id,study_entry_age,observed_followup,study_exit_age,observed_outcome,time_of_onset
1,59,7,66,0,inf
2,57,8,65,0,inf
3,53,5,58,0,inf
4,57,9,66,0,inf
5,53,7,60,0,inf
6,50,10,60,0,inf
7,54,11,65,0,inf
8,67,13,80,0,inf
9,58,10,68,1,4.627499180675088
10,66,7,73,0,inf
11,67,12,79,0,inf
12,58,6,64,0,inf
13,59,10,69,0,inf
14,59,7,66,0,inf
15,63,11,74,0,inf
16,52,13,65,0,inf
17,54,6,60,0,inf
18,64,7,71,0,inf
19,60,6,66,0,inf
20,60,9,69,0,inf
21,67,10,77,0,inf
22,65,8,73,0,inf
23,54,10,64,0,inf
24,59,8,67,0,inf
25,63,7,70,0,inf
26,51,12,63,0,inf
27,63,11,74,0,inf
28,63,7,70,0,inf
29,63,10,73,0,inf
30,58,10,68,0,inf
31,63,6,69,0,inf
32,65,9,74,0,inf
33,55,11,66,0,inf
34,67,13,80,0,inf
35,63,5,68,0,inf
36,66,10,76,0,inf
37,60,5,65,0,inf
38,57,11,68,0,inf
39,59,11,70,0,inf
40,58,13,71,0,inf
41,51,5,56,0,inf
42,60,13,73,0,inf
43,65,5,70,0,inf
44,55,9,64,0,inf
45,66,9,75,0,inf
46,67,9,76,0,inf
47,54,10,64,0,inf
48,55,8,63,0,inf
49,56,10,66,0,inf
50,51,10,61,0,inf
51,52,6,58,0,inf
52,53,11,64,0,inf
53,65,11,76,0,inf
54,52,12,64,0,inf
55,52,5,57,0,inf
56,53,11,64,0,inf
57,57,11,68,0,inf
58,51,8,59,1,1.08708672844773
59,64,13,77,1,10.205258429071279
60,56,8,64,0,inf
61,64,10,74,0,inf
62,64,8,72,0,inf
63,54,12,66,0,inf
64,66,12,78,0,inf
65,53,13,66,0,inf
66,59,7,66,0,inf
67,64,9,73,0,inf
68,54,9,63,1,6.19084978349013
69,55,5,60,0,inf
70,55,7,62,0,inf
71,67,5,72,0,inf
72,59,10,69,0,inf
73,62,9,71,0,inf
74,61,10,71,0,inf
75,54,6,60,0,inf
76,67,11,78,0,inf
77,55,5,60,0,inf
78,51,6,57,0,inf
79,53,12,65,0,inf
80,53,10,63,0,inf
81,56,8,64,0,inf
82,66,9,75,0,inf
83,54,8,62,0,inf
84,55,6,61,0,inf
85,66,13,79,0,inf
86,62,6,68,0,inf
87,62,10,72,0,inf
88,57,6,63,0,inf
89,59,8,67,0,inf
90,60,10,70,0,inf
91,55,11,66,0,inf
92,56,12,68,0,inf
93,60,12,72,0,inf
94,55,9,64,1,7.149891530140373
95,59,13,72,0,inf
96,65,6,71,0,inf
97,56,5,61,0,inf
98,52,5,57,0,inf
99,52,12,64,0,inf
100,64,10,74,0,inf
101,56,11,67,0,inf
102,50,11,61,0,inf
103,55,6,61,0,inf
104,59,11,70,0,inf
105,50,13,63,1,12.266491353772807
106,64,10,74,0,inf
107,63,12,75,0,inf
108,67,6,73,0,inf
109,60,6,66,0,inf
110,56,10,66,0,inf
111,61,8,69,0,inf
112,59,8,67,0,inf
113,65,11,76,0,inf
114,58,8,66,0,inf
115,61,10,71,0,inf
116,60,6,66,0,inf
117,61,5,66,0,inf
118,55,13,68,0,inf
119,59,7,66,0,inf
120,67,7,74,0,inf
121,61,6,67,0,inf
122,53,7,60,0,inf
123,64,10,74,0,inf
124,64,5,69,0,inf
125,61,10,71,0,inf
126,55,12,67,0,inf
127,67,10,77,0,inf
128,60,8,68,0,inf
129,65,12,77,0,inf
130,64,10,74,0,inf
131,50,5,55,0,inf
132,66,10,76,0,inf
133,67,5,72,0,inf
134,59,10,69,0,inf
135,62,11,73,0,inf
136,52,9,61,0,inf
137,60,5,65,1,2.2327050653834775
138,54,6,60,0,inf
139,64,9,73,0,inf
140,53,10,63,0,inf
141,65,12,77,0,inf
142,51,9,60,0,inf
143,65,9,74,1,8.621820260470216
144,59,8,67,0,inf
145,65,8,73,0,inf
146,64,9,73,0,inf
147,65,11,76,0,inf
148,55,13,68,0,inf
149,57,6,63,0,inf
150,60,12,72,0,inf
151,60,6,66,0,inf
152,65,8,73,0,inf
153,53,11,64,0,inf
154,65,9,74,0,inf
155,62,11,73,0,inf
156,61,11,72,0,inf
157,65,12,77,0,inf
158,50,7,57,0,inf
159,51,6,57,0,inf
160,67,12,79,0,inf
161,54,11,65,0,inf
162,54,8,62,0,inf
163,67,8,75,0,inf
164,59,11,70,0,inf
165,50,13,63,1,2.852727984454347
166,60,9,69,0,inf
167,66,11,77,0,inf
168,60,6,66,0,inf
169,50,5,55,0,inf
170,53,5,58,0,inf
171,52,8,60,0,inf
172,63,5,68,0,inf
173,65,7,72,0,inf
174,64,12,76,0,inf
175,50,11,61,0,inf
176,60,6,66,0,inf
177,67,7,74,0,inf
178,52,7,59,0,inf
179,59,7,66,0,inf
180,64,5,69,0,inf
181,67,5,72,0,inf
182,56,9,65,0,inf
183,52,6,58,0,inf
184,65,9,74,0,inf
185,57,7,64,0,inf
186,59,7,66,0,inf
187,66,10,76,0,inf
188,50,11,61,0,inf
189,55,7,62,0,inf
190,67,9,76,0,inf
191,54,11,65,0,inf
192,62,8,70,0,inf
193,54,5,59,0,inf
194,59,5,64,0,inf
195,50,5,55,0,inf
196,62,7,69,0,inf
197,62,10,72,0,inf
198,55,11,66,0,inf
199,61,10,71,0,inf
200,63,8,71,0,inf
201,67,13,80,1,5.7424062156348725
202,50,7,57,0,inf
203,60,10,70,0,inf
204,62,11,73,0,inf
205,63,5,68,0,inf
206,51,11,62,0,inf
207,57,7,64,0,inf
208,64,11,75,0,inf
209,59,10,69,0,inf
210,63,6,69,0,inf
211,54,6,60,0,inf
212,58,5,63,0,inf
213,63,11,74,0,inf
214,67,9,76,0,inf
215,51,13,64,0,inf
216,56,8,64,0,inf
217,58,6,64,0,inf
218,59,12,71,0,inf
219,58,13,71,0,inf
220,59,6,65,1,3.31505108613581
221,63,12,75,0,inf
222,66,10,76,0,inf
223,60,12,72,0,inf
224,62,5,67,0,inf
225,60,13,73,0,inf
226,67,9,76,0,inf
227,61,5,66,0,inf
228,52,8,60,0,inf
229,62,12,74,0,inf
230,59,7,66,0,inf
231,50,11,61,0,inf
232,52,5,57,0,inf
233,54,6,60,0,inf
234,54,11,65,0,inf
235,60,6,66,0,inf
236,57,9,66,0,inf
237,57,5,62,0,inf
238,60,5,65,0,inf
239,53,13,66,0,inf
240,54,5,59,0,inf
241,61,9,70,0,inf
242,59,10,69,0,inf
243,53,8,61,0,inf
244,60,12,72,0,inf
245,67,6,73,0,inf
246,54,6,60,0,inf
247,52,13,65,0,inf
248,63,9,72,0,inf
249,62,13,75,0,inf
250,65,10,75,0,inf
251,67,5,72,0,inf
252,51,8,59,0,inf
253,66,8,74,0,inf
254,54,8,62,0,inf
255,54,10,64,0,inf
256,65,5,70,0,inf
257,54,7,61,0,inf
258,60,10,70,0,inf
259,52,11,63,0,inf
260,52,8,60,0,inf
261,59,12,71,0,inf
262,56,8,64,0,inf
263,63,7,70,0,inf
264,50,10,60,0,inf
265,57,5,62,0,inf
266,59,9,68,0,inf
267,66,5,71,0,inf
268,59,11,70,0,inf
269,56,10,66,0,inf
270,50,8,58,0,inf
271,50,12,62,0,inf
272,67,11,78,0,inf
273,58,6,64,0,inf
274,61,10,71,0,inf
275,64,9,73,0,inf
276,60,12,72,0,inf
277,52,12,64,0,inf
278,60,5,65,0,inf
279,58,9,67,0,inf
280,62,11,73,0,inf
281,62,9,71,0,inf
282,65,12,77,0,inf
283,56,9,65,0,inf
284,61,6,67,0,inf
285,51,12,63,0,inf
286,59,11,70,0,inf
287,63,12,75,0,inf
288,63,6,69,0,inf
289,66,5,71,0,inf
290,65,13,78,0,inf
291,58,5,63,0,inf
292,63,10,73,0,inf
293,54,10,64,0,inf
294,61,11,72,1,4.989744205792817
295,53,7,60,0,inf
296,67,7,74,0,inf
297,58,8,66,0,inf
298,55,6,61,0,inf
299,50,11,61,0,inf
300,57,12,69,0,inf
301,54,13,67,0,inf
302,50,5,55,0,inf
303,63,11,74,0,inf
304,63,8,71,0,inf
305,50,7,57,0,inf
306,63,12,75,0,inf
307,65,8,73,0,inf
308,50,11,61,0,inf
309,54,13,67,1,5.977408073042483
310,63,9,72,0,inf
311,61,7,68,0,inf
312,58,13,71,0,inf
313,50,5,55,0,inf
314,59,7,66,0,inf
315,64,12,76,0,inf
316,64,13,77,0,inf
317,55,8,63,0,inf
318,59,8,67,0,inf
319,61,9,70,0,inf
320,60,8,68,0,inf
321,67,13,80,0,inf
322,57,5,62,0,inf
323,61,6,67,0,inf
324,52,6,58,0,inf
325,51,11,62,0,inf
326,66,8,74,0,inf
327,59,10,69,0,inf
328,65,5,70,0,inf
329,65,7,72,0,inf
330,50,5,55,0,inf
331,67,6,73,0,inf
332,51,12,63,0,inf
333,59,12,71,0,inf
334,60,11,71,1,0.062493541051864554
335,64,10,74,0,inf
336,52,12,64,0,inf
337,60,11,71,1,0.8110430008463965
338,67,12,79,0,inf
339,52,9,61,0,inf
340,63,13,76,0,inf
341,51,9,60,0,inf
342,67,12,79,0,inf
343,59,11,70,0,inf
344,54,6,60,0,inf
345,52,11,63,0,inf
346,57,9,66,0,inf
347,63,13,76,0,inf
348,60,11,71,0,inf
349,61,8,69,0,inf
350,67,5,72,0,inf
351,62,5,67,0,inf
352,58,12,70,1,7.20082796523613
353,54,9,63,0,inf
354,63,7,70,0,inf
355,57,7,64,0,inf
356,53,11,64,0,inf
357,62,12,74,1,4.971838668657483
358,66,13,79,1,8.4795534769586
359,62,7,69,0,inf
360,54,12,66,0,inf
361,61,8,69,0,inf
362,50,11,61,0,inf
363,55,6,61,0,inf
364,62,9,71,0,inf
365,56,13,69,0,inf
366,64,7,71,0,inf
367,64,13,77,0,inf
368,63,9,72,0,inf
369,53,6,59,0,inf
370,51,9,60,0,inf
371,52,9,61,0,inf
372,66,12,78,0,inf
373,60,9,69,0,inf
374,61,6,67,0,inf
375,53,6,59,0,inf
376,57,8,65,0,inf
377,64,6,70,0,inf
378,57,11,68,0,inf
379,58,8,66,0,inf
380,66,6,72,0,inf
381,67,5,72,0,inf
382,55,7,62,0,inf
383,63,6,69,0,inf
384,57,12,69,0,inf
385,57,9,66,0,inf
386,65,11,76,0,inf
387,55,6,61,0,inf
388,65,10,75,0,inf
389,60,11,71,0,inf
390,62,13,75,0,inf
391,64,7,71,1,1.0261776619148577
392,54,9,63,0,inf
393,61,8,69,0,inf
394,53,10,63,0,inf
395,64,12,76,0,inf
396,61,8,69,0,inf
397,56,12,68,0,inf
398,52,6,58,0,inf
399,67,13,80,0,inf
400,52,10,62,0,inf
401,64,12,76,0,inf
402,67,12,79,0,inf
403,67,10,77,0,inf
404,54,11,65,0,inf
405,64,6,70,0,inf
406,55,13,68,0,inf
407,52,8,60,0,inf
408,67,11,78,0,inf
409,60,6,66,0,inf
410,62,9,71,0,inf
411,67,8,75,0,inf
412,51,5,56,0,inf
413,50,6,56,0,inf
414,55,5,60,0,inf
415,65,5,70,0,inf
416,59,9,68,0,inf
417,52,10,62,0,inf
418,55,12,67,0,inf
419,65,13,78,0,inf
420,55,9,64,0,inf
421,51,6,57,0,inf
422,54,5,59,0,inf
423,66,8,74,0,inf
424,59,7,66,0,inf
425,64,10,74,0,inf
426,54,13,67,0,inf
427,63,7,70,0,inf
428,51,7,58,0,inf
429,55,6,61,0,inf
430,59,6,65,0,inf
431,62,6,68,0,inf
432,59,10,69,0,inf
433,50,5,55,0,inf
434,56,11,67,0,inf
435,59,6,65,0,inf
436,61,8,69,0,inf
437,59,10,69,0,inf
438,55,11,66,0,inf
439,66,13,79,1,6.249824724920757
440,66,10,76,0,inf
441,51,13,64,0,inf
442,55,11,66,0,inf
443,57,12,69,0,inf
444,57,10,67,0,inf
445,59,12,71,0,inf
446,67,12,79,0,inf
447,67,9,76,0,inf
448,60,10,70,0,inf
449,61,12,73,0,inf
450,67,11,78,0,inf
451,63,9,72,0,inf
452,61,7,68,0,inf
453,57,6,63,0,inf
454,59,10,69,0,inf
455,51,11,62,0,inf
456,53,5,58,0,inf
457,51,8,59,0,inf
458,64,12,76,0,inf
459,67,12,79,0,inf
460,52,8,60,0,inf
461,63,10,73,0,inf
462,63,12,75,0,inf
463,50,12,62,0,inf
464,52,8,60,0,inf
465,65,9,74,0,inf
466,60,5,65,0,inf
467,61,6,67,0,inf
468,65,8,73,0,inf
469,67,12,79,0,inf
470,52,9,61,0,inf
471,54,8,62,0,inf
472,53,8,61,0,inf
473,52,13,65,0,inf
474,59,10,69,1,6.800360196782762
475,63,13,76,0,inf
476,61,9,70,0,inf
477,56,7,63,0,inf
478,52,5,57,0,inf
479,60,8,68,0,inf
480,66,13,79,0,inf
481,50,12,62,0,inf
482,66,5,71,0,inf
483,67,12,79,0,inf
484,60,11,71,0,inf
485,61,6,67,0,inf
486,57,8,65,0,inf
487,60,5,65,0,inf
488,53,5,58,0,inf
489,64,5,69,0,inf
490,56,6,62,0,inf
491,50,12,62,0,inf
492,67,10,77,0,inf
493,54,9,63,0,inf
494,60,7,67,0,inf
495,56,6,62,0,inf
496,64,10,74,0,inf
497,66,5,71,0,inf
498,61,6,67,0,inf
499,62,6,68,0,inf
500,63,7,70,0,inf
501,62,6,68,0,inf
502,58,7,65,0,inf
503,59,11,70,0,inf
504,67,9,76,0,inf
505,55,5,60,0,inf
506,58,7,65,0,inf
507,60,7,67,0,inf
508,59,10,69,0,inf
509,50,7,57,0,inf
510,50,10,60,0,inf
511,66,10,76,0,inf
512,56,9,65,0,inf
513,57,6,63,0,inf
514,66,5,71,0,inf
515,57,13,70,0,inf
516,67,5,72,0,inf
517,59,7,66,0,inf
518,62,7,69,0,inf
519,64,5,69,0,inf
520,65,6,71,0,inf
521,57,13,70,0,inf
522,63,13,76,0,inf
523,65,10,75,0,inf
524,65,7,72,0,inf
525,62,7,69,0,inf
526,57,8,65,0,inf
527,66,13,79,0,inf
528,60,11,71,0,inf
529,56,8,64,0,inf
530,66,8,74,0,inf
531,65,10,75,0,inf
532,52,7,59,0,inf
533,64,8,72,0,inf
534,60,6,66,0,inf
535,57,5,62,0,inf
536,52,5,57,0,inf
537,66,12,78,0,inf
538,62,12,74,0,inf
539,52,5,57,0,inf
540,53,8,61,0,inf
541,52,11,63,0,inf
542,52,10,62,0,inf
543,55,9,64,0,inf
544,66,13,79,0,inf
545,67,11,78,0,inf
546,59,6,65,0,inf
547,57,12,69,0,inf
548,53,7,60,0,inf
549,57,10,67,0,inf
550,53,9,62,0,inf
551,62,10,72,0,inf
552,66,8,74,0,inf
553,51,13,64,0,inf
554,57,6,63,0,inf
555,57,6,63,0,inf
556,53,10,63,0,inf
557,57,10,67,0,inf
558,56,12,68,0,inf
559,58,5,63,0,inf
560,60,6,66,0,inf
561,63,11,74,0,inf
562,61,13,74,0,inf
563,55,12,67,0,inf
564,63,9,72,0,inf
565,57,7,64,0,inf
566,50,7,57,0,inf
567,55,13,68,0,inf
568,66,5,71,0,inf
569,58,5,63,0,inf
570,62,12,74,0,inf
571,67,11,78,0,inf
572,62,5,67,0,inf
573,63,12,75,0,inf
574,61,10,71,0,inf
575,58,11,69,0,inf
576,62,12,74,0,inf
577,67,9,76,0,inf
578,54,7,61,0,inf
579,67,10,77,0,inf
580,62,5,67,0,inf
581,52,9,61,0,inf
582,64,5,69,0,inf
583,57,5,62,0,inf
584,61,12,73,0,inf
585,64,11,75,0,inf
586,63,5,68,0,inf
587,51,7,58,0,inf
588,62,12,74,0,inf
589,66,9,75,0,inf
590,52,12,64,0,inf
591,52,11,63,0,inf
592,63,6,69,1,2.1411960127396554
593,53,11,64,0,inf
594,52,12,64,0,inf
595,60,9,69,0,inf
596,55,13,68,0,inf
597,62,6,68,0,inf
598,56,13,69,0,inf
599,54,10,64,0,inf
600,52,11,63,0,inf
601,57,7,64,0,inf
602,63,11,74,0,inf
603,61,8,69,0,inf
604,51,12,63,0,inf
605,65,6,71,0,inf
606,63,13,76,0,inf
607,62,11,73,0,inf
608,54,10,64,0,inf
609,63,13,76,0,inf
610,60,8,68,0,inf
611,61,8,69,0,inf
612,65,13,78,0,inf
613,53,6,59,0,inf
614,63,8,71,0,inf
615,53,6,59,0,inf
616,53,12,65,0,inf
617,52,9,61,0,inf
618,52,11,63,1,5.8611605523664565
619,61,12,73,0,inf
620,58,13,71,0,inf
621,55,7,62,0,inf
622,63,9,72,0,inf
623,64,5,69,0,inf
624,56,10,66,0,inf
625,67,9,76,0,inf
626,63,9,72,0,inf
627,50,10,60,0,inf
628,62,10,72,0,inf
629,55,10,65,0,inf
630,52,12,64,0,inf
631,63,7,70,0,inf
632,52,12,64,0,inf
633,66,10,76,0,inf
634,58,9,67,0,inf
635,59,5,64,0,inf
636,59,12,71,0,inf
637,50,11,61,0,inf
638,66,13,79,0,inf
639,58,6,64,0,inf
640,56,10,66,0,inf
641,61,11,72,0,inf
642,64,8,72,0,inf
643,67,7,74,0,inf
644,64,13,77,0,inf
645,52,5,57,0,inf
646,64,11,75,1,5.686133476290706
647,53,12,65,0,inf
648,58,10,68,0,inf
649,59,11,70,0,inf
650,58,6,64,0,inf
651,56,13,69,0,inf
652,57,11,68,0,inf
653,64,12,76,0,inf
654,65,10,75,0,inf
655,65,7,72,0,inf
656,63,13,76,0,inf
657,67,12,79,0,inf
658,59,13,72,0,inf
659,50,9,59,0,inf
660,66,12,78,0,inf
661,52,5,57,0,inf
662,52,13,65,0,inf
663,64,5,69,0,inf
664,56,6,62,0,inf
665,52,7,59,0,inf
666,50,8,58,0,inf
667,66,13,79,0,inf
668,53,13,66,0,inf
669,53,13,66,0,inf
670,57,5,62,0,inf
671,62,7,69,0,inf
672,56,7,63,0,inf
673,51,6,57,0,inf
674,58,9,67,0,inf
675,53,10,63,0,inf
676,57,13,70,0,inf
677,64,9,73,0,inf
678,61,11,72,0,inf
679,67,10,77,0,inf
680,52,12,64,0,inf
681,63,8,71,0,inf
682,67,5,72,0,inf
683,53,7,60,0,inf
684,52,6,58,0,inf
685,57,11,68,0,inf
686,58,10,68,0,inf
687,55,5,60,0,inf
688,63,11,74,0,inf
689,55,10,65,0,inf
690,52,12,64,0,inf
691,54,8,62,0,inf
692,51,5,56,0,inf
693,51,8,59,0,inf
694,62,9,71,0,inf
695,52,9,61,0,inf
696,58,12,70,0,inf
697,61,5,66,0,inf
698,55,12,67,0,inf
699,55,12,67,0,inf
700,60,13,73,0,inf
701,54,8,62,0,inf
702,53,9,62,0,inf
703,66,11,77,0,inf
704,61,7,68,0,inf
705,50,11,61,0,inf
706,65,7,72,0,inf
707,58,7,65,0,inf
708,59,11,70,0,inf
709,59,7,66,0,inf
710,63,9,72,0,inf
711,50,6,56,0,inf
712,66,8,74,0,inf
713,67,5,72,0,inf
714,56,8,64,0,inf
715,55,12,67,0,inf
716,61,6,67,0,inf
717,62,7,69,0,inf
718,55,8,63,0,inf
719,52,9,61,0,inf
720,58,6,64,0,inf
721,54,5,59,0,inf
722,62,11,73,0,inf
723,53,11,64,0,inf
724,56,13,69,0,inf
725,65,10,75,0,inf
726,67,11,78,0,inf
727,52,7,59,0,inf
728,66,10,76,0,inf
729,67,11,78,0,inf
730,66,10,76,0,inf
731,57,5,62,0,inf
732,54,8,62,0,inf
733,59,12,71,0,inf
734,52,8,60,0,inf
735,53,8,61,0,inf
736,61,7,68,0,inf
737,56,8,64,0,inf
738,51,8,59,0,inf
739,58,11,69,1,8.504720066146334
740,55,9,64,0,inf
741,51,10,61,0,inf
742,55,5,60,0,inf
743,50,8,58,0,inf
744,53,9,62,0,inf
745,59,7,66,0,inf
746,62,10,72,0,inf
747,59,9,68,0,inf
748,58,8,66,0,inf
749,61,8,69,0,inf
750,55,7,62,0,inf
751,58,13,71,0,inf
752,59,6,65,0,inf
753,52,5,57,0,inf
754,64,7,71,0,inf
755,63,13,76,0,inf
756,53,12,65,0,inf
757,56,9,65,0,inf
758,64,6,70,0,inf
759,66,11,77,0,inf
760,58,12,70,0,inf
761,63,7,70,0,inf
762,58,9,67,0,inf
763,52,11,63,1,0.012701922754509098
764,61,6,67,1,0.711798283177707
765,59,11,70,0,inf
766,61,10,71,0,inf
767,64,10,74,0,inf
768,54,13,67,0,inf
769,60,5,65,0,inf
770,63,9,72,0,inf
771,63,8,71,0,inf
772,51,11,62,0,inf
773,63,9,72,0,inf
774,51,7,58,0,inf
775,66,7,73,0,inf
776,60,12,72,0,inf
777,65,7,72,0,inf
778,59,8,67,0,inf
779,66,13,79,0,inf
780,66,13,79,0,inf
781,64,13,77,1,5.421194753496053
782,58,8,66,0,inf
783,56,11,67,0,inf
784,59,9,68,0,inf
785,53,8,61,0,inf
786,58,9,67,0,inf
787,61,7,68,0,inf
788,60,11,71,0,inf
789,61,7,68,0,inf
790,60,6,66,0,inf
791,60,6,66,0,inf
792,61,9,70,0,inf
793,65,9,74,0,inf
794,56,5,61,0,inf
795,65,11,76,0,inf
796,53,11,64,0,inf
797,57,13,70,0,inf
798,51,7,58,0,inf
799,53,12,65,0,inf
800,66,6,72,0,inf
801,51,5,56,0,inf
802,54,6,60,0,inf
803,60,11,71,1,10.505058503238843
804,61,7,68,0,inf
805,53,11,64,0,inf
806,50,6,56,0,inf
807,63,11,74,0,inf
808,60,7,67,0,inf
809,58,5,63,0,inf
810,58,12,70,0,inf
811,55,9,64,0,inf
812,57,11,68,0,inf
813,63,11,74,1,3.3298624968575012
814,59,5,64,0,inf
815,51,8,59,0,inf
816,61,11,72,0,inf
817,54,6,60,0,inf
818,50,9,59,0,inf
819,58,12,70,0,inf
820,54,7,61,0,inf
821,63,8,71,0,inf
822,57,9,66,0,inf
823,62,8,70,0,inf
824,54,8,62,0,inf
825,61,12,73,0,inf
826,54,5,59,0,inf
827,54,12,66,0,inf
828,66,12,78,0,inf
829,54,7,61,0,inf
830,65,11,76,0,inf
831,60,6,66,0,inf
832,58,13,71,0,inf
833,65,6,71,0,inf
834,65,7,72,0,inf
835,53,12,65,0,inf
836,58,13,71,0,inf
837,64,12,76,0,inf
838,64,7,71,0,inf
839,65,8,73,0,inf
840,61,7,68,0,inf
841,60,8,68,0,inf
842,52,6,58,0,inf
843,50,12,62,0,inf
844,58,9,67,0,inf
845,57,5,62,0,inf
846,56,11,67,0,inf
847,66,12,78,0,inf
848,60,10,70,0,inf
849,60,11,71,0,inf
850,61,10,71,0,inf
851,53,9,62,0,inf
852,67,7,74,0,inf
853,54,5,59,0,inf
854,67,5,72,0,inf
855,64,6,70,0,inf
856,58,7,65,0,inf
857,53,9,62,0,inf
858,64,7,71,0,inf
859,55,10,65,0,inf
860,51,11,62,0,inf
861,61,12,73,0,inf
862,65,7,72,0,inf
863,65,11,76,0,inf
864,61,7,68,0,inf
865,59,12,71,0,inf
866,51,9,60,0,inf
867,58,12,70,1,8.972361299419376
868,52,11,63,1,0.6832367005070168
869,55,7,62,0,inf
870,50,8,58,0,inf
871,50,8,58,0,inf
872,59,9,68,0,inf
873,52,8,60,1,0.9827105329781318
874,63,7,70,0,inf
875,59,7,66,0,inf
876,58,12,70,0,inf
877,53,8,61,0,inf
878,65,8,73,0,inf
879,63,10,73,0,inf
880,53,12,65,0,inf
881,62,6,68,0,inf
882,65,8,73,0,inf
883,66,12,78,0,inf
884,67,10,77,0,inf
885,60,10,70,0,inf
886,60,6,66,0,inf
887,59,13,72,1,10.69906738097491
888,65,11,76,0,inf
889,63,8,71,0,inf
890,65,9,74,0,inf
891,62,10,72,0,inf
892,52,5,57,1,1.6609631229282869
893,60,12,72,0,inf
894,59,9,68,0,inf
895,56,12,68,0,inf
896,60,8,68,0,inf
897,64,10,74,0,inf
898,64,8,72,0,inf
899,50,10,60,0,inf
900,50,13,63,0,inf
901,55,10,65,0,inf
902,61,8,69,0,inf
903,52,9,61,0,inf
904,52,9,61,0,inf
905,65,6,71,0,inf
906,67,7,74,0,inf
907,64,10,74,0,inf
908,53,8,61,0,inf
909,53,8,61,0,inf
910,51,7,58,0,inf
911,56,9,65,0,inf
912,64,9,73,0,inf
913,59,7,66,0,inf
914,50,11,61,0,inf
915,61,8,69,0,inf
916,53,8,61,0,inf
917,53,9,62,0,inf
918,65,12,77,0,inf
919,60,7,67,0,inf
920,64,9,73,0,inf
921,61,10,71,0,inf
922,54,9,63,0,inf
923,52,9,61,0,inf
924,59,8,67,0,inf
925,51,8,59,1,7.50595458247853
926,51,12,63,0,inf
927,52,9,61,0,inf
928,64,9,73,0,inf
929,54,11,65,0,inf
930,60,10,70,0,inf
931,63,7,70,0,inf
932,50,10,60,0,inf
933,62,8,70,0,inf
934,59,13,72,0,inf
935,53,10,63,0,inf
936,58,12,70,0,inf
937,51,8,59,0,inf
938,63,12,75,0,inf
939,51,9,60,0,inf
940,53,6,59,0,inf
941,66,12,78,0,inf
942,57,11,68,0,inf
943,63,10,73,0,inf
944,65,9,74,0,inf
945,60,10,70,0,inf
946,51,9,60,0,inf
947,57,12,69,0,inf
948,57,8,65,0,inf
949,59,10,69,0,inf
950,65,11,76,0,inf
951,66,5,71,0,inf
952,53,12,65,0,inf
953,55,8,63,0,inf
954,57,11,68,0,inf
955,52,8,60,0,inf
956,59,10,69,0,inf
957,54,11,65,0,inf
958,67,7,74,0,inf
959,62,8,70,0,inf
960,66,11,77,0,inf
961,52,5,57,0,inf
962,66,7,73,1,4.3026538882751595
963,66,13,79,0,inf
964,50,9,59,0,inf
965,55,8,63,0,inf
966,67,8,75,0,inf
967,66,13,79,0,inf
968,57,12,69,0,inf
969,65,6,71,0,inf
970,57,6,63,0,inf
971,50,5,55,0,inf
972,67,13,80,0,inf
973,63,7,70,0,inf
974,50,6,56,0,inf
975,56,9,65,0,inf
976,65,9,74,0,inf
977,56,6,62,0,inf
978,62,9,71,0,inf
979,59,12,71,1,0.7030466008504845
980,66,6,72,0,inf
981,58,7,65,0,inf
982,62,12,74,0,inf
983,62,11,73,0,inf
984,57,5,62,0,inf
985,66,7,73,0,inf
986,57,6,63,0,inf
987,60,12,72,0,inf
988,57,7,64,0,inf
989,65,12,77,0,inf
990,57,9,66,0,inf
991,52,11,63,0,inf
992,55,13,68,0,inf
993,52,12,64,0,inf
994,53,5,58,0,inf
995,67,13,80,0,inf
996,60,8,68,1,1.3148349324737438
997,62,10,72,0,inf
998,61,11,72,0,inf
999,56,11,67,0,inf
1000,52,8,60,0,inf
1001,59,5,64,0,inf
1002,60,10,70,1,7.791420473585845
1003,58,8,66,0,inf
1004,61,13,74,0,inf
1005,59,5,64,0,inf
1006,58,11,69,0,inf
1007,52,5,57,0,inf
1008,50,7,57,0,inf
1009,54,9,63,0,inf
1010,61,7,68,0,inf
1011,65,12,77,0,inf
1012,66,13,79,0,inf
1013,66,11,77,0,inf
1014,56,9,65,0,inf
1015,52,8,60,0,inf
1016,57,8,65,0,inf
1017,51,9,60,0,inf
1018,58,8,66,0,inf
1019,63,7,70,0,inf
1020,66,12,78,0,inf
1021,53,9,62,0,inf
1022,66,7,73,0,inf
1023,56,5,61,0,inf
1024,54,13,67,0,inf
1025,67,6,73,0,inf
1026,64,7,71,1,5.053589475034443
1027,52,8,60,0,inf
1028,50,12,62,1,10.142175847203617
1029,58,5,63,0,inf
1030,53,13,66,0,inf
1031,63,11,74,0,inf
1032,55,8,63,0,inf
1033,57,7,64,0,inf
1034,64,7,71,0,inf
1035,59,12,71,0,inf
1036,59,7,66,0,inf
1037,56,6,62,0,inf
1038,52,10,62,0,inf
1039,59,13,72,0,inf
1040,56,8,64,0,inf
1041,51,6,57,0,inf
1042,51,5,56,0,inf
1043,66,6,72,0,inf
1044,57,10,67,0,inf
1045,57,9,66,0,inf
1046,65,6,71,0,inf
1047,59,10,69,0,inf
1048,50,5,55,0,inf
1049,53,11,64,0,inf
1050,59,7,66,0,inf
1051,61,9,70,0,inf
1052,51,12,63,0,inf
1053,60,6,66,0,inf
1054,54,7,61,0,inf
1055,54,13,67,0,inf
1056,51,12,63,0,inf
1057,58,12,70,0,inf
1058,58,7,65,0,inf
1059,56,10,66,0,inf
1060,52,9,61,0,inf
1061,58,9,67,0,inf
1062,51,10,61,0,inf
1063,65,7,72,0,inf
1064,55,12,67,0,inf
1065,50,11,61,0,inf
1066,66,13,79,0,inf
1067,57,12,69,0,inf
1068,58,10,68,0,inf
1069,64,8,72,0,inf
1070,61,9,70,0,inf
1071,64,8,72,0,inf
1072,50,10,60,0,inf
1073,55,10,65,0,inf
1074,52,12,64,0,inf
1075,56,7,63,0,inf
1076,63,11,74,0,inf
1077,54,9,63,0,inf
1078,54,9,63,0,inf
1079,54,8,62,0,inf
1080,61,7,68,0,inf
1081,59,11,70,0,inf
1082,56,7,63,0,inf
1083,60,6,66,0,inf
1084,53,10,63,0,inf
1085,66,7,73,0,inf
1086,60,9,69,0,inf
1087,60,10,70,0,inf
1088,63,6,69,0,inf
1089,66,13,79,1,7.463529013483949
1090,53,9,62,0,inf
1091,58,11,69,0,inf
1092,67,7,74,0,inf
1093,57,10,67,0,inf
1094,55,8,63,0,inf
1095,53,11,64,0,inf
1096,52,7,59,0,inf
1097,50,7,57,0,inf
1098,63,10,73,0,inf
1099,52,12,64,0,inf
1100,54,9,63,0,inf
1101,64,10,74,0,inf
1102,60,5,65,0,inf
1103,58,11,69,0,inf
1104,62,9,71,0,inf
1105,55,9,64,0,inf
1106,61,12,73,0,inf
1107,58,12,70,0,inf
1108,65,8,73,0,inf
1109,50,8,58,0,inf
1110,62,7,69,0,inf
1111,51,10,61,0,inf
1112,54,6,60,0,inf
1113,65,9,74,0,inf
1114,63,7,70,0,inf
1115,64,9,73,0,inf
1116,55,8,63,0,inf
1117,67,7,74,0,inf
1118,53,5,58,0,inf
1119,58,12,70,0,inf
1120,52,8,60,0,inf
1121,63,13,76,0,inf
1122,58,8,66,0,inf
1123,54,9,63,0,inf
1124,59,8,67,0,inf
1125,54,8,62,0,inf
1126,60,7,67,0,inf
1127,52,5,57,0,inf
1128,57,13,70,0,inf
1129,61,6,67,0,inf
1130,67,7,74,0,inf
1131,54,6,60,0,inf
1132,64,12,76,0,inf
1133,51,7,58,0,inf
1134,52,8,60,0,inf
1135,51,8,59,0,inf
1136,65,9,74,0,inf
1137,56,7,63,0,inf
1138,55,9,64,0,inf
1139,54,10,64,0,inf
1140,57,11,68,0,inf
1141,53,11,64,0,inf
1142,56,10,66,0,inf
1143,54,7,61,0,inf
1144,62,13,75,0,inf
1145,50,8,58,0,inf
1146,52,12,64,0,inf
1147,59,11,70,0,inf
1148,53,12,65,0,inf
1149,59,6,65,0,inf
1150,52,9,61,0,inf
1151,64,11,75,0,inf
1152,61,7,68,0,inf
1153,50,7,57,0,inf
1154,66,7,73,0,inf
1155,58,5,63,0,inf
1156,66,10,76,0,inf
1157,52,8,60,0,inf
1158,55,6,61,0,inf
1159,65,13,78,0,inf
1160,67,13,80,0,inf
1161,64,6,70,0,inf
1162,60,8,68,0,inf
1163,53,6,59,0,inf
1164,53,12,65,0,inf
1165,58,6,64,0,inf
1166,64,12,76,0,inf
1167,51,5,56,0,inf
1168,65,11,76,0,inf
1169,55,10,65,0,inf
1170,58,7,65,0,inf
1171,67,9,76,0,inf
1172,59,9,68,0,inf
1173,64,8,72,0,inf
1174,50,11,61,0,inf
1175,53,10,63,0,inf
1176,64,10,74,0,inf
1177,51,11,62,0,inf
1178,66,9,75,0,inf
1179,65,7,72,0,inf
1180,53,10,63,0,inf
1181,57,7,64,0,inf
1182,59,5,64,0,inf
1183,60,6,66,0,inf
1184,56,9,65,0,inf
1185,52,8,60,0,inf
1186,65,9,74,0,inf
1187,55,13,68,0,inf
1188,62,8,70,0,inf
1189,54,12,66,0,inf
1190,65,10,75,0,inf
1191,53,10,63,0,inf
1192,53,10,63,0,inf
1193,60,8,68,0,inf
1194,62,13,75,0,inf
1195,53,9,62,0,inf
1196,51,12,63,0,inf
1197,66,5,71,0,inf
1198,51,9,60,0,inf
1199,60,12,72,0,inf
1200,65,9,74,0,inf
1201,51,6,57,0,inf
1202,51,6,57,0,inf
1203,55,9,64,0,inf
1204,61,8,69,0,inf
1205,61,5,66,0,inf
1206,57,5,62,0,inf
1207,66,5,71,0,inf
1208,51,6,57,0,inf
1209,54,13,67,0,inf
1210,52,8,60,0,inf
1211,53,9,62,0,inf
1212,55,11,66,0,inf
1213,53,9,62,0,inf
1214,53,13,66,0,inf
1215,64,10,74,0,inf
1216,62,6,68,0,inf
1217,66,7,73,0,inf
1218,53,6,59,0,inf
1219,67,8,75,0,inf
1220,54,8,62,0,inf
1221,53,10,63,0,inf
1222,62,11,73,0,inf
1223,61,5,66,0,inf
1224,58,13,71,0,inf
1225,63,12,75,0,inf
1226,53,11,64,0,inf
1227,67,12,79,0,inf
1228,54,11,65,1,9.021520810151124
1229,65,13,78,1,8.704308183316016
1230,57,9,66,0,inf
1231,66,6,72,0,inf
1232,64,9,73,0,inf
1233,56,10,66,0,inf
1234,62,7,69,0,inf
1235,65,9,74,0,inf
1236,67,11,78,0,inf
1237,61,11,72,0,inf
1238,63,6,69,1,1.1601503089326428
1239,60,10,70,0,inf
1240,59,11,70,0,inf
1241,56,8,64,0,inf
1242,66,9,75,0,inf
1243,50,9,59,0,inf
1244,67,10,77,0,inf
1245,66,13,79,0,inf
1246,65,5,70,0,inf
1247,62,11,73,0,inf
1248,63,9,72,0,inf
1249,65,12,77,0,inf
1250,65,9,74,0,inf
1251,67,10,77,0,inf
1252,62,7,69,0,inf
1253,62,9,71,0,inf
1254,53,9,62,0,inf
1255,67,11,78,0,inf
1256,66,7,73,0,inf
1257,55,12,67,0,inf
1258,52,8,60,0,inf
1259,50,7,57,0,inf
1260,64,9,73,0,inf
1261,52,13,65,0,inf
1262,52,6,58,0,inf
1263,57,9,66,0,inf
1264,55,11,66,0,inf
1265,57,7,64,0,inf
1266,55,9,64,0,inf
1267,55,6,61,0,inf
1268,51,8,59,0,inf
1269,52,7,59,0,inf
1270,62,13,75,0,inf
1271,65,9,74,0,inf
1272,58,12,70,0,inf
1273,53,6,59,0,inf
1274,66,13,79,0,inf
1275,60,6,66,0,inf
1276,60,5,65,0,inf
1277,57,12,69,0,inf
1278,64,11,75,0,inf
1279,50,7,57,0,inf
1280,61,5,66,0,inf
1281,57,12,69,0,inf
1282,60,11,71,0,inf
1283,60,5,65,0,inf
1284,67,5,72,0,inf
1285,65,12,77,0,inf
1286,52,9,61,0,inf
1287,56,8,64,0,inf
1288,67,13,80,0,inf
1289,67,12,79,0,inf
1290,65,5,70,0,inf
1291,56,5,61,0,inf
1292,64,9,73,0,inf
1293,54,13,67,0,inf
1294,57,6,63,0,inf
1295,66,6,72,0,inf
1296,52,11,63,0,inf
1297,56,8,64,0,inf
1298,53,6,59,0,inf
1299,64,8,72,0,inf
1300,58,12,70,0,inf
1301,54,11,65,1,10.300057962907758
1302,66,11,77,0,inf
1303,50,9,59,0,inf
1304,51,12,63,0,inf
1305,53,8,61,0,inf
1306,66,5,71,0,inf
1307,61,10,71,0,inf
1308,57,8,65,0,inf
1309,53,11,64,0,inf
1310,56,7,63,0,inf
1311,62,9,71,0,inf
1312,57,12,69,0,inf
1313,60,5,65,0,inf
1314,55,9,64,0,inf
1315,56,5,61,0,inf
1316,57,10,67,0,inf
1317,53,8,61,0,inf
1318,67,5,72,0,inf
1319,55,11,66,0,inf
1320,54,6,60,0,inf
1321,67,10,77,0,inf
1322,63,8,71,0,inf
1323,54,12,66,0,inf
1324,54,6,60,0,inf
1325,59,13,72,0,inf
1326,65,5,70,0,inf
1327,59,10,69,0,inf
1328,51,9,60,1,1.5844803415470992
1329,56,9,65,0,inf
1330,60,7,67,0,inf
1331,55,5,60,0,inf
1332,50,13,63,0,inf
1333,54,12,66,0,inf
1334,60,7,67,0,inf
1335,60,10,70,0,inf
1336,54,9,63,0,inf
1337,65,10,75,0,inf
1338,54,7,61,0,inf
1339,58,5,63,0,inf
1340,60,5,65,0,inf
1341,60,6,66,0,inf
1342,66,9,75,1,3.3300320775256864
1343,54,5,59,0,inf
1344,65,6,71,0,inf
1345,64,5,69,0,inf
1346,56,13,69,0,inf
1347,62,11,73,0,inf
1348,54,9,63,0,inf
1349,60,8,68,0,inf
1350,54,11,65,0,inf
1351,67,11,78,0,inf
1352,63,10,73,0,inf
1353,50,12,62,0,inf
1354,53,10,63,0,inf
1355,57,11,68,0,inf
1356,60,9,69,0,inf
1357,58,11,69,0,inf
1358,59,12,71,0,inf
1359,59,12,71,0,inf
1360,56,10,66,0,inf
1361,51,10,61,0,inf
1362,65,12,77,0,inf
1363,65,8,73,0,inf
1364,67,11,78,0,inf
1365,57,12,69,0,inf
1366,58,9,67,0,inf
1367,64,13,77,0,inf
1368,53,10,63,0,inf
1369,61,7,68,1,6.386904966280326
1370,63,11,74,0,inf
1371,56,6,62,0,inf
1372,62,10,72,0,inf
1373,57,12,69,0,inf
1374,62,13,75,0,inf
1375,63,5,68,0,inf
1376,61,12,73,0,inf
1377,67,12,79,0,inf
1378,59,5,64,0,inf
1379,62,13,75,0,inf
1380,60,6,66,0,inf
1381,63,11,74,0,inf
1382,56,7,63,0,inf
1383,65,7,72,0,inf
1384,60,9,69,1,2.270219974830823
1385,61,8,69,0,inf
1386,58,5,63,0,inf
1387,53,11,64,0,inf
1388,55,12,67,0,inf
1389,52,8,60,0,inf
1390,52,10,62,0,inf
1391,51,12,63,0,inf
1392,57,11,68,0,inf
1393,54,9,63,0,inf
1394,51,7,58,0,inf
1395,56,6,62,0,inf
1396,51,9,60,0,inf
1397,63,6,69,0,inf
1398,63,9,72,0,inf
1399,66,5,71,0,inf
1400,50,7,57,0,inf
1401,56,12,68,0,inf
1402,53,13,66,0,inf
1403,59,8,67,0,inf
1404,60,6,66,0,inf
1405,63,5,68,0,inf
1406,50,12,62,0,inf
1407,51,9,60,0,inf
1408,59,13,72,0,inf
1409,56,12,68,0,inf
1410,62,5,67,0,inf
1411,53,7,60,0,inf
1412,53,5,58,0,inf
1413,63,10,73,0,inf
1414,62,6,68,0,inf
1415,65,5,70,0,inf
1416,58,11,69,0,inf
1417,53,6,59,0,inf
1418,53,11,64,0,inf
1419,65,9,74,0,inf
1420,63,6,69,0,inf
1421,62,12,74,0,inf
1422,66,7,73,0,inf
1423,55,7,62,0,inf
1424,59,13,72,0,inf
1425,51,8,59,0,inf
1426,63,8,71,0,inf
1427,65,12,77,0,inf
1428,60,10,70,0,inf
1429,51,10,61,0,inf
1430,55,11,66,0,inf
1431,56,5,61,0,inf
1432,53,8,61,0,inf
1433,58,11,69,0,inf
1434,67,10,77,0,inf
1435,53,10,63,0,inf
1436,51,11,62,0,inf
1437,59,12,71,0,inf
1438,50,11,61,0,inf
1439,60,10,70,1,4.961655097297339
1440,51,12,63,0,inf
1441,67,5,72,0,inf
1442,58,12,70,0,inf
1443,66,5,71,0,inf
1444,58,8,66,0,inf
1445,61,10,71,0,inf
1446,58,12,70,0,inf
1447,66,10,76,0,inf
1448,53,5,58,0,inf
1449,50,6,56,0,inf
1450,62,9,71,0,inf
1451,62,12,74,0,inf
1452,56,6,62,0,inf
1453,63,8,71,0,inf
1454,63,11,74,0,inf
1455,61,8,69,0,inf
1456,58,13,71,0,inf
1457,59,10,69,0,inf
1458,67,10,77,0,inf
1459,63,9,72,0,inf
1460,61,12,73,0,inf
1461,63,11,74,0,inf
1462,65,8,73,0,inf
1463,50,13,63,0,inf
1464,53,8,61,0,inf
1465,62,6,68,0,inf
1466,52,6,58,0,inf
1467,61,10,71,0,inf
1468,67,10,77,0,inf
1469,56,10,66,0,inf
1470,51,7,58,0,inf
1471,67,13,80,0,inf
1472,65,5,70,0,inf
1473,67,5,72,0,inf
1474,62,11,73,0,inf
1475,55,8,63,0,inf
1476,54,5,59,0,inf
1477,60,8,68,0,inf
1478,61,12,73,0,inf
1479,50,10,60,0,inf
1480,59,5,64,0,inf
1481,66,7,73,0,inf
1482,58,7,65,0,inf
1483,62,5,67,0,inf
1484,64,6,70,0,inf
1485,67,11,78,0,inf
1486,58,7,65,0,inf
1487,53,5,58,0,inf
1488,58,9,67,0,inf
1489,51,8,59,0,inf
1490,64,10,74,0,inf
1491,50,5,55,0,inf
1492,66,13,79,0,inf
1493,52,12,64,0,inf
1494,56,12,68,0,inf
1495,66,12,78,0,inf
1496,54,7,61,0,inf
1497,64,13,77,0,inf
1498,51,6,57,0,inf
1499,60,8,68,0,inf
1500,60,11,71,0,inf
1501,67,6,73,0,inf
1502,62,5,67,0,inf
1503,52,6,58,0,inf
1504,56,13,69,0,inf
1505,57,8,65,0,inf
1506,60,7,67,0,inf
1507,56,11,67,0,inf
1508,59,10,69,0,inf
1509,53,13,66,0,inf
1510,60,10,70,0,inf
1511,56,11,67,0,inf
1512,52,9,61,0,inf
1513,56,7,63,0,inf
1514,52,6,58,0,inf
1515,65,5,70,0,inf
1516,54,6,60,0,inf
1517,52,8,60,0,inf
1518,62,13,75,0,inf
1519,54,8,62,0,inf
1520,63,11,74,0,inf
1521,56,13,69,0,inf
1522,53,10,63,0,inf
1523,63,13,76,0,inf
1524,67,13,80,0,inf
1525,54,13,67,0,inf
1526,55,10,65,0,inf
1527,61,12,73,0,inf
1528,63,6,69,0,inf
1529,52,10,62,0,inf
1530,54,11,65,1,0.4733593884185865
1531,67,9,76,0,inf
1532,65,11,76,0,inf
1533,67,9,76,0,inf
1534,67,9,76,0,inf
1535,53,12,65,0,inf
1536,66,12,78,0,inf
1537,54,7,61,0,inf
1538,55,13,68,0,inf
1539,57,11,68,0,inf
1540,67,9,76,0,inf
1541,56,12,68,0,inf
1542,64,9,73,0,inf
1543,53,12,65,0,inf
1544,56,8,64,0,inf
1545,51,9,60,0,inf
1546,64,11,75,0,inf
1547,55,6,61,0,inf
1548,60,9,69,0,inf
1549,66,12,78,0,inf
1550,60,5,65,0,inf
1551,52,11,63,0,inf
1552,55,12,67,0,inf
1553,55,8,63,0,inf
1554,50,11,61,0,inf
1555,64,6,70,0,inf
1556,63,9,72,0,inf
1557,66,7,73,0,inf
1558,64,13,77,0,inf
1559,50,13,63,0,inf
1560,60,13,73,1,7.854130377343537
1561,54,9,63,0,inf
1562,64,6,70,0,inf
1563,61,6,67,0,inf
1564,61,5,66,0,inf
1565,54,12,66,0,inf
1566,58,13,71,0,inf
1567,50,8,58,0,inf
1568,67,10,77,0,inf
1569,67,6,73,0,inf
1570,53,9,62,0,inf
1571,63,7,70,0,inf
1572,54,13,67,0,inf
1573,61,12,73,0,inf
1574,54,7,61,0,inf
1575,63,5,68,0,inf
1576,63,12,75,0,inf
1577,52,11,63,0,inf
1578,67,10,77,0,inf
1579,59,8,67,0,inf
1580,60,9,69,0,inf
1581,66,6,72,0,inf
1582,50,10,60,0,inf
1583,53,6,59,0,inf
1584,58,10,68,0,inf
1585,60,5,65,0,inf
1586,67,12,79,0,inf
1587,61,13,74,0,inf
1588,52,7,59,0,inf
1589,57,8,65,0,inf
1590,62,13,75,0,inf
1591,58,13,71,0,inf
1592,58,9,67,0,inf
1593,54,13,67,0,inf
1594,55,8,63,0,inf
1595,52,12,64,0,inf
1596,64,12,76,1,9.930246878271234
1597,61,12,73,0,inf
1598,57,11,68,0,inf
1599,60,9,69,0,inf
1600,63,6,69,0,inf
1601,56,9,65,0,inf
1602,54,12,66,0,inf
1603,58,12,70,0,inf
1604,62,9,71,0,inf
1605,58,11,69,0,inf
1606,57,9,66,0,inf
1607,60,7,67,0,inf
1608,63,9,72,0,inf
1609,58,5,63,0,inf
1610,66,11,77,0,inf
1611,65,10,75,0,inf
1612,63,11,74,0,inf
1613,63,12,75,0,inf
1614,58,7,65,0,inf
1615,63,7,70,0,inf
1616,54,9,63,0,inf
1617,53,7,60,0,inf
1618,64,8,72,0,inf
1619,58,8,66,0,inf
1620,59,8,67,0,inf
1621,63,11,74,0,inf
1622,60,7,67,0,inf
1623,62,13,75,0,inf
1624,59,6,65,0,inf
1625,63,5,68,0,inf
1626,58,13,71,0,inf
1627,67,6,73,0,inf
1628,51,11,62,0,inf
1629,59,13,72,0,inf
1630,62,6,68,0,inf
1631,52,7,59,0,inf
1632,66,8,74,0,inf
1633,65,6,71,0,inf
1634,54,13,67,0,inf
1635,65,5,70,0,inf
1636,54,5,59,0,inf
1637,58,6,64,0,inf
1638,67,6,73,0,inf
1639,66,8,74,0,inf
1640,61,9,70,0,inf
1641,50,13,63,0,inf
1642,57,7,64,0,inf
1643,62,10,72,0,inf
1644,65,8,73,0,inf
1645,55,7,62,0,inf
1646,54,7,61,0,inf
1647,50,8,58,0,inf
1648,63,6,69,0,inf
1649,58,10,68,0,inf
1650,63,13,76,0,inf
1651,50,11,61,0,inf
1652,60,8,68,0,inf
1653,55,11,66,0,inf
1654,53,5,58,0,inf
1655,51,6,57,0,inf
1656,60,5,65,0,inf
1657,58,8,66,0,inf
1658,64,12,76,0,inf
1659,57,10,67,0,inf
1660,57,13,70,0,inf
1661,53,9,62,0,inf
1662,57,9,66,0,inf
1663,66,7,73,0,inf
1664,55,9,64,0,inf
1665,53,8,61,0,inf
1666,65,8,73,0,inf
1667,55,7,62,0,inf
1668,65,8,73,1,0.5295054802345618
1669,59,12,71,0,inf
1670,54,8,62,0,inf
1671,53,5,58,0,inf
1672,59,5,64,0,inf
1673,58,6,64,0,inf
1674,50,10,60,0,inf
1675,60,6,66,0,inf
1676,54,11,65,0,inf
1677,55,7,62,0,inf
1678,56,7,63,0,inf
1679,65,9,74,0,inf
1680,65,10,75,0,inf
1681,50,11,61,0,inf
1682,66,6,72,0,inf
1683,53,11,64,0,inf
1684,66,6,72,0,inf
1685,65,11,76,0,inf
1686,58,6,64,0,inf
1687,64,13,77,0,inf
1688,66,7,73,0,inf
1689,61,5,66,0,inf
1690,54,7,61,0,inf
1691,54,10,64,0,inf
1692,55,5,60,0,inf
1693,51,7,58,0,inf
1694,65,8,73,0,inf
1695,57,12,69,0,inf
1696,57,11,68,0,inf
1697,67,9,76,0,inf
1698,65,8,73,0,inf
1699,59,6,65,0,inf
1700,53,8,61,0,inf
1701,55,8,63,0,inf
1702,64,12,76,0,inf
1703,57,9,66,0,inf
1704,64,13,77,0,inf
1705,58,6,64,0,inf
1706,53,13,66,0,inf
1707,51,5,56,0,inf
1708,59,9,68,0,inf
1709,54,11,65,0,inf
1710,57,11,68,0,inf
1711,55,7,62,0,inf
1712,53,10,63,0,inf
1713,54,10,64,0,inf
1714,56,13,69,0,inf
1715,58,12,70,0,inf
1716,63,11,74,0,inf
1717,53,7,60,0,inf
1718,65,11,76,0,inf
1719,53,11,64,0,inf
1720,52,11,63,0,inf
1721,62,11,73,0,inf
1722,66,10,76,0,inf
1723,58,7,65,0,inf
1724,58,13,71,0,inf
1725,66,7,73,0,inf
1726,60,6,66,0,inf
1727,53,9,62,0,inf
1728,63,10,73,0,inf
1729,65,10,75,0,inf
1730,54,13,67,0,inf
1731,54,8,62,0,inf
1732,64,8,72,0,inf
1733,55,13,68,0,inf
1734,55,5,60,0,inf
1735,51,8,59,0,inf
1736,65,10,75,0,inf
1737,65,6,71,0,inf
1738,62,5,67,0,inf
1739,61,13,74,0,inf
1740,59,6,65,0,inf
1741,52,9,61,0,inf
1742,51,7,58,0,inf
1743,66,5,71,0,inf
1744,59,5,64,0,inf
1745,56,7,63,0,inf
1746,67,12,79,0,inf
1747,64,10,74,0,inf
1748,62,6,68,0,inf
1749,54,5,59,0,inf
1750,57,12,69,0,inf
1751,61,8,69,0,inf
1752,66,8,74,0,inf
1753,61,13,74,0,inf
1754,53,7,60,0,inf
1755,51,13,64,0,inf
1756,56,8,64,0,inf
1757,51,12,63,0,inf
1758,52,6,58,0,inf
1759,61,11,72,0,inf
1760,59,7,66,0,inf
1761,59,11,70,0,inf
1762,54,13,67,0,inf
1763,61,7,68,0,inf
1764,66,8,74,0,inf
1765,58,9,67,0,inf
1766,64,8,72,0,inf
1767,64,9,73,0,inf
1768,66,10,76,0,inf
1769,63,12,75,0,inf
1770,63,13,76,0,inf
1771,54,10,64,0,inf
1772,52,10,62,0,inf
1773,51,5,56,0,inf
1774,62,7,69,0,inf
1775,58,7,65,0,inf
1776,57,8,65,0,inf
1777,55,12,67,0,inf
1778,67,12,79,0,inf
1779,59,13,72,0,inf
1780,64,6,70,0,inf
1781,57,5,62,0,inf
1782,59,12,71,0,inf
1783,59,13,72,0,inf
1784,63,5,68,0,inf
1785,63,11,74,0,inf
1786,54,5,59,0,inf
1787,50,8,58,0,inf
1788,64,8,72,0,inf
1789,61,13,74,0,inf
1790,64,13,77,0,inf
1791,56,13,69,0,inf
1792,55,8,63,0,inf
1793,65,11,76,0,inf
1794,54,8,62,0,inf
1795,55,7,62,0,inf
1796,50,10,60,0,inf
1797,57,5,62,0,inf
1798,66,6,72,0,inf
1799,51,7,58,0,inf
1800,64,10,74,0,inf
1801,52,10,62,0,inf
1802,62,5,67,0,inf
1803,62,12,74,0,inf
1804,66,9,75,0,inf
1805,63,11,74,0,inf
1806,59,11,70,0,inf
1807,56,7,63,0,inf
1808,62,12,74,0,inf
1809,67,11,78,0,inf
1810,64,8,72,0,inf
1811,66,11,77,0,inf
1812,67,13,80,0,inf
1813,67,13,80,0,inf
1814,56,8,64,0,inf
1815,66,6,72,0,inf
1816,54,10,64,0,inf
1817,61,13,74,0,inf
1818,50,9,59,0,inf
1819,66,12,78,0,inf
1820,56,6,62,0,inf
1821,63,7,70,0,inf
1822,50,11,61,0,inf
1823,54,13,67,0,inf
1824,59,10,69,0,inf
1825,66,11,77,1,7.903269347638201
1826,61,12,73,0,inf
1827,58,13,71,0,inf
1828,61,9,70,0,inf
1829,63,13,76,0,inf
1830,56,6,62,0,inf
1831,60,8,68,0,inf
1832,54,10,64,0,inf
1833,61,5,66,0,inf
1834,52,11,63,0,inf
1835,61,9,70,0,inf
1836,55,11,66,0,inf
1837,64,5,69,0,inf
1838,65,11,76,0,inf
1839,58,6,64,1,4.7332582075864735
1840,65,12,77,1,5.7553186592424055
1841,63,11,74,0,inf
1842,52,10,62,0,inf
1843,54,10,64,0,inf
1844,59,11,70,0,inf
1845,51,5,56,0,inf
1846,65,5,70,1,3.4486486319689647
1847,61,9,70,0,inf
1848,58,11,69,0,inf
1849,63,10,73,0,inf
1850,67,9,76,0,inf
1851,56,12,68,0,inf
1852,51,7,58,1,5.205308328359386
1853,52,8,60,0,inf
1854,51,8,59,0,inf
1855,56,10,66,0,inf
1856,60,8,68,0,inf
1857,53,5,58,0,inf
1858,67,12,79,0,inf
1859,55,8,63,0,inf
1860,52,12,64,0,inf
1861,65,5,70,0,inf
1862,66,8,74,0,inf
1863,60,6,66,0,inf
1864,52,5,57,0,inf
1865,67,10,77,0,inf
1866,53,8,61,0,inf
1867,61,8,69,0,inf
1868,51,8,59,0,inf
1869,50,5,55,0,inf
1870,65,13,78,0,inf
1871,52,13,65,0,inf
1872,52,12,64,0,inf
1873,55,13,68,0,inf
1874,53,12,65,0,inf
1875,62,9,71,0,inf
1876,58,13,71,0,inf
1877,55,9,64,0,inf
1878,58,7,65,0,inf
1879,63,13,76,0,inf
1880,60,8,68,0,inf
1881,53,12,65,0,inf
1882,61,11,72,0,inf
1883,57,9,66,0,inf
1884,62,6,68,0,inf
1885,52,5,57,0,inf
1886,59,6,65,0,inf
1887,61,8,69,0,inf
1888,58,10,68,0,inf
1889,59,8,67,0,inf
1890,54,8,62,0,inf
1891,56,7,63,0,inf
1892,52,8,60,0,inf
1893,64,6,70,0,inf
1894,61,13,74,0,inf
1895,66,9,75,0,inf
1896,66,5,71,0,inf
1897,55,6,61,0,inf
1898,62,12,74,0,inf
1899,55,7,62,0,inf
1900,52,7,59,0,inf
1901,58,11,69,0,inf
1902,67,12,79,0,inf
1903,53,11,64,0,inf
1904,51,7,58,0,inf
1905,50,10,60,0,inf
1906,54,5,59,0,inf
1907,55,11,66,0,inf
1908,60,7,67,0,inf
1909,53,9,62,0,inf
1910,55,9,64,0,inf
1911,56,6,62,0,inf
1912,63,13,76,0,inf
1913,63,10,73,0,inf
1914,62,10,72,0,inf
1915,50,10,60,0,inf
1916,66,8,74,0,inf
1917,67,9,76,0,inf
1918,56,9,65,0,inf
1919,58,13,71,0,inf
1920,56,11,67,0,inf
1921,65,13,78,0,inf
1922,57,5,62,0,inf
1923,51,9,60,0,inf
1924,62,8,70,0,inf
1925,55,9,64,0,inf
1926,63,7,70,0,inf
1927,53,13,66,0,inf
1928,65,8,73,0,inf
1929,60,5,65,0,inf
1930,56,9,65,0,inf
1931,56,12,68,0,inf
1932,57,8,65,0,inf
1933,50,10,60,0,inf
1934,62,6,68,0,inf
1935,64,6,70,0,inf
1936,67,5,72,0,inf
1937,67,6,73,0,inf
1938,55,10,65,0,inf
1939,56,9,65,0,inf
1940,59,12,71,0,inf
1941,57,13,70,0,inf
1942,50,10,60,0,inf
1943,64,10,74,0,inf
1944,54,9,63,0,inf
1945,55,7,62,0,inf
1946,64,6,70,0,inf
1947,56,6,62,0,inf
1948,58,9,67,0,inf
1949,57,13,70,0,inf
1950,59,13,72,0,inf
1951,52,12,64,0,inf
1952,65,13,78,0,inf
1953,54,11,65,0,inf
1954,58,5,63,0,inf
1955,67,5,72,0,inf
1956,64,13,77,0,inf
1957,66,7,73,0,inf
1958,55,10,65,0,inf
1959,51,7,58,0,inf
1960,51,13,64,0,inf
1961,56,7,63,0,inf
1962,58,9,67,0,inf
1963,56,8,64,0,inf
1964,55,13,68,0,inf
1965,60,10,70,0,inf
1966,57,12,69,0,inf
1967,51,6,57,0,inf
1968,65,11,76,0,inf
1969,50,12,62,0,inf
1970,67,13,80,0,inf
1971,54,8,62,0,inf
1972,62,11,73,0,inf
1973,66,5,71,0,inf
1974,51,10,61,0,inf
1975,54,7,61,0,inf
1976,53,13,66,0,inf
1977,67,5,72,0,inf
1978,62,7,69,1,5.05056043647258
1979,54,9,63,0,inf
1980,54,10,64,1,7.552730985754067
1981,61,7,68,0,inf
1982,58,7,65,0,inf
1983,67,8,75,0,inf
1984,66,9,75,0,inf
1985,59,12,71,0,inf
1986,53,9,62,0,inf
1987,50,10,60,0,inf
1988,66,5,71,0,inf
1989,66,13,79,1,11.100440803541673
1990,62,9,71,0,inf
1991,59,12,71,0,inf
1992,55,12,67,0,inf
1993,54,7,61,0,inf
1994,65,6,71,0,inf
1995,56,13,69,0,inf
1996,67,9,76,0,inf
1997,62,7,69,0,inf
1998,53,8,61,0,inf
1999,55,5,60,0,inf
2000,51,11,62,0,inf
2001,53,7,60,0,inf
2002,51,8,59,0,inf
2003,56,10,66,0,inf
2004,55,7,62,0,inf
2005,64,8,72,0,inf
2006,65,13,78,0,inf
2007,63,5,68,0,inf
2008,58,13,71,0,inf
2009,50,13,63,0,inf
2010,50,13,63,0,inf
2011,64,13,77,0,inf
2012,56,5,61,0,inf
2013,67,13,80,0,inf
2014,56,13,69,0,inf
2015,57,12,69,0,inf
2016,58,7,65,0,inf
2017,63,10,73,0,inf
2018,51,7,58,0,inf
2019,51,11,62,0,inf
2020,67,12,79,0,inf
2021,52,11,63,0,inf
2022,66,8,74,0,inf
2023,65,7,72,0,inf
2024,57,8,65,0,inf
2025,61,9,70,1,0.7210373940156103
2026,52,6,58,0,inf
2027,59,6,65,0,inf
2028,58,9,67,0,inf
2029,62,8,70,0,inf
2030,65,12,77,0,inf
2031,61,13,74,1,11.346148789625673
2032,59,7,66,0,inf
2033,54,12,66,0,inf
2034,66,9,75,1,3.105157068203212
2035,56,10,66,0,inf
2036,63,5,68,0,inf
2037,64,10,74,0,inf
2038,66,5,71,0,inf
2039,54,13,67,0,inf
2040,62,8,70,0,inf
2041,52,13,65,0,inf
2042,55,13,68,0,inf
2043,55,5,60,0,inf
2044,62,13,75,0,inf
2045,63,13,76,0,inf
2046,61,9,70,0,inf
2047,59,12,71,0,inf
2048,50,7,57,0,inf
2049,61,10,71,0,inf
2050,66,9,75,0,inf
2051,66,12,78,0,inf
2052,60,5,65,0,inf
2053,51,7,58,0,inf
2054,65,7,72,0,inf
2055,52,13,65,0,inf
2056,65,12,77,0,inf
2057,62,8,70,0,inf
2058,67,7,74,0,inf
2059,63,8,71,0,inf
2060,52,9,61,0,inf
2061,53,5,58,0,inf
2062,58,5,63,0,inf
2063,58,8,66,0,inf
2064,52,12,64,0,inf
2065,57,6,63,0,inf
2066,59,10,69,0,inf
2067,64,11,75,0,inf
2068,55,13,68,0,inf
2069,51,9,60,0,inf
2070,65,12,77,0,inf
2071,51,9,60,0,inf
2072,56,8,64,0,inf
2073,53,8,61,0,inf
2074,67,9,76,0,inf
2075,67,5,72,0,inf
2076,56,8,64,0,inf
2077,53,13,66,0,inf
2078,63,7,70,0,inf
2079,54,6,60,0,inf
2080,58,12,70,0,inf
2081,57,12,69,0,inf
2082,67,7,74,0,inf
2083,63,7,70,0,inf
2084,63,12,75,0,inf
2085,57,11,68,0,inf
2086,53,7,60,0,inf
2087,50,11,61,0,inf
2088,62,8,70,0,inf
2089,65,5,70,0,inf
2090,53,13,66,0,inf
2091,52,11,63,0,inf
2092,57,11,68,0,inf
2093,58,12,70,0,inf
2094,64,9,73,0,inf
2095,65,11,76,0,inf
2096,53,10,63,0,inf
2097,50,8,58,0,inf
2098,57,12,69,0,inf
2099,56,9,65,0,inf
2100,62,9,71,0,inf
2101,64,9,73,0,inf
2102,66,8,74,0,inf
2103,50,12,62,0,inf
2104,57,11,68,0,inf
2105,67,7,74,0,inf
2106,50,12,62,0,inf
2107,58,6,64,0,inf
2108,64,12,76,0,inf
2109,57,12,69,0,inf
2110,64,5,69,0,inf
2111,63,5,68,0,inf
2112,53,9,62,0,inf
2113,53,5,58,0,inf
2114,61,9,70,0,inf
2115,50,5,55,0,inf
2116,64,7,71,0,inf
2117,50,13,63,0,inf
2118,63,6,69,0,inf
2119,64,13,77,0,inf
2120,67,13,80,0,inf
2121,57,8,65,0,inf
2122,67,7,74,0,inf
2123,63,13,76,0,inf
2124,59,9,68,0,inf
2125,52,12,64,1,5.532139199926213
2126,50,11,61,0,inf
2127,51,11,62,0,inf
2128,57,7,64,0,inf
2129,62,8,70,0,inf
2130,56,9,65,0,inf
2131,55,11,66,0,inf
2132,60,6,66,0,inf
2133,62,11,73,0,inf
2134,52,8,60,0,inf
2135,52,7,59,0,inf
2136,53,7,60,1,1.6115847354017987
2137,50,10,60,0,inf
2138,59,10,69,0,inf
2139,60,11,71,0,inf
2140,56,11,67,0,inf
2141,63,8,71,0,inf
2142,63,9,72,0,inf
2143,61,7,68,0,inf
2144,67,9,76,0,inf
2145,59,7,66,0,inf
2146,57,7,64,0,inf
2147,51,6,57,0,inf
2148,66,5,71,0,inf
2149,52,6,58,0,inf
2150,64,8,72,0,inf
2151,51,13,64,1,9.448803199207774
2152,67,9,76,0,inf
2153,52,7,59,0,inf
2154,61,11,72,0,inf
2155,57,6,63,0,inf
2156,56,12,68,0,inf
2157,60,10,70,0,inf
2158,50,13,63,0,inf
2159,53,12,65,0,inf
2160,57,12,69,0,inf
2161,58,12,70,0,inf
2162,52,10,62,1,2.679602648366725
2163,61,12,73,0,inf
2164,52,9,61,0,inf
2165,54,8,62,0,inf
2166,66,12,78,1,7.6183223526789305
2167,65,11,76,0,inf
2168,67,7,74,0,inf
2169,59,5,64,0,inf
2170,61,10,71,0,inf
2171,65,12,77,0,inf
2172,65,6,71,0,inf
2173,67,5,72,0,inf
2174,61,11,72,0,inf
2175,51,9,60,0,inf
2176,59,13,72,0,inf
2177,63,13,76,0,inf
2178,50,6,56,0,inf
2179,65,8,73,0,inf
2180,53,10,63,0,inf
2181,52,6,58,0,inf
2182,66,11,77,0,inf
2183,52,13,65,0,inf
2184,66,8,74,0,inf
2185,61,12,73,0,inf
2186,57,6,63,0,inf
2187,64,12,76,0,inf
2188,63,9,72,0,inf
2189,52,13,65,0,inf
2190,64,11,75,1,5.926651315524822
2191,60,8,68,0,inf
2192,65,7,72,0,inf
2193,67,10,77,0,inf
2194,55,8,63,0,inf
2195,58,6,64,0,inf
2196,50,10,60,0,inf
2197,55,10,65,0,inf
2198,52,6,58,0,inf
2199,58,6,64,0,inf
2200,64,8,72,1,1.2361705020430662
2201,50,13,63,0,inf
2202,50,8,58,0,inf
2203,63,8,71,0,inf
2204,53,11,64,0,inf
2205,67,12,79,0,inf
2206,55,7,62,0,inf
2207,54,10,64,0,inf
2208,51,12,63,0,inf
2209,55,6,61,0,inf
2210,64,12,76,0,inf
2211,61,5,66,0,inf
2212,62,6,68,0,inf
2213,51,12,63,0,inf
2214,50,12,62,0,inf
2215,60,6,66,0,inf
2216,57,10,67,0,inf
2217,66,6,72,0,inf
2218,50,5,55,0,inf
2219,56,8,64,0,inf
2220,59,8,67,0,inf
2221,62,7,69,0,inf
2222,66,13,79,0,inf
2223,52,10,62,0,inf
2224,50,11,61,0,inf
2225,54,10,64,0,inf
2226,53,7,60,0,inf
2227,65,8,73,0,inf
2228,52,9,61,1,5.886965299390617
2229,55,11,66,0,inf
2230,54,8,62,0,inf
2231,66,8,74,0,inf
2232,50,9,59,0,inf
2233,51,5,56,0,inf
2234,67,5,72,0,inf
2235,59,10,69,0,inf
2236,63,9,72,0,inf
2237,60,5,65,0,inf
2238,57,10,67,0,inf
2239,51,10,61,0,inf
2240,63,9,72,0,inf
2241,57,10,67,0,inf
2242,63,7,70,0,inf
2243,51,11,62,0,inf
2244,51,13,64,0,inf
2245,64,6,70,0,inf
2246,60,10,70,0,inf
2247,63,9,72,0,inf
2248,57,7,64,0,inf
2249,60,10,70,0,inf
2250,51,10,61,0,inf
2251,53,10,63,0,inf
2252,52,6,58,0,inf
2253,60,13,73,0,inf
2254,67,12,79,0,inf
2255,56,11,67,0,inf
2256,57,9,66,0,inf
2257,59,8,67,0,inf
2258,65,13,78,0,inf
2259,55,5,60,0,inf
2260,52,7,59,0,inf
2261,54,8,62,0,inf
2262,62,7,69,0,inf
2263,64,6,70,0,inf
2264,50,6,56,0,inf
2265,67,5,72,0,inf
2266,61,9,70,0,inf
2267,65,9,74,0,inf
2268,67,5,72,0,inf
2269,60,7,67,0,inf
2270,50,10,60,0,inf
2271,52,12,64,0,inf
2272,64,9,73,0,inf
2273,63,10,73,0,inf
2274,55,5,60,0,inf
2275,67,10,77,1,4.995072650226973
2276,60,6,66,0,inf
2277,59,8,67,0,inf
2278,53,8,61,0,inf
2279,57,6,63,0,inf
2280,59,5,64,0,inf
2281,66,11,77,0,inf
2282,56,13,69,0,inf
2283,67,11,78,0,inf
2284,62,11,73,0,inf
2285,66,6,72,0,inf
2286,51,9,60,0,inf
2287,50,13,63,0,inf
2288,50,8,58,0,inf
2289,55,10,65,0,inf
2290,55,7,62,0,inf
2291,66,7,73,0,inf
2292,55,10,65,0,inf
2293,56,9,65,0,inf
2294,53,6,59,0,inf
2295,64,8,72,0,inf
2296,58,10,68,0,inf
2297,61,12,73,0,inf
2298,58,12,70,0,inf
2299,51,10,61,0,inf
2300,56,7,63,0,inf
2301,53,5,58,0,inf
2302,62,5,67,0,inf
2303,63,7,70,0,inf
2304,54,5,59,0,inf
2305,52,5,57,0,inf
2306,59,10,69,0,inf
2307,67,6,73,1,5.372882105164052
2308,60,9,69,0,inf
2309,67,8,75,0,inf
2310,65,8,73,0,inf
2311,56,7,63,0,inf
2312,55,5,60,0,inf
2313,64,11,75,0,inf
2314,50,13,63,0,inf
2315,62,12,74,0,inf
2316,51,7,58,0,inf
2317,65,11,76,0,inf
2318,61,10,71,0,inf
2319,61,7,68,1,5.461632740160937
2320,55,11,66,0,inf
2321,62,11,73,0,inf
2322,58,13,71,0,inf
2323,63,7,70,0,inf
2324,54,8,62,0,inf
2325,53,13,66,0,inf
2326,55,11,66,1,8.721881871602292
2327,62,6,68,0,inf
2328,57,7,64,0,inf
2329,56,9,65,0,inf
2330,59,6,65,0,inf
2331,53,13,66,0,inf
2332,67,7,74,0,inf
2333,57,11,68,0,inf
2334,51,7,58,0,inf
2335,58,7,65,0,inf
2336,55,7,62,0,inf
2337,50,11,61,0,inf
2338,66,13,79,0,inf
2339,61,12,73,0,inf
2340,56,6,62,0,inf
2341,59,10,69,0,inf
2342,55,12,67,0,inf
2343,63,10,73,0,inf
2344,54,10,64,0,inf
2345,50,11,61,0,inf
2346,58,13,71,0,inf
2347,66,11,77,0,inf
2348,67,7,74,0,inf
2349,55,13,68,0,inf
2350,57,5,62,0,inf
2351,57,9,66,0,inf
2352,50,11,61,0,inf
2353,60,12,72,0,inf
2354,51,11,62,0,inf
2355,59,12,71,1,5.225804099060738
2356,52,12,64,0,inf
2357,57,13,70,0,inf
2358,64,6,70,0,inf
2359,60,13,73,0,inf
2360,58,7,65,0,inf
2361,54,10,64,0,inf
2362,67,11,78,0,inf
2363,53,6,59,0,inf
2364,64,10,74,0,inf
2365,55,7,62,0,inf
2366,63,9,72,0,inf
2367,55,5,60,0,inf
2368,51,11,62,0,inf
2369,51,9,60,0,inf
2370,50,9,59,0,inf
2371,59,9,68,0,inf
2372,60,11,71,0,inf
2373,57,7,64,0,inf
2374,52,5,57,0,inf
2375,50,10,60,0,inf
2376,65,10,75,0,inf
2377,64,11,75,0,inf
2378,54,9,63,0,inf
2379,65,10,75,0,inf
2380,60,7,67,0,inf
2381,64,9,73,0,inf
2382,56,6,62,1,0.8501837408607571
2383,56,8,64,0,inf
2384,55,13,68,0,inf
2385,56,5,61,0,inf
2386,60,5,65,0,inf
2387,65,10,75,0,inf
2388,55,11,66,0,inf
2389,54,9,63,0,inf
2390,57,6,63,0,inf
2391,62,10,72,0,inf
2392,52,12,64,0,inf
2393,67,11,78,0,inf
2394,63,12,75,0,inf
2395,63,7,70,0,inf
2396,65,12,77,0,inf
2397,55,10,65,0,inf
2398,55,11,66,0,inf
2399,57,10,67,0,inf
2400,63,13,76,0,inf
2401,58,7,65,0,inf
2402,52,9,61,0,inf
2403,53,8,61,0,inf
2404,67,12,79,0,inf
2405,51,6,57,0,inf
2406,64,7,71,1,3.513956590112315
2407,63,10,73,0,inf
2408,60,13,73,0,inf
2409,64,8,72,0,inf
2410,61,12,73,0,inf
2411,51,5,56,0,inf
2412,67,7,74,0,inf
2413,60,5,65,0,inf
2414,63,13,76,0,inf
2415,61,11,72,0,inf
2416,64,5,69,0,inf
2417,53,5,58,0,inf
2418,59,6,65,0,inf
2419,54,9,63,0,inf
2420,55,8,63,0,inf
2421,58,9,67,0,inf
2422,60,10,70,0,inf
2423,52,7,59,0,inf
2424,56,13,69,0,inf
2425,59,7,66,0,inf
2426,53,10,63,0,inf
2427,63,12,75,0,inf
2428,63,9,72,0,inf
2429,55,12,67,0,inf
2430,66,12,78,0,inf
2431,50,12,62,0,inf
2432,56,11,67,0,inf
2433,58,6,64,0,inf
2434,65,5,70,0,inf
2435,60,7,67,0,inf
2436,64,6,70,0,inf
2437,67,11,78,0,inf
2438,52,12,64,0,inf
2439,52,13,65,0,inf
2440,52,8,60,0,inf
2441,60,9,69,0,inf
2442,57,12,69,0,inf
2443,67,9,76,1,4.043208256392262
2444,59,10,69,0,inf
2445,51,13,64,0,inf
2446,62,5,67,0,inf
2447,67,8,75,0,inf
2448,63,5,68,0,inf
2449,57,8,65,0,inf
2450,59,6,65,0,inf
2451,67,11,78,0,inf
2452,53,5,58,0,inf
2453,61,10,71,0,inf
2454,55,13,68,0,inf
2455,51,7,58,0,inf
2456,56,11,67,0,inf
2457,59,8,67,0,inf
2458,63,13,76,0,inf
2459,63,11,74,0,inf
2460,61,13,74,0,inf
2461,52,9,61,0,inf
2462,58,7,65,0,inf
2463,64,12,76,0,inf
2464,67,8,75,0,inf
2465,65,8,73,0,inf
2466,61,13,74,0,inf
2467,55,7,62,0,inf
2468,64,9,73,0,inf
2469,50,10,60,0,inf
2470,57,13,70,0,inf
2471,63,10,73,0,inf
2472,66,10,76,0,inf
2473,62,13,75,0,inf
2474,54,12,66,0,inf
2475,53,8,61,0,inf
2476,55,9,64,0,inf
2477,65,10,75,0,inf
2478,55,8,63,0,inf
2479,55,6,61,0,inf
2480,60,8,68,0,inf
2481,50,7,57,0,inf
2482,61,5,66,0,inf
2483,63,7,70,0,inf
2484,51,11,62,0,inf
2485,50,12,62,0,inf
2486,63,12,75,0,inf
2487,56,9,65,0,inf
2488,55,8,63,0,inf
2489,54,11,65,0,inf
2490,55,7,62,0,inf
2491,54,5,59,0,inf
2492,53,12,65,0,inf
2493,65,12,77,0,inf
2494,52,6,58,0,inf
2495,62,13,75,0,inf
2496,54,6,60,0,inf
2497,62,13,75,0,inf
2498,60,10,70,0,inf
2499,51,7,58,0,inf
2500,57,8,65,0,inf
2501,50,12,62,0,inf
2502,65,7,72,0,inf
2503,67,7,74,0,inf
2504,57,13,70,0,inf
2505,66,9,75,1,3.7749898262707546
2506,62,8,70,0,inf
2507,51,8,59,0,inf
2508,63,13,76,0,inf
2509,62,7,69,0,inf
2510,58,13,71,0,inf
2511,57,5,62,0,inf
2512,62,8,70,0,inf
2513,50,8,58,0,inf
2514,63,6,69,0,inf
2515,58,9,67,0,inf
2516,61,12,73,0,inf
2517,58,5,63,0,inf
2518,51,11,62,0,inf
2519,55,13,68,0,inf
2520,62,13,75,0,inf
2521,57,7,64,0,inf
2522,66,13,79,0,inf
2523,64,10,74,0,inf
2524,61,7,68,0,inf
2525,54,10,64,0,inf
2526,58,7,65,0,inf
2527,50,6,56,0,inf
2528,55,8,63,0,inf
2529,56,6,62,0,inf
2530,51,9,60,0,inf
2531,64,5,69,0,inf
2532,59,12,71,0,inf
2533,66,13,79,0,inf
2534,65,12,77,0,inf
2535,61,13,74,0,inf
2536,56,7,63,0,inf
2537,53,6,59,0,inf
2538,65,13,78,0,inf
2539,53,7,60,0,inf
2540,67,7,74,0,inf
2541,64,9,73,0,inf
2542,58,7,65,0,inf
2543,58,9,67,0,inf
2544,65,12,77,0,inf
2545,67,8,75,0,inf
2546,66,12,78,0,inf
2547,57,5,62,0,inf
2548,66,6,72,0,inf
2549,55,13,68,0,inf
2550,66,9,75,0,inf
2551,65,12,77,0,inf
2552,66,6,72,0,inf
2553,67,7,74,0,inf
2554,60,12,72,0,inf
2555,53,5,58,0,inf
2556,51,5,56,0,inf
2557,52,7,59,0,inf
2558,59,12,71,0,inf
2559,66,11,77,0,inf
2560,63,8,71,0,inf
2561,52,6,58,0,inf
2562,52,6,58,0,inf
2563,51,12,63,0,inf
2564,52,13,65,0,inf
2565,51,11,62,0,inf
2566,56,7,63,0,inf
2567,65,6,71,0,inf
2568,67,9,76,0,inf
2569,62,5,67,0,inf
2570,66,11,77,0,inf
2571,50,7,57,0,inf
2572,57,7,64,0,inf
2573,54,7,61,0,inf
2574,53,9,62,0,inf
2575,59,11,70,0,inf
2576,62,5,67,0,inf
2577,54,6,60,0,inf
2578,52,7,59,1,1.404973872117445
2579,58,12,70,0,inf
2580,52,6,58,0,inf
2581,66,13,79,0,inf
2582,64,9,73,0,inf
2583,59,5,64,0,inf
2584,67,10,77,0,inf
2585,50,10,60,0,inf
2586,60,11,71,0,inf
2587,58,7,65,0,inf
2588,60,6,66,0,inf
2589,54,5,59,0,inf
2590,57,9,66,0,inf
2591,65,10,75,0,inf
2592,60,8,68,0,inf
2593,63,13,76,0,inf
2594,65,9,74,0,inf
2595,50,5,55,0,inf
2596,67,5,72,0,inf
2597,52,7,59,0,inf
2598,52,6,58,0,inf
2599,66,12,78,0,inf
2600,63,6,69,0,inf
2601,52,8,60,0,inf
2602,59,5,64,0,inf
2603,61,7,68,0,inf
2604,63,8,71,0,inf
2605,62,9,71,0,inf
2606,67,13,80,0,inf
2607,57,8,65,0,inf
2608,58,12,70,0,inf
2609,55,13,68,0,inf
2610,60,7,67,0,inf
2611,67,5,72,0,inf
2612,61,7,68,0,inf
2613,65,8,73,0,inf
2614,64,13,77,0,inf
2615,57,6,63,0,inf
2616,67,5,72,0,inf
2617,52,8,60,0,inf
2618,62,10,72,0,inf
2619,51,13,64,0,inf
2620,53,12,65,0,inf
2621,55,11,66,0,inf
2622,65,7,72,1,6.095370671066689
2623,65,11,76,0,inf
2624,53,11,64,0,inf
2625,56,9,65,0,inf
2626,53,12,65,0,inf
2627,56,7,63,0,inf
2628,59,12,71,0,inf
2629,60,6,66,0,inf
2630,53,9,62,0,inf
2631,65,5,70,0,inf
2632,51,9,60,0,inf
2633,58,6,64,0,inf
2634,62,11,73,0,inf
2635,60,10,70,0,inf
2636,63,8,71,0,inf
2637,59,13,72,0,inf
2638,65,11,76,0,inf
2639,61,5,66,0,inf
2640,65,11,76,0,inf
2641,58,8,66,1,1.9406986528001937
2642,66,5,71,0,inf
2643,67,12,79,0,inf
2644,60,7,67,0,inf
2645,59,12,71,0,inf
2646,59,12,71,0,inf
2647,55,12,67,0,inf
2648,51,12,63,0,inf
2649,54,12,66,0,inf
2650,59,5,64,0,inf
2651,63,8,71,0,inf
2652,63,5,68,0,inf
2653,51,8,59,0,inf
2654,62,11,73,0,inf
2655,54,9,63,0,inf
2656,62,13,75,0,inf
2657,51,9,60,0,inf
2658,59,6,65,0,inf
2659,50,5,55,0,inf
2660,66,10,76,0,inf
2661,58,13,71,0,inf
2662,58,11,69,0,inf
2663,60,6,66,0,inf
2664,65,6,71,0,inf
2665,56,13,69,0,inf
2666,56,5,61,0,inf
2667,58,13,71,0,inf
2668,62,11,73,0,inf
2669,66,6,72,0,inf
2670,64,7,71,0,inf
2671,56,9,65,0,inf
2672,61,10,71,0,inf
2673,67,7,74,0,inf
2674,59,5,64,0,inf
2675,50,5,55,0,inf
2676,56,9,65,0,inf
2677,54,10,64,0,inf
2678,58,5,63,0,inf
2679,61,9,70,0,inf
2680,56,7,63,0,inf
2681,56,11,67,0,inf
2682,55,8,63,0,inf
2683,55,5,60,0,inf
2684,55,13,68,0,inf
2685,56,9,65,0,inf
2686,50,8,58,0,inf
2687,60,8,68,0,inf
2688,53,7,60,0,inf
2689,53,11,64,0,inf
2690,51,12,63,0,inf
2691,60,13,73,0,inf
2692,65,13,78,0,inf
2693,52,12,64,0,inf
2694,52,6,58,0,inf
2695,56,10,66,0,inf
2696,54,13,67,0,inf
2697,51,6,57,0,inf
2698,61,11,72,0,inf
2699,65,10,75,0,inf
2700,57,8,65,0,inf
2701,58,7,65,0,inf
2702,52,5,57,0,inf
2703,56,8,64,0,inf
2704,50,7,57,0,inf
2705,67,5,72,0,inf
2706,66,12,78,0,inf
2707,55,9,64,0,inf
2708,52,9,61,0,inf
2709,67,5,72,0,inf
2710,54,8,62,0,inf
2711,56,5,61,0,inf
2712,65,13,78,0,inf
2713,60,6,66,0,inf
2714,63,5,68,0,inf
2715,59,13,72,0,inf
2716,66,9,75,0,inf
2717,56,13,69,0,inf
2718,53,10,63,0,inf
2719,60,7,67,0,inf
2720,63,11,74,0,inf
2721,64,8,72,0,inf
2722,55,13,68,1,5.406414256022728
2723,66,11,77,0,inf
2724,66,13,79,0,inf
2725,66,6,72,0,inf
2726,58,12,70,0,inf
2727,60,5,65,0,inf
2728,58,5,63,0,inf
2729,67,6,73,0,inf
2730,60,6,66,0,inf
2731,67,9,76,0,inf
2732,52,12,64,0,inf
2733,54,5,59,0,inf
2734,60,10,70,0,inf
2735,58,7,65,0,inf
2736,56,5,61,0,inf
2737,62,7,69,0,inf
2738,67,13,80,0,inf
2739,57,9,66,0,inf
2740,65,11,76,0,inf
2741,59,7,66,0,inf
2742,67,9,76,0,inf
2743,65,5,70,0,inf
2744,50,7,57,0,inf
2745,62,5,67,0,inf
2746,57,12,69,0,inf
2747,52,12,64,0,inf
2748,57,12,69,0,inf
2749,58,11,69,0,inf
2750,52,5,57,0,inf
2751,64,11,75,0,inf
2752,52,11,63,0,inf
2753,64,11,75,0,inf
2754,67,9,76,0,inf
2755,64,10,74,0,inf
2756,58,10,68,0,inf
2757,62,10,72,0,inf
2758,59,7,66,0,inf
2759,67,5,72,0,inf
2760,53,11,64,0,inf
2761,65,10,75,0,inf
2762,57,8,65,0,inf
2763,51,11,62,0,inf
2764,56,11,67,0,inf
2765,61,11,72,0,inf
2766,66,13,79,0,inf
2767,54,5,59,0,inf
2768,67,9,76,0,inf
2769,53,9,62,0,inf
2770,65,8,73,0,inf
2771,59,13,72,0,inf
2772,60,11,71,0,inf
2773,51,13,64,0,inf
2774,57,11,68,0,inf
2775,56,13,69,0,inf
2776,53,9,62,0,inf
2777,62,8,70,0,inf
2778,61,5,66,0,inf
2779,62,6,68,0,inf
2780,52,8,60,0,inf
2781,57,10,67,0,inf
2782,61,13,74,1,0.6508669627218637
2783,63,10,73,0,inf
2784,57,7,64,0,inf
2785,66,9,75,0,inf
2786,62,12,74,0,inf
2787,53,11,64,0,inf
2788,62,9,71,1,7.061471765827207
2789,50,11,61,0,inf
2790,60,12,72,0,inf
2791,65,5,70,0,inf
2792,54,11,65,0,inf
2793,60,5,65,0,inf
2794,59,12,71,1,4.820265350478955
2795,63,10,73,0,inf
2796,58,7,65,0,inf
2797,61,8,69,0,inf
2798,67,6,73,0,inf
2799,65,11,76,0,inf
2800,60,13,73,0,inf
2801,55,7,62,0,inf
2802,54,5,59,0,inf
2803,55,13,68,0,inf
2804,66,9,75,0,inf
2805,57,12,69,0,inf
2806,65,6,71,0,inf
2807,66,8,74,0,inf
2808,59,11,70,0,inf
2809,61,8,69,0,inf
2810,52,6,58,0,inf
2811,59,8,67,0,inf
2812,50,13,63,0,inf
2813,61,5,66,0,inf
2814,67,5,72,0,inf
2815,56,11,67,0,inf
2816,59,10,69,0,inf
2817,53,7,60,0,inf
2818,60,9,69,0,inf
2819,56,13,69,0,inf
2820,51,12,63,0,inf
2821,51,5,56,0,inf
2822,50,10,60,0,inf
2823,64,9,73,0,inf
2824,59,8,67,0,inf
2825,54,5,59,0,inf
2826,60,5,65,0,inf
2827,53,8,61,0,inf
2828,58,11,69,0,inf
2829,54,11,65,0,inf
2830,63,10,73,0,inf
2831,58,7,65,0,inf
2832,67,6,73,0,inf
2833,56,13,69,0,inf
2834,63,10,73,0,inf
2835,51,6,57,0,inf
2836,60,12,72,0,inf
2837,53,11,64,0,inf
2838,59,13,72,0,inf
2839,65,13,78,0,inf
2840,60,7,67,0,inf
2841,51,11,62,0,inf
2842,51,10,61,0,inf
2843,57,6,63,0,inf
2844,63,9,72,0,inf
2845,60,9,69,0,inf
2846,56,13,69,0,inf
2847,57,13,70,0,inf
2848,51,10,61,0,inf
2849,52,8,60,0,inf
2850,54,10,64,0,inf
2851,55,8,63,0,inf
2852,56,5,61,0,inf
2853,61,9,70,0,inf
2854,67,12,79,0,inf
2855,61,10,71,0,inf
2856,58,12,70,0,inf
2857,56,7,63,0,inf
2858,64,5,69,0,inf
2859,51,11,62,0,inf
2860,65,5,70,0,inf
2861,62,6,68,0,inf
2862,59,13,72,0,inf
2863,53,5,58,0,inf
2864,67,9,76,1,4.031712367352327
2865,52,11,63,0,inf
2866,55,9,64,0,inf
2867,59,13,72,0,inf
2868,63,8,71,0,inf
2869,52,8,60,0,inf
2870,52,12,64,0,inf
2871,56,6,62,0,inf
2872,50,7,57,0,inf
2873,66,6,72,0,inf
2874,56,9,65,0,inf
2875,53,5,58,0,inf
2876,58,13,71,0,inf
2877,55,11,66,0,inf
2878,53,11,64,0,inf
2879,62,8,70,0,inf
2880,51,5,56,0,inf
2881,50,12,62,0,inf
2882,65,11,76,0,inf
2883,65,9,74,0,inf
2884,63,13,76,0,inf
2885,56,12,68,0,inf
2886,51,7,58,0,inf
2887,62,11,73,0,inf
2888,55,8,63,0,inf
2889,60,6,66,0,inf
2890,55,13,68,0,inf
2891,66,11,77,0,inf
2892,58,5,63,0,inf
2893,54,12,66,0,inf
2894,59,8,67,0,inf
2895,63,10,73,0,inf
2896,65,7,72,0,inf
2897,52,6,58,0,inf
2898,60,13,73,0,inf
2899,65,5,70,0,inf
2900,50,13,63,0,inf
2901,56,13,69,0,inf
2902,58,6,64,0,inf
2903,54,6,60,0,inf
2904,64,5,69,0,inf
2905,50,6,56,0,inf
2906,64,9,73,0,inf
2907,63,13,76,0,inf
2908,51,10,61,0,inf
2909,64,13,77,0,inf
2910,60,8,68,0,inf
2911,57,9,66,0,inf
2912,57,8,65,0,inf
2913,67,13,80,0,inf
2914,51,10,61,0,inf
2915,53,13,66,1,2.7148720113409013
2916,66,8,74,0,inf
2917,59,5,64,0,inf
2918,50,12,62,1,4.674360897285652
2919,62,9,71,0,inf
2920,67,12,79,0,inf
2921,56,11,67,1,6.229129260137405
2922,56,13,69,0,inf
2923,66,6,72,0,inf
2924,52,11,63,0,inf
2925,50,5,55,0,inf
2926,65,6,71,0,inf
2927,66,7,73,0,inf
2928,61,9,70,0,inf
2929,57,9,66,0,inf
2930,55,7,62,0,inf
2931,66,12,78,0,inf
2932,54,5,59,0,inf
2933,62,5,67,0,inf
2934,50,11,61,0,inf
2935,66,6,72,0,inf
2936,64,13,77,0,inf
2937,65,5,70,0,inf
2938,64,9,73,0,inf
2939,64,5,69,0,inf
2940,58,9,67,0,inf
2941,61,7,68,0,inf
2942,58,12,70,0,inf
2943,52,12,64,0,inf
2944,67,9,76,0,inf
2945,60,13,73,0,inf
2946,58,9,67,0,inf
2947,65,12,77,0,inf
2948,56,11,67,0,inf
2949,61,8,69,0,inf
2950,61,6,67,0,inf
2951,67,7,74,0,inf
2952,60,6,66,0,inf
2953,64,10,74,0,inf
2954,62,11,73,0,inf
2955,62,6,68,0,inf
2956,62,8,70,0,inf
2957,56,9,65,0,inf
2958,62,10,72,0,inf
2959,61,7,68,0,inf
2960,56,12,68,0,inf
2961,62,7,69,0,inf
2962,52,10,62,0,inf
2963,55,9,64,0,inf
2964,66,5,71,0,inf
2965,65,9,74,0,inf
2966,57,8,65,0,inf
2967,50,6,56,0,inf
2968,62,12,74,0,inf
2969,64,8,72,0,inf
2970,60,10,70,0,inf
2971,56,6,62,0,inf
2972,51,10,61,0,inf
2973,50,13,63,0,inf
2974,52,11,63,0,inf
2975,62,11,73,0,inf
2976,54,7,61,0,inf
2977,54,5,59,0,inf
2978,66,9,75,0,inf
2979,56,11,67,0,inf
2980,50,8,58,0,inf
2981,67,8,75,0,inf
2982,67,11,78,0,inf
2983,66,12,78,0,inf
2984,56,12,68,0,inf
2985,52,11,63,0,inf
2986,62,11,73,0,inf
2987,56,9,65,0,inf
2988,54,10,64,0,inf
2989,64,5,69,0,inf
2990,63,6,69,0,inf
2991,54,9,63,0,inf
2992,56,11,67,0,inf
2993,67,10,77,0,inf
2994,62,5,67,0,inf
2995,50,8,58,0,inf
2996,51,8,59,0,inf
2997,66,10,76,0,inf
2998,56,5,61,0,inf
2999,59,6,65,0,inf
3000,63,12,75,0,inf
3001,67,10,77,0,inf
3002,65,5,70,0,inf
3003,51,8,59,0,inf
3004,66,5,71,0,inf
3005,53,5,58,0,inf
3006,65,6,71,0,inf
3007,58,10,68,0,inf
3008,56,6,62,0,inf
3009,67,8,75,0,inf
3010,53,10,63,0,inf
3011,60,5,65,0,inf
3012,59,13,72,0,inf
3013,65,10,75,0,inf
3014,65,5,70,0,inf
3015,53,10,63,0,inf
3016,50,13,63,0,inf
3017,62,10,72,0,inf
3018,50,5,55,0,inf
3019,50,13,63,0,inf
3020,56,12,68,0,inf
3021,66,10,76,0,inf
3022,65,5,70,0,inf
3023,57,9,66,0,inf
3024,56,7,63,0,inf
3025,66,11,77,0,inf
3026,50,10,60,0,inf
3027,55,12,67,0,inf
3028,60,5,65,0,inf
3029,55,5,60,0,inf
3030,61,10,71,0,inf
3031,64,13,77,0,inf
3032,63,12,75,0,inf
3033,66,12,78,0,inf
3034,63,11,74,0,inf
3035,53,13,66,0,inf
3036,64,8,72,0,inf
3037,55,8,63,0,inf
3038,60,9,69,0,inf
3039,63,6,69,0,inf
3040,50,12,62,0,inf
3041,51,8,59,0,inf
3042,53,13,66,0,inf
3043,51,10,61,0,inf
3044,65,12,77,0,inf
3045,61,7,68,0,inf
3046,54,8,62,0,inf
3047,51,7,58,0,inf
3048,52,6,58,0,inf
3049,61,10,71,0,inf
3050,62,7,69,0,inf
3051,50,10,60,0,inf
3052,52,5,57,0,inf
3053,52,11,63,0,inf
3054,60,13,73,0,inf
3055,65,11,76,0,inf
3056,54,8,62,0,inf
3057,57,5,62,0,inf
3058,56,5,61,0,inf
3059,60,11,71,0,inf
3060,51,8,59,0,inf
3061,57,7,64,0,inf
3062,54,11,65,0,inf
3063,52,9,61,0,inf
3064,64,13,77,0,inf
3065,62,5,67,0,inf
3066,53,12,65,0,inf
3067,57,7,64,0,inf
3068,55,13,68,0,inf
3069,56,10,66,0,inf
3070,60,10,70,0,inf
3071,58,6,64,0,inf
3072,60,7,67,0,inf
3073,61,6,67,0,inf
3074,55,13,68,0,inf
3075,54,12,66,0,inf
3076,57,12,69,0,inf
3077,53,12,65,0,inf
3078,67,10,77,0,inf
3079,51,11,62,0,inf
3080,54,12,66,0,inf
3081,51,5,56,0,inf
3082,62,13,75,0,inf
3083,61,6,67,0,inf
3084,56,12,68,0,inf
3085,54,9,63,0,inf
3086,52,9,61,0,inf
3087,67,6,73,0,inf
3088,56,13,69,0,inf
3089,54,8,62,0,inf
3090,59,11,70,0,inf
3091,66,8,74,0,inf
3092,60,8,68,0,inf
3093,50,13,63,0,inf
3094,55,9,64,0,inf
3095,64,6,70,0,inf
3096,59,7,66,0,inf
3097,56,10,66,0,inf
3098,59,10,69,0,inf
3099,56,8,64,0,inf
3100,50,11,61,0,inf
3101,67,8,75,0,inf
3102,56,11,67,0,inf
3103,53,11,64,0,inf
3104,57,12,69,0,inf
3105,62,9,71,0,inf
3106,50,9,59,0,inf
3107,62,10,72,0,inf
3108,64,5,69,0,inf
3109,61,9,70,0,inf
3110,63,7,70,0,inf
3111,54,9,63,0,inf
3112,63,12,75,0,inf
3113,57,10,67,0,inf
3114,51,12,63,0,inf
3115,58,7,65,0,inf
3116,53,12,65,0,inf
3117,53,6,59,0,inf
3118,63,12,75,0,inf
3119,58,10,68,0,inf
3120,58,13,71,0,inf
3121,60,5,65,0,inf
3122,57,6,63,0,inf
3123,50,10,60,0,inf
3124,53,11,64,0,inf
3125,52,5,57,0,inf
3126,52,12,64,0,inf
3127,54,11,65,0,inf
3128,62,5,67,0,inf
3129,51,8,59,0,inf
3130,59,10,69,0,inf
3131,59,9,68,0,inf
3132,64,9,73,0,inf
3133,59,8,67,0,inf
3134,60,13,73,0,inf
3135,57,8,65,0,inf
3136,61,7,68,0,inf
3137,54,8,62,0,inf
3138,59,9,68,0,inf
3139,54,12,66,0,inf
3140,55,11,66,0,inf
3141,55,8,63,0,inf
3142,59,8,67,0,inf
3143,65,11,76,0,inf
3144,60,13,73,0,inf
3145,60,8,68,0,inf
3146,53,13,66,0,inf
3147,54,6,60,0,inf
3148,58,8,66,0,inf
3149,65,5,70,0,inf
3150,55,5,60,0,inf
3151,63,13,76,0,inf
3152,61,6,67,0,inf
3153,63,8,71,0,inf
3154,59,12,71,0,inf
3155,50,9,59,0,inf
3156,62,5,67,0,inf
3157,50,13,63,0,inf
3158,57,8,65,0,inf
3159,53,8,61,0,inf
3160,50,10,60,0,inf
3161,62,9,71,0,inf
3162,64,9,73,0,inf
3163,66,8,74,0,inf
3164,60,13,73,0,inf
3165,59,13,72,0,inf
3166,50,7,57,0,inf
3167,65,5,70,0,inf
3168,51,11,62,0,inf
3169,59,8,67,0,inf
3170,54,11,65,0,inf
3171,64,13,77,0,inf
3172,59,5,64,0,inf
3173,52,9,61,0,inf
3174,55,9,64,0,inf
3175,51,8,59,0,inf
3176,61,12,73,0,inf
3177,54,9,63,0,inf
3178,67,5,72,0,inf
3179,61,5,66,0,inf
3180,66,11,77,1,3.324817939878372
3181,64,12,76,0,inf
3182,52,7,59,0,inf
3183,65,13,78,0,inf
3184,50,8,58,0,inf
3185,67,8,75,0,inf
3186,66,9,75,0,inf
3187,61,12,73,0,inf
3188,66,11,77,0,inf
3189,58,5,63,0,inf
3190,56,10,66,0,inf
3191,59,12,71,0,inf
3192,55,7,62,0,inf
3193,64,5,69,0,inf
3194,66,11,77,0,inf
3195,54,6,60,1,3.0378833907732243
3196,58,7,65,0,inf
3197,57,11,68,0,inf
3198,67,11,78,0,inf
3199,54,7,61,0,inf
3200,67,10,77,0,inf
3201,56,13,69,0,inf
3202,62,10,72,1,2.570227016511126
3203,62,6,68,0,inf
3204,55,12,67,0,inf
3205,65,8,73,0,inf
3206,53,6,59,0,inf
3207,58,10,68,0,inf
3208,59,7,66,0,inf
3209,61,13,74,0,inf
3210,55,9,64,0,inf
3211,62,6,68,0,inf
3212,64,5,69,0,inf
3213,54,11,65,0,inf
3214,64,5,69,0,inf
3215,57,5,62,0,inf
3216,67,5,72,0,inf
3217,52,5,57,0,inf
3218,58,6,64,0,inf
3219,50,12,62,0,inf
3220,52,6,58,0,inf
3221,52,12,64,0,inf
3222,66,6,72,0,inf
3223,51,7,58,0,inf
3224,60,13,73,0,inf
3225,55,11,66,0,inf
3226,67,12,79,0,inf
3227,52,11,63,0,inf
3228,67,6,73,0,inf
3229,59,7,66,0,inf
3230,64,5,69,0,inf
3231,52,13,65,0,inf
3232,64,7,71,0,inf
3233,50,11,61,0,inf
3234,62,6,68,0,inf
3235,62,12,74,0,inf
3236,63,13,76,0,inf
3237,67,8,75,0,inf
3238,51,10,61,0,inf
3239,55,9,64,0,inf
3240,53,5,58,0,inf
3241,52,6,58,0,inf
3242,64,6,70,0,inf
3243,62,8,70,0,inf
3244,62,5,67,0,inf
3245,55,9,64,0,inf
3246,66,7,73,0,inf
3247,66,11,77,0,inf
3248,58,10,68,0,inf
3249,67,9,76,1,8.667723239700607
3250,63,5,68,0,inf
3251,60,6,66,0,inf
3252,60,10,70,0,inf
3253,66,11,77,0,inf
3254,53,11,64,1,6.987914172737135
3255,61,9,70,0,inf
3256,54,7,61,0,inf
3257,54,6,60,0,inf
3258,58,13,71,0,inf
3259,62,5,67,0,inf
3260,53,7,60,0,inf
3261,57,12,69,0,inf
3262,53,6,59,0,inf
3263,52,9,61,0,inf
3264,53,10,63,0,inf
3265,60,8,68,0,inf
3266,53,10,63,0,inf
3267,67,12,79,0,inf
3268,57,10,67,0,inf
3269,65,10,75,0,inf
3270,67,6,73,0,inf
3271,51,13,64,0,inf
3272,61,7,68,0,inf
3273,55,10,65,0,inf
3274,65,11,76,0,inf
3275,56,11,67,0,inf
3276,64,13,77,0,inf
3277,50,9,59,0,inf
3278,52,10,62,0,inf
3279,59,7,66,0,inf
3280,67,10,77,0,inf
3281,55,11,66,0,inf
3282,50,12,62,0,inf
3283,55,8,63,0,inf
3284,59,6,65,0,inf
3285,67,10,77,0,inf
3286,66,5,71,1,3.708114665990408
3287,58,10,68,0,inf
3288,52,11,63,0,inf
3289,50,7,57,0,inf
3290,56,8,64,0,inf
3291,65,8,73,0,inf
3292,55,9,64,0,inf
3293,67,13,80,0,inf
3294,54,10,64,0,inf
3295,65,11,76,0,inf
3296,50,6,56,1,1.3573675149071747
3297,53,9,62,0,inf
3298,66,5,71,0,inf
3299,61,5,66,0,inf
3300,50,13,63,0,inf
3301,65,5,70,0,inf
3302,52,6,58,0,inf
3303,58,8,66,0,inf
3304,64,6,70,0,inf
3305,58,5,63,0,inf
3306,51,11,62,0,inf
3307,57,10,67,0,inf
3308,63,9,72,0,inf
3309,62,8,70,0,inf
3310,54,10,64,0,inf
3311,65,11,76,0,inf
3312,58,9,67,0,inf
3313,61,5,66,0,inf
3314,61,8,69,0,inf
3315,63,5,68,0,inf
3316,54,11,65,0,inf
3317,54,8,62,0,inf
3318,64,6,70,0,inf
3319,66,5,71,0,inf
3320,67,11,78,0,inf
3321,63,11,74,0,inf
3322,59,5,64,0,inf
3323,60,5,65,0,inf
3324,67,9,76,0,inf
3325,64,8,72,0,inf
3326,55,10,65,0,inf
3327,63,6,69,0,inf
3328,61,13,74,0,inf
3329,59,9,68,0,inf
3330,62,9,71,0,inf
3331,64,5,69,0,inf
3332,55,12,67,0,inf
3333,57,5,62,0,inf
3334,51,8,59,0,inf
3335,57,10,67,0,inf
3336,51,12,63,0,inf
3337,57,12,69,0,inf
3338,61,12,73,0,inf
3339,55,13,68,0,inf
3340,61,7,68,0,inf
3341,66,13,79,0,inf
3342,57,10,67,0,inf
3343,52,13,65,0,inf
3344,59,11,70,0,inf
3345,55,10,65,0,inf
3346,56,10,66,0,inf
3347,66,6,72,0,inf
3348,63,13,76,0,inf
3349,64,10,74,0,inf
3350,60,11,71,0,inf
3351,54,10,64,0,inf
3352,63,8,71,0,inf
3353,57,12,69,0,inf
3354,51,7,58,0,inf
3355,59,8,67,0,inf
3356,67,8,75,0,inf
3357,62,7,69,0,inf
3358,58,5,63,0,inf
3359,64,12,76,0,inf
3360,61,7,68,0,inf
3361,60,9,69,0,inf
3362,67,7,74,0,inf
3363,60,13,73,0,inf
3364,66,12,78,0,inf
3365,66,12,78,0,inf
3366,54,13,67,0,inf
3367,50,11,61,0,inf
3368,53,13,66,0,inf
3369,63,10,73,0,inf
3370,58,9,67,0,inf
3371,63,7,70,0,inf
3372,62,9,71,0,inf
3373,61,8,69,0,inf
3374,55,12,67,0,inf
3375,62,9,71,0,inf
3376,54,9,63,0,inf
3377,57,10,67,0,inf
3378,66,8,74,0,inf
3379,55,12,67,0,inf
3380,54,13,67,0,inf
3381,66,9,75,0,inf
3382,53,5,58,0,inf
3383,52,12,64,0,inf
3384,51,8,59,0,inf
3385,64,5,69,0,inf
3386,58,8,66,0,inf
3387,64,5,69,0,inf
3388,67,8,75,0,inf
3389,65,9,74,0,inf
3390,58,11,69,0,inf
3391,50,10,60,0,inf
3392,63,6,69,0,inf
3393,61,5,66,0,inf
3394,64,5,69,0,inf
3395,51,10,61,0,inf
3396,60,7,67,0,inf
3397,67,7,74,0,inf
3398,58,13,71,0,inf
3399,56,12,68,0,inf
3400,67,11,78,0,inf
3401,59,10,69,0,inf
3402,61,10,71,0,inf
3403,67,7,74,0,inf
3404,65,6,71,0,inf
3405,58,8,66,0,inf
3406,58,9,67,0,inf
3407,63,12,75,0,inf
3408,54,11,65,0,inf
3409,67,12,79,0,inf
3410,63,7,70,0,inf
3411,66,5,71,0,inf
3412,60,13,73,0,inf
3413,62,10,72,0,inf
3414,56,10,66,0,inf
3415,50,8,58,0,inf
3416,65,5,70,0,inf
3417,59,13,72,0,inf
3418,65,10,75,0,inf
3419,50,8,58,0,inf
3420,57,13,70,0,inf
3421,65,7,72,0,inf
3422,51,10,61,0,inf
3423,53,6,59,0,inf
3424,65,7,72,0,inf
3425,56,13,69,0,inf
3426,54,9,63,0,inf
3427,62,13,75,0,inf
3428,58,5,63,0,inf
3429,59,6,65,0,inf
3430,59,11,70,0,inf
3431,50,13,63,0,inf
3432,67,11,78,1,10.907641946759597
3433,53,13,66,0,inf
3434,54,5,59,0,inf
3435,53,11,64,0,inf
3436,51,7,58,0,inf
3437,54,8,62,0,inf
3438,51,11,62,0,inf
3439,61,10,71,0,inf
3440,56,8,64,0,inf
3441,55,9,64,0,inf
3442,56,10,66,0,inf
3443,53,13,66,0,inf
3444,52,12,64,1,11.405953206640014
3445,61,11,72,0,inf
3446,61,10,71,0,inf
3447,61,11,72,0,inf
3448,57,11,68,0,inf
3449,54,12,66,0,inf
3450,52,10,62,0,inf
3451,57,8,65,0,inf
3452,51,9,60,0,inf
3453,55,10,65,0,inf
3454,57,9,66,0,inf
3455,50,10,60,0,inf
3456,64,11,75,0,inf
3457,52,6,58,0,inf
3458,51,8,59,0,inf
3459,51,10,61,0,inf
3460,57,9,66,0,inf
3461,61,12,73,1,0.13750794285419943
3462,63,7,70,0,inf
3463,66,10,76,0,inf
3464,51,6,57,0,inf
3465,58,9,67,1,6.65515841555424
3466,54,8,62,0,inf
3467,67,6,73,0,inf
3468,65,10,75,0,inf
3469,56,5,61,0,inf
3470,58,5,63,0,inf
3471,50,13,63,0,inf
3472,57,9,66,0,inf
3473,61,9,70,0,inf
3474,57,6,63,0,inf
3475,52,10,62,0,inf
3476,58,10,68,0,inf
3477,63,11,74,0,inf
3478,57,13,70,0,inf
3479,60,13,73,0,inf
3480,65,12,77,0,inf
3481,61,9,70,0,inf
3482,57,7,64,0,inf
3483,53,8,61,0,inf
3484,51,7,58,0,inf
3485,65,7,72,0,inf
3486,57,10,67,0,inf
3487,63,5,68,0,inf
3488,63,11,74,0,inf
3489,52,7,59,0,inf
3490,55,11,66,0,inf
3491,65,8,73,0,inf
3492,66,11,77,0,inf
3493,65,5,70,0,inf
3494,57,5,62,0,inf
3495,62,9,71,0,inf
3496,61,13,74,0,inf
3497,55,5,60,0,inf
3498,61,13,74,0,inf
3499,59,7,66,0,inf
3500,52,5,57,0,inf
3501,66,9,75,0,inf
3502,64,5,69,0,inf
3503,64,12,76,0,inf
3504,51,6,57,0,inf
3505,62,6,68,0,inf
3506,62,8,70,0,inf
3507,51,9,60,0,inf
3508,61,8,69,0,inf
3509,66,13,79,0,inf
3510,62,10,72,0,inf
3511,57,12,69,0,inf
3512,66,9,75,0,inf
3513,65,6,71,0,inf
3514,54,8,62,0,inf
3515,58,5,63,0,inf
3516,59,12,71,0,inf
3517,66,10,76,0,inf
3518,53,6,59,0,inf
3519,64,10,74,0,inf
3520,60,13,73,0,inf
3521,65,8,73,0,inf
3522,59,5,64,0,inf
3523,65,8,73,0,inf
3524,64,12,76,0,inf
3525,57,12,69,0,inf
3526,52,9,61,0,inf
3527,55,9,64,0,inf
3528,57,11,68,0,inf
3529,59,8,67,0,inf
3530,59,11,70,0,inf
3531,59,8,67,0,inf
3532,50,5,55,0,inf
3533,58,6,64,0,inf
3534,54,8,62,0,inf
3535,53,6,59,0,inf
3536,59,6,65,0,inf
3537,57,8,65,0,inf
3538,54,5,59,0,inf
3539,56,9,65,0,inf
3540,53,8,61,1,7.002825987236363
3541,63,12,75,0,inf
3542,63,13,76,0,inf
3543,56,8,64,0,inf
3544,56,6,62,0,inf
3545,53,9,62,0,inf
3546,66,6,72,0,inf
3547,61,11,72,0,inf
3548,57,7,64,0,inf
3549,57,10,67,0,inf
3550,62,9,71,0,inf
3551,58,8,66,0,inf
3552,54,13,67,0,inf
3553,65,10,75,1,7.054558301566786
3554,59,5,64,0,inf
3555,67,6,73,0,inf
3556,61,11,72,0,inf
3557,53,7,60,0,inf
3558,56,5,61,0,inf
3559,66,12,78,0,inf
3560,64,5,69,1,4.880810099982085
3561,65,12,77,0,inf
3562,55,7,62,1,6.153431628192195
3563,67,7,74,0,inf
3564,55,7,62,0,inf
3565,63,8,71,0,inf
3566,59,10,69,0,inf
3567,53,6,59,0,inf
3568,65,10,75,0,inf
3569,55,11,66,0,inf
3570,56,10,66,0,inf
3571,54,5,59,0,inf
3572,64,6,70,0,inf
3573,63,7,70,0,inf
3574,63,8,71,0,inf
3575,56,13,69,0,inf
3576,50,12,62,0,inf
3577,59,10,69,0,inf
3578,55,10,65,0,inf
3579,55,10,65,0,inf
3580,56,6,62,0,inf
3581,64,8,72,0,inf
3582,57,13,70,0,inf
3583,56,5,61,0,inf
3584,59,5,64,0,inf
3585,62,6,68,0,inf
3586,54,9,63,0,inf
3587,53,6,59,0,inf
3588,54,10,64,0,inf
3589,64,7,71,0,inf
3590,58,7,65,0,inf
3591,54,12,66,0,inf
3592,61,11,72,0,inf
3593,57,13,70,0,inf
3594,66,9,75,0,inf
3595,52,9,61,0,inf
3596,54,7,61,0,inf
3597,52,8,60,0,inf
3598,61,11,72,0,inf
3599,64,8,72,0,inf
3600,58,9,67,0,inf
3601,51,13,64,0,inf
3602,52,5,57,0,inf
3603,53,10,63,0,inf
3604,64,13,77,0,inf
3605,63,7,70,0,inf
3606,57,10,67,0,inf
3607,65,8,73,0,inf
3608,63,10,73,0,inf
3609,62,11,73,0,inf
3610,54,10,64,0,inf
3611,67,5,72,0,inf
3612,66,6,72,0,inf
3613,63,7,70,0,inf
3614,63,11,74,0,inf
3615,64,13,77,0,inf
3616,63,11,74,0,inf
3617,64,10,74,0,inf
3618,59,6,65,0,inf
3619,65,5,70,0,inf
3620,66,12,78,0,inf
3621,59,13,72,0,inf
3622,52,8,60,0,inf
3623,57,13,70,0,inf
3624,66,11,77,0,inf
3625,57,6,63,0,inf
3626,64,7,71,0,inf
3627,51,7,58,0,inf
3628,62,13,75,1,4.158144085077495
3629,54,9,63,0,inf
3630,64,8,72,0,inf
3631,56,5,61,0,inf
3632,63,8,71,0,inf
3633,63,12,75,0,inf
3634,56,13,69,0,inf
3635,55,13,68,0,inf
3636,52,13,65,1,0.8099622406277476
3637,60,13,73,0,inf
3638,62,5,67,0,inf
3639,51,6,57,0,inf
3640,53,8,61,0,inf
3641,65,9,74,0,inf
3642,52,5,57,0,inf
3643,52,5,57,0,inf
3644,56,13,69,0,inf
3645,65,13,78,0,inf
3646,61,7,68,0,inf
3647,58,9,67,0,inf
3648,66,8,74,0,inf
3649,52,5,57,1,2.3442271240123276
3650,60,11,71,0,inf
3651,56,11,67,0,inf
3652,66,7,73,0,inf
3653,62,8,70,0,inf
3654,58,8,66,0,inf
3655,52,10,62,0,inf
3656,55,5,60,0,inf
3657,62,8,70,0,inf
3658,54,5,59,0,inf
3659,62,10,72,0,inf
3660,64,6,70,0,inf
3661,60,13,73,0,inf
3662,67,7,74,0,inf
3663,65,12,77,0,inf
3664,63,5,68,0,inf
3665,58,11,69,0,inf
3666,59,9,68,0,inf
3667,52,11,63,0,inf
3668,53,9,62,0,inf
3669,67,7,74,0,inf
3670,56,13,69,0,inf
3671,62,13,75,0,inf
3672,52,9,61,0,inf
3673,56,6,62,0,inf
3674,61,5,66,0,inf
3675,53,13,66,1,0.24372940769961104
3676,50,10,60,0,inf
3677,51,12,63,0,inf
3678,64,9,73,0,inf
3679,55,10,65,0,inf
3680,52,5,57,0,inf
3681,59,11,70,0,inf
3682,62,11,73,0,inf
3683,63,7,70,0,inf
3684,64,12,76,0,inf
3685,65,5,70,0,inf
3686,61,7,68,0,inf
3687,55,7,62,0,inf
3688,60,10,70,0,inf
3689,53,13,66,0,inf
3690,52,8,60,0,inf
3691,54,5,59,0,inf
3692,55,8,63,0,inf
3693,64,5,69,0,inf
3694,51,5,56,0,inf
3695,55,9,64,0,inf
3696,62,9,71,0,inf
3697,65,13,78,0,inf
3698,57,9,66,0,inf
3699,63,9,72,0,inf
3700,63,8,71,0,inf
3701,66,8,74,0,inf
3702,53,7,60,0,inf
3703,67,9,76,0,inf
3704,58,12,70,0,inf
3705,65,12,77,0,inf
3706,54,10,64,0,inf
3707,60,9,69,0,inf
3708,54,6,60,0,inf
3709,55,10,65,0,inf
3710,51,11,62,0,inf
3711,51,9,60,0,inf
3712,54,10,64,0,inf
3713,50,12,62,0,inf
3714,53,11,64,0,inf
3715,59,9,68,0,inf
3716,62,13,75,0,inf
3717,51,9,60,0,inf
3718,65,6,71,0,inf
3719,62,7,69,0,inf
3720,54,7,61,0,inf
3721,50,5,55,0,inf
3722,64,11,75,0,inf
3723,63,8,71,1,2.109997729066592
3724,56,10,66,0,inf
3725,65,6,71,0,inf
3726,61,6,67,0,inf
3727,53,6,59,0,inf
3728,61,13,74,0,inf
3729,54,8,62,0,inf
3730,61,7,68,0,inf
3731,63,11,74,0,inf
3732,57,5,62,0,inf
3733,58,5,63,0,inf
3734,52,10,62,0,inf
3735,56,11,67,0,inf
3736,54,10,64,0,inf
3737,59,11,70,0,inf
3738,56,6,62,0,inf
3739,58,13,71,0,inf
3740,59,6,65,0,inf
3741,63,8,71,0,inf
3742,65,6,71,0,inf
3743,62,5,67,0,inf
3744,67,12,79,0,inf
3745,62,13,75,0,inf
3746,52,13,65,0,inf
3747,58,5,63,0,inf
3748,67,9,76,0,inf
3749,56,12,68,0,inf
3750,67,11,78,0,inf
3751,64,12,76,0,inf
3752,55,5,60,0,inf
3753,50,13,63,0,inf
3754,61,11,72,0,inf
3755,66,8,74,0,inf
3756,64,6,70,0,inf
3757,53,13,66,0,inf
3758,65,11,76,0,inf
3759,50,13,63,0,inf
3760,56,10,66,0,inf
3761,52,6,58,0,inf
3762,61,7,68,0,inf
3763,65,12,77,0,inf
3764,61,11,72,0,inf
3765,65,11,76,0,inf
3766,58,12,70,0,inf
3767,63,8,71,0,inf
3768,52,8,60,0,inf
3769,55,6,61,0,inf
3770,67,9,76,0,inf
3771,65,12,77,0,inf
3772,56,11,67,0,inf
3773,64,5,69,0,inf
3774,62,11,73,0,inf
3775,56,7,63,0,inf
3776,63,11,74,0,inf
3777,61,12,73,0,inf
3778,54,10,64,0,inf
3779,58,9,67,0,inf
3780,60,6,66,0,inf
3781,59,6,65,0,inf
3782,61,13,74,0,inf
3783,63,10,73,0,inf
3784,55,6,61,0,inf
3785,62,12,74,0,inf
3786,63,9,72,0,inf
3787,63,11,74,0,inf
3788,61,12,73,0,inf
3789,56,7,63,0,inf
3790,61,9,70,0,inf
3791,52,9,61,0,inf
3792,58,6,64,0,inf
3793,57,6,63,0,inf
3794,58,7,65,0,inf
3795,61,5,66,0,inf
3796,66,12,78,0,inf
3797,63,9,72,0,inf
3798,64,7,71,0,inf
3799,50,13,63,0,inf
3800,64,12,76,0,inf
3801,55,11,66,0,inf
3802,51,9,60,0,inf
3803,67,13,80,0,inf
3804,64,6,70,0,inf
3805,53,7,60,0,inf
3806,52,6,58,0,inf
3807,61,9,70,0,inf
3808,64,7,71,0,inf
3809,60,6,66,0,inf
3810,63,12,75,0,inf
3811,55,6,61,0,inf
3812,53,6,59,0,inf
3813,64,13,77,0,inf
3814,56,5,61,0,inf
3815,62,7,69,0,inf
3816,59,5,64,0,inf
3817,54,10,64,0,inf
3818,56,6,62,0,inf
3819,52,13,65,0,inf
3820,52,9,61,0,inf
3821,62,13,75,0,inf
3822,58,10,68,0,inf
3823,50,5,55,1,4.366487712231411
3824,67,6,73,0,inf
3825,61,7,68,0,inf
3826,65,8,73,0,inf
3827,61,9,70,0,inf
3828,55,6,61,0,inf
3829,61,7,68,0,inf
3830,63,7,70,0,inf
3831,53,7,60,0,inf
3832,62,9,71,0,inf
3833,50,9,59,0,inf
3834,62,9,71,0,inf
3835,54,6,60,0,inf
3836,59,9,68,0,inf
3837,61,8,69,0,inf
3838,58,11,69,0,inf
3839,51,7,58,0,inf
3840,60,12,72,0,inf
3841,53,12,65,0,inf
3842,66,12,78,0,inf
3843,67,10,77,0,inf
3844,52,13,65,0,inf
3845,65,6,71,0,inf
3846,51,9,60,0,inf
3847,56,8,64,0,inf
3848,54,11,65,0,inf
3849,58,12,70,0,inf
3850,66,9,75,0,inf
3851,60,8,68,0,inf
3852,65,11,76,0,inf
3853,63,13,76,0,inf
3854,55,6,61,0,inf
3855,55,6,61,0,inf
3856,52,5,57,0,inf
3857,60,12,72,0,inf
3858,53,6,59,0,inf
3859,64,12,76,0,inf
3860,56,5,61,0,inf
3861,53,13,66,0,inf
3862,60,6,66,0,inf
3863,60,8,68,0,inf
3864,51,9,60,0,inf
3865,55,13,68,0,inf
3866,55,5,60,0,inf
3867,54,9,63,0,inf
3868,52,8,60,0,inf
3869,67,8,75,0,inf
3870,66,6,72,0,inf
3871,58,6,64,0,inf
3872,51,5,56,0,inf
3873,58,11,69,0,inf
3874,54,13,67,0,inf
3875,57,11,68,0,inf
3876,64,11,75,0,inf
3877,51,11,62,0,inf
3878,62,9,71,0,inf
3879,60,7,67,0,inf
3880,58,10,68,0,inf
3881,60,8,68,0,inf
3882,59,11,70,0,inf
3883,52,7,59,0,inf
3884,56,12,68,0,inf
3885,53,9,62,0,inf
3886,61,10,71,0,inf
3887,60,12,72,0,inf
3888,58,12,70,1,0.29737348704662736
3889,64,5,69,0,inf
3890,56,11,67,0,inf
3891,61,13,74,0,inf
3892,63,13,76,0,inf
3893,59,9,68,0,inf
3894,57,7,64,0,inf
3895,59,13,72,0,inf
3896,52,8,60,0,inf
3897,56,10,66,0,inf
3898,51,9,60,0,inf
3899,59,7,66,0,inf
3900,60,8,68,0,inf
3901,62,5,67,0,inf
3902,58,9,67,1,8.360270949092325
3903,59,11,70,0,inf
3904,61,11,72,0,inf
3905,61,5,66,0,inf
3906,55,6,61,0,inf
3907,60,10,70,0,inf
3908,63,13,76,0,inf
3909,54,8,62,0,inf
3910,67,6,73,0,inf
3911,50,8,58,0,inf
3912,56,8,64,0,inf
3913,51,6,57,0,inf
3914,52,5,57,0,inf
3915,54,9,63,0,inf
3916,63,5,68,0,inf
3917,57,9,66,0,inf
3918,50,5,55,0,inf
3919,52,9,61,0,inf
3920,56,6,62,0,inf
3921,52,8,60,0,inf
3922,55,7,62,0,inf
3923,63,5,68,0,inf
3924,55,6,61,0,inf
3925,52,10,62,0,inf
3926,51,13,64,0,inf
3927,66,5,71,0,inf
3928,64,12,76,1,11.348590233135269
3929,64,6,70,0,inf
3930,54,6,60,0,inf
3931,52,11,63,0,inf
3932,59,11,70,0,inf
3933,63,10,73,0,inf
3934,56,11,67,0,inf
3935,66,7,73,0,inf
3936,60,5,65,0,inf
3937,63,7,70,0,inf
3938,66,8,74,1,0.1650587279866471
3939,66,8,74,0,inf
3940,60,7,67,0,inf
3941,61,8,69,0,inf
3942,53,12,65,0,inf
3943,56,13,69,0,inf
3944,66,11,77,0,inf
3945,61,12,73,0,inf
3946,53,8,61,0,inf
3947,50,7,57,0,inf
3948,59,8,67,0,inf
3949,56,6,62,0,inf
3950,50,11,61,0,inf
3951,50,9,59,0,inf
3952,67,7,74,0,inf
3953,58,11,69,0,inf
3954,66,6,72,0,inf
3955,64,13,77,0,inf
3956,50,6,56,0,inf
3957,59,10,69,0,inf
3958,62,12,74,0,inf
3959,63,13,76,0,inf
3960,61,13,74,0,inf
3961,50,10,60,0,inf
3962,60,6,66,0,inf
3963,51,8,59,0,inf
3964,63,10,73,0,inf
3965,59,8,67,0,inf
3966,54,7,61,0,inf
3967,62,9,71,0,inf
3968,56,5,61,0,inf
3969,59,10,69,0,inf
3970,55,7,62,0,inf
3971,55,5,60,0,inf
3972,62,9,71,0,inf
3973,65,11,76,0,inf
3974,66,6,72,0,inf
3975,65,8,73,0,inf
3976,60,9,69,0,inf
3977,55,13,68,0,inf
3978,55,10,65,0,inf
3979,65,5,70,0,inf
3980,66,9,75,0,inf
3981,65,13,78,0,inf
3982,51,11,62,0,inf
3983,50,7,57,0,inf
3984,55,5,60,0,inf
3985,53,11,64,0,inf
3986,57,7,64,0,inf
3987,59,11,70,0,inf
3988,55,12,67,0,inf
3989,56,11,67,0,inf
3990,54,5,59,0,inf
3991,61,9,70,0,inf
3992,64,6,70,0,inf
3993,55,13,68,0,inf
3994,58,12,70,0,inf
3995,52,12,64,0,inf
3996,66,7,73,1,6.442753112800148
3997,53,11,64,0,inf
3998,56,5,61,0,inf
3999,65,10,75,0,inf
4000,61,10,71,0,inf
4001,67,12,79,0,inf
4002,52,9,61,0,inf
4003,66,5,71,0,inf
4004,66,8,74,0,inf
4005,60,8,68,0,inf
4006,57,13,70,0,inf
4007,52,8,60,0,inf
4008,51,8,59,0,inf
4009,59,7,66,0,inf
4010,66,8,74,0,inf
4011,61,13,74,0,inf
4012,66,7,73,0,inf
4013,65,10,75,0,inf
4014,63,10,73,0,inf
4015,53,7,60,0,inf
4016,55,13,68,0,inf
4017,64,9,73,0,inf
4018,59,6,65,0,inf
4019,55,13,68,1,10.412936829067064
4020,63,8,71,0,inf
4021,61,10,71,0,inf
4022,55,6,61,0,inf
4023,58,10,68,0,inf
4024,56,6,62,0,inf
4025,64,13,77,0,inf
4026,52,11,63,0,inf
4027,62,9,71,0,inf
4028,56,12,68,0,inf
4029,61,6,67,0,inf
4030,51,12,63,0,inf
4031,64,7,71,0,inf
4032,53,5,58,0,inf
4033,56,7,63,0,inf
4034,60,10,70,0,inf
4035,67,11,78,0,inf
4036,67,8,75,0,inf
4037,55,6,61,0,inf
4038,56,9,65,0,inf
4039,66,11,77,0,inf
4040,55,11,66,0,inf
4041,52,9,61,0,inf
4042,58,6,64,0,inf
4043,60,5,65,0,inf
4044,65,8,73,0,inf
4045,53,13,66,0,inf
4046,50,8,58,0,inf
4047,58,13,71,0,inf
4048,64,8,72,0,inf
4049,66,6,72,0,inf
4050,62,13,75,0,inf
4051,50,13,63,0,inf
4052,55,9,64,0,inf
4053,55,9,64,0,inf
4054,60,8,68,0,inf
4055,50,10,60,0,inf
4056,62,8,70,0,inf
4057,54,13,67,0,inf
4058,59,12,71,0,inf
4059,59,11,70,1,9.404962517676893
4060,64,10,74,0,inf
4061,53,6,59,0,inf
4062,54,9,63,0,inf
4063,55,6,61,0,inf
4064,51,12,63,0,inf
4065,64,9,73,0,inf
4066,57,11,68,0,inf
4067,61,8,69,0,inf
4068,52,11,63,0,inf
4069,55,7,62,0,inf
4070,59,13,72,0,inf
4071,55,9,64,0,inf
4072,58,5,63,0,inf
4073,64,11,75,1,8.82208386050948
4074,55,7,62,0,inf
4075,62,11,73,0,inf
4076,55,7,62,0,inf
4077,59,8,67,0,inf
4078,66,13,79,0,inf
4079,67,13,80,0,inf
4080,59,9,68,0,inf
4081,57,13,70,0,inf
4082,58,11,69,0,inf
4083,67,7,74,0,inf
4084,59,13,72,0,inf
4085,63,11,74,0,inf
4086,53,11,64,0,inf
4087,52,12,64,0,inf
4088,60,9,69,0,inf
4089,63,9,72,0,inf
4090,52,5,57,0,inf
4091,50,5,55,0,inf
4092,59,5,64,0,inf
4093,59,5,64,0,inf
4094,59,13,72,1,11.9039752124377
4095,59,8,67,0,inf
4096,63,5,68,0,inf
4097,65,12,77,0,inf
4098,65,11,76,0,inf
4099,51,8,59,0,inf
4100,50,5,55,0,inf
4101,59,7,66,0,inf
4102,59,11,70,0,inf
4103,54,9,63,0,inf
4104,50,8,58,0,inf
4105,50,10,60,0,inf
4106,59,8,67,0,inf
4107,52,10,62,0,inf
4108,65,9,74,0,inf
4109,54,8,62,0,inf
4110,51,10,61,0,inf
4111,52,6,58,0,inf
4112,66,7,73,0,inf
4113,66,6,72,0,inf
4114,51,6,57,0,inf
4115,52,12,64,0,inf
4116,58,10,68,0,inf
4117,55,10,65,0,inf
4118,65,10,75,0,inf
4119,64,11,75,0,inf
4120,55,10,65,0,inf
4121,50,5,55,0,inf
4122,66,10,76,0,inf
4123,50,8,58,1,4.326564212689917
4124,62,8,70,0,inf
4125,54,8,62,0,inf
4126,60,6,66,0,inf
4127,53,5,58,0,inf
4128,55,12,67,0,inf
4129,56,10,66,0,inf
4130,53,12,65,0,inf
4131,56,5,61,0,inf
4132,65,13,78,0,inf
4133,58,10,68,0,inf
4134,54,5,59,0,inf
4135,54,8,62,0,inf
4136,62,9,71,0,inf
4137,55,6,61,0,inf
4138,57,10,67,0,inf
4139,60,12,72,0,inf
4140,64,9,73,0,inf
4141,53,13,66,0,inf
4142,63,10,73,0,inf
4143,58,10,68,0,inf
4144,65,7,72,0,inf
4145,52,13,65,0,inf
4146,50,13,63,0,inf
4147,59,9,68,0,inf
4148,53,8,61,0,inf
4149,56,8,64,0,inf
4150,63,6,69,0,inf
4151,56,6,62,0,inf
4152,50,9,59,0,inf
4153,52,13,65,0,inf
4154,50,10,60,0,inf
4155,57,13,70,0,inf
4156,64,5,69,0,inf
4157,63,13,76,0,inf
4158,64,9,73,0,inf
4159,54,11,65,0,inf
4160,62,10,72,0,inf
4161,60,10,70,0,inf
4162,54,11,65,0,inf
4163,57,12,69,0,inf
4164,63,8,71,0,inf
4165,54,9,63,0,inf
4166,51,11,62,0,inf
4167,54,7,61,0,inf
4168,65,5,70,0,inf
4169,61,9,70,0,inf
4170,51,13,64,0,inf
4171,50,9,59,0,inf
4172,59,10,69,0,inf
4173,54,6,60,0,inf
4174,65,11,76,0,inf
4175,54,13,67,1,3.3174401389000394
4176,62,5,67,0,inf
4177,52,9,61,0,inf
4178,66,5,71,0,inf
4179,54,12,66,1,7.851988127764486
4180,63,8,71,0,inf
4181,58,6,64,0,inf
4182,56,10,66,0,inf
4183,67,12,79,0,inf
4184,59,10,69,0,inf
4185,61,7,68,0,inf
4186,52,7,59,0,inf
4187,57,10,67,0,inf
4188,66,5,71,0,inf
4189,58,7,65,0,inf
4190,63,12,75,0,inf
4191,62,6,68,0,inf
4192,57,6,63,0,inf
4193,52,5,57,0,inf
4194,62,5,67,0,inf
4195,53,5,58,0,inf
4196,62,8,70,0,inf
4197,60,10,70,0,inf
4198,63,9,72,0,inf
4199,52,9,61,0,inf
4200,60,12,72,0,inf
4201,54,12,66,0,inf
4202,56,5,61,0,inf
4203,51,12,63,0,inf
4204,61,8,69,0,inf
4205,59,10,69,0,inf
4206,50,12,62,0,inf
4207,63,8,71,0,inf
4208,54,13,67,0,inf
4209,51,10,61,0,inf
4210,60,13,73,0,inf
4211,55,6,61,0,inf
4212,63,7,70,0,inf
4213,64,9,73,0,inf
4214,64,6,70,0,inf
4215,50,9,59,0,inf
4216,64,6,70,0,inf
4217,54,7,61,0,inf
4218,58,8,66,0,inf
4219,62,10,72,0,inf
4220,58,9,67,0,inf
4221,67,12,79,0,inf
4222,66,8,74,0,inf
4223,65,9,74,0,inf
4224,57,8,65,0,inf
4225,65,5,70,0,inf
4226,61,7,68,0,inf
4227,63,11,74,1,7.676382286467657
4228,61,7,68,0,inf
4229,53,11,64,0,inf
4230,60,6,66,0,inf
4231,60,9,69,0,inf
4232,52,5,57,0,inf
4233,50,9,59,0,inf
4234,65,13,78,0,inf
4235,59,7,66,0,inf
4236,62,10,72,0,inf
4237,63,7,70,0,inf
4238,63,7,70,0,inf
4239,53,5,58,0,inf
4240,56,12,68,0,inf
4241,60,10,70,0,inf
4242,61,5,66,0,inf
4243,53,12,65,1,10.74544384542861
4244,55,7,62,0,inf
4245,62,12,74,0,inf
4246,64,10,74,0,inf
4247,65,7,72,0,inf
4248,53,7,60,0,inf
4249,60,7,67,0,inf
4250,57,5,62,0,inf
4251,66,8,74,0,inf
4252,64,12,76,1,7.960114413785547
4253,60,6,66,0,inf
4254,67,8,75,0,inf
4255,66,8,74,1,5.559810766652987
4256,53,9,62,0,inf
4257,62,5,67,0,inf
4258,66,5,71,0,inf
4259,65,13,78,0,inf
4260,56,12,68,0,inf
4261,59,13,72,0,inf
4262,56,7,63,0,inf
4263,61,11,72,0,inf
4264,64,11,75,0,inf
4265,52,7,59,0,inf
4266,63,5,68,0,inf
4267,64,11,75,0,inf
4268,62,10,72,0,inf
4269,50,11,61,0,inf
4270,53,7,60,0,inf
4271,61,8,69,0,inf
4272,57,9,66,0,inf
4273,66,6,72,0,inf
4274,56,5,61,0,inf
4275,67,7,74,0,inf
4276,60,5,65,0,inf
4277,57,10,67,0,inf
4278,55,7,62,0,inf
4279,50,5,55,0,inf
4280,62,7,69,0,inf
4281,57,7,64,0,inf
4282,54,6,60,0,inf
4283,58,5,63,0,inf
4284,66,12,78,0,inf
4285,63,8,71,0,inf
4286,64,10,74,0,inf
4287,55,9,64,0,inf
4288,67,8,75,0,inf
4289,51,7,58,0,inf
4290,66,7,73,1,5.576435055378823
4291,59,5,64,0,inf
4292,50,5,55,0,inf
4293,54,11,65,0,inf
4294,53,13,66,1,3.9205967737232825
4295,51,8,59,0,inf
4296,66,13,79,0,inf
4297,58,5,63,0,inf
4298,54,12,66,0,inf
4299,57,5,62,0,inf
4300,52,5,57,0,inf
4301,62,12,74,0,inf
4302,59,13,72,0,inf
4303,63,5,68,0,inf
4304,62,9,71,0,inf
4305,54,5,59,0,inf
4306,55,7,62,0,inf
4307,64,13,77,0,inf
4308,59,5,64,0,inf
4309,59,11,70,0,inf
4310,51,5,56,0,inf
4311,50,9,59,0,inf
4312,58,7,65,0,inf
4313,53,7,60,0,inf
4314,50,11,61,0,inf
4315,64,7,71,0,inf
4316,59,12,71,0,inf
4317,52,10,62,0,inf
4318,53,9,62,0,inf
4319,53,13,66,0,inf
4320,65,8,73,0,inf
4321,56,6,62,0,inf
4322,61,6,67,0,inf
4323,61,12,73,0,inf
4324,54,10,64,0,inf
4325,59,13,72,0,inf
4326,59,10,69,0,inf
4327,66,8,74,0,inf
4328,54,9,63,0,inf
4329,51,8,59,0,inf
4330,64,12,76,0,inf
4331,59,6,65,0,inf
4332,55,9,64,0,inf
4333,51,7,58,0,inf
4334,62,9,71,0,inf
4335,61,13,74,0,inf
4336,61,9,70,0,inf
4337,58,5,63,0,inf
4338,60,13,73,0,inf
4339,55,13,68,0,inf
4340,55,12,67,0,inf
4341,61,10,71,0,inf
4342,55,7,62,0,inf
4343,53,6,59,0,inf
4344,51,13,64,0,inf
4345,66,12,78,0,inf
4346,63,10,73,0,inf
4347,51,11,62,0,inf
4348,62,6,68,0,inf
4349,51,6,57,0,inf
4350,57,11,68,0,inf
4351,61,13,74,0,inf
4352,52,8,60,0,inf
4353,55,6,61,0,inf
4354,53,5,58,0,inf
4355,53,8,61,0,inf
4356,55,12,67,0,inf
4357,61,13,74,0,inf
4358,60,11,71,0,inf
4359,54,8,62,0,inf
4360,66,11,77,0,inf
4361,58,13,71,0,inf
4362,67,6,73,0,inf
4363,51,13,64,0,inf
4364,54,13,67,0,inf
4365,58,8,66,0,inf
4366,61,11,72,0,inf
4367,61,10,71,0,inf
4368,61,9,70,0,inf
4369,57,9,66,0,inf
4370,57,12,69,0,inf
4371,56,8,64,0,inf
4372,52,9,61,0,inf
4373,62,12,74,0,inf
4374,53,13,66,0,inf
4375,66,5,71,0,inf
4376,66,8,74,0,inf
4377,55,12,67,0,inf
4378,64,5,69,0,inf
4379,55,7,62,0,inf
4380,61,10,71,0,inf
4381,61,12,73,0,inf
4382,50,8,58,0,inf
4383,54,8,62,0,inf
4384,51,13,64,0,inf
4385,65,6,71,0,inf
4386,53,6,59,0,inf
4387,64,7,71,0,inf
4388,54,5,59,0,inf
4389,61,13,74,0,inf
4390,53,8,61,0,inf
4391,66,13,79,0,inf
4392,60,8,68,0,inf
4393,62,6,68,0,inf
4394,66,10,76,0,inf
4395,57,9,66,0,inf
4396,53,9,62,0,inf
4397,53,9,62,0,inf
4398,51,11,62,0,inf
4399,66,6,72,0,inf
4400,61,11,72,0,inf
4401,60,13,73,0,inf
4402,63,7,70,0,inf
4403,58,10,68,0,inf
4404,66,7,73,0,inf
4405,64,6,70,0,inf
4406,59,6,65,0,inf
4407,67,13,80,1,6.672348467704197
4408,62,13,75,0,inf
4409,65,12,77,1,3.3470583775398097
4410,56,13,69,0,inf
4411,62,12,74,0,inf
4412,60,12,72,0,inf
4413,64,8,72,0,inf
4414,64,6,70,0,inf
4415,51,8,59,0,inf
4416,55,10,65,1,4.979359155575608
4417,66,11,77,0,inf
4418,50,11,61,0,inf
4419,57,12,69,0,inf
4420,65,9,74,0,inf
4421,51,6,57,0,inf
4422,54,13,67,0,inf
4423,63,8,71,0,inf
4424,64,12,76,0,inf
4425,56,12,68,0,inf
4426,55,12,67,0,inf
4427,58,8,66,0,inf
4428,57,11,68,0,inf
4429,57,7,64,0,inf
4430,60,10,70,0,inf
4431,50,12,62,0,inf
4432,62,11,73,0,inf
4433,51,7,58,0,inf
4434,54,11,65,0,inf
4435,53,6,59,0,inf
4436,62,7,69,0,inf
4437,52,9,61,0,inf
4438,58,13,71,0,inf
4439,60,12,72,0,inf
4440,50,6,56,0,inf
4441,61,5,66,0,inf
4442,67,13,80,0,inf
4443,66,8,74,0,inf
4444,54,11,65,1,8.652232622800263
4445,55,6,61,0,inf
4446,50,9,59,0,inf
4447,61,10,71,0,inf
4448,54,7,61,0,inf
4449,55,7,62,0,inf
4450,58,10,68,0,inf
4451,55,9,64,0,inf
4452,64,7,71,0,inf
4453,51,13,64,0,inf
4454,67,6,73,0,inf
4455,63,7,70,0,inf
4456,52,13,65,0,inf
4457,64,11,75,0,inf
4458,67,10,77,0,inf
4459,62,5,67,0,inf
4460,65,11,76,0,inf
4461,52,7,59,0,inf
4462,54,8,62,0,inf
4463,58,8,66,0,inf
4464,63,11,74,0,inf
4465,64,7,71,0,inf
4466,56,12,68,0,inf
4467,51,5,56,0,inf
4468,53,6,59,0,inf
4469,64,12,76,0,inf
4470,50,10,60,0,inf
4471,62,10,72,0,inf
4472,55,10,65,0,inf
4473,61,10,71,0,inf
4474,66,12,78,0,inf
4475,59,8,67,0,inf
4476,67,13,80,0,inf
4477,63,12,75,0,inf
4478,66,7,73,0,inf
4479,50,6,56,0,inf
4480,50,8,58,0,inf
4481,53,9,62,0,inf
4482,67,12,79,0,inf
4483,50,6,56,0,inf
4484,50,13,63,0,inf
4485,50,8,58,0,inf
4486,54,13,67,0,inf
4487,57,9,66,0,inf
4488,51,9,60,0,inf
4489,65,8,73,0,inf
4490,55,13,68,0,inf
4491,56,9,65,0,inf
4492,60,7,67,0,inf
4493,59,7,66,0,inf
4494,51,9,60,0,inf
4495,63,7,70,0,inf
4496,66,9,75,0,inf
4497,65,8,73,0,inf
4498,66,7,73,0,inf
4499,63,8,71,0,inf
4500,62,5,67,0,inf
4501,51,10,61,0,inf
4502,66,11,77,0,inf
4503,56,8,64,0,inf
4504,64,10,74,0,inf
4505,61,7,68,0,inf
4506,50,13,63,0,inf
4507,63,10,73,0,inf
4508,65,7,72,0,inf
4509,67,8,75,0,inf
4510,55,5,60,0,inf
4511,55,13,68,0,inf
4512,61,6,67,0,inf
4513,54,8,62,0,inf
4514,53,13,66,0,inf
4515,66,13,79,0,inf
4516,67,5,72,0,inf
4517,50,10,60,0,inf
4518,50,13,63,0,inf
4519,66,12,78,0,inf
4520,58,8,66,0,inf
4521,63,6,69,0,inf
4522,55,8,63,0,inf
4523,54,10,64,0,inf
4524,61,8,69,0,inf
4525,63,9,72,0,inf
4526,66,9,75,0,inf
4527,63,8,71,0,inf
4528,65,6,71,0,inf
4529,51,7,58,0,inf
4530,59,5,64,0,inf
4531,54,13,67,1,8.413936265076408
4532,52,6,58,0,inf
4533,64,5,69,0,inf
4534,64,11,75,0,inf
4535,62,9,71,0,inf
4536,54,9,63,0,inf
4537,64,13,77,0,inf
4538,62,9,71,0,inf
4539,53,11,64,0,inf
4540,53,9,62,0,inf
4541,65,7,72,0,inf
4542,54,12,66,0,inf
4543,60,11,71,1,2.191021758685636
4544,54,9,63,0,inf
4545,50,7,57,0,inf
4546,61,12,73,0,inf
4547,66,7,73,0,inf
4548,64,5,69,0,inf
4549,67,11,78,0,inf
4550,50,12,62,0,inf
4551,57,10,67,0,inf
4552,53,9,62,0,inf
4553,65,8,73,0,inf
4554,51,13,64,0,inf
4555,60,6,66,0,inf
4556,56,12,68,0,inf
4557,59,10,69,0,inf
4558,53,10,63,0,inf
4559,57,13,70,0,inf
4560,50,13,63,0,inf
4561,55,5,60,0,inf
4562,56,9,65,1,7.172794097942557
4563,57,9,66,0,inf
4564,55,8,63,0,inf
4565,65,6,71,0,inf
4566,63,8,71,0,inf
4567,53,13,66,0,inf
4568,61,6,67,0,inf
4569,63,7,70,0,inf
4570,52,6,58,0,inf
4571,64,6,70,0,inf
4572,59,13,72,0,inf
4573,62,11,73,0,inf
4574,56,6,62,0,inf
4575,67,10,77,0,inf
4576,58,10,68,0,inf
4577,52,10,62,0,inf
4578,63,6,69,0,inf
4579,61,13,74,0,inf
4580,52,6,58,0,inf
4581,52,12,64,0,inf
4582,59,6,65,0,inf
4583,57,8,65,0,inf
4584,63,7,70,0,inf
4585,64,8,72,0,inf
4586,63,10,73,0,inf
4587,52,6,58,0,inf
4588,61,6,67,0,inf
4589,61,10,71,0,inf
4590,57,6,63,0,inf
4591,56,5,61,0,inf
4592,56,6,62,0,inf
4593,66,10,76,0,inf
4594,51,9,60,0,inf
4595,55,8,63,0,inf
4596,62,9,71,0,inf
4597,58,8,66,0,inf
4598,50,13,63,0,inf
4599,61,8,69,0,inf
4600,67,8,75,0,inf
4601,56,8,64,0,inf
4602,55,8,63,0,inf
4603,57,6,63,0,inf
4604,65,11,76,0,inf
4605,51,12,63,0,inf
4606,67,11,78,0,inf
4607,59,13,72,0,inf
4608,67,5,72,0,inf
4609,50,5,55,0,inf
4610,59,9,68,0,inf
4611,52,9,61,0,inf
4612,67,5,72,0,inf
4613,55,12,67,0,inf
4614,55,13,68,0,inf
4615,63,10,73,0,inf
4616,63,11,74,0,inf
4617,63,12,75,0,inf
4618,60,8,68,0,inf
4619,61,10,71,0,inf
4620,62,12,74,0,inf
4621,67,10,77,0,inf
4622,59,9,68,0,inf
4623,57,5,62,0,inf
4624,63,13,76,0,inf
4625,51,11,62,0,inf
4626,55,9,64,0,inf
4627,52,6,58,0,inf
4628,67,6,73,0,inf
4629,51,12,63,0,inf
4630,50,6,56,0,inf
4631,59,5,64,0,inf
4632,56,5,61,0,inf
4633,64,6,70,0,inf
4634,61,10,71,0,inf
4635,65,10,75,0,inf
4636,62,10,72,0,inf
4637,53,6,59,0,inf
4638,53,11,64,0,inf
4639,60,10,70,0,inf
4640,64,6,70,0,inf
4641,60,12,72,0,inf
4642,60,5,65,0,inf
4643,58,13,71,1,9.210954661490632
4644,60,7,67,0,inf
4645,53,13,66,0,inf
4646,55,12,67,0,inf
4647,64,5,69,0,inf
4648,57,8,65,0,inf
4649,63,9,72,0,inf
4650,63,6,69,0,inf
4651,54,11,65,0,inf
4652,61,8,69,0,inf
4653,59,12,71,0,inf
4654,50,6,56,0,inf
4655,53,11,64,0,inf
4656,65,13,78,0,inf
4657,64,6,70,0,inf
4658,53,5,58,0,inf
4659,56,9,65,1,0.1759463130949115
4660,61,7,68,0,inf
4661,59,6,65,0,inf
4662,53,8,61,0,inf
4663,58,12,70,0,inf
4664,54,6,60,0,inf
4665,53,10,63,0,inf
4666,55,7,62,0,inf
4667,62,9,71,0,inf
4668,67,11,78,0,inf
4669,58,8,66,0,inf
4670,51,6,57,0,inf
4671,58,5,63,0,inf
4672,57,6,63,0,inf
4673,51,6,57,0,inf
4674,67,8,75,0,inf
4675,63,9,72,0,inf
4676,61,13,74,0,inf
4677,67,12,79,0,inf
4678,55,6,61,0,inf
4679,66,9,75,0,inf
4680,67,6,73,0,inf
4681,59,6,65,0,inf
4682,62,9,71,0,inf
4683,63,11,74,0,inf
4684,61,13,74,0,inf
4685,64,11,75,0,inf
4686,53,8,61,0,inf
4687,59,7,66,0,inf
4688,61,11,72,0,inf
4689,54,5,59,0,inf
4690,52,8,60,0,inf
4691,50,12,62,0,inf
4692,57,7,64,0,inf
4693,59,12,71,0,inf
4694,62,6,68,0,inf
4695,58,9,67,0,inf
4696,51,11,62,0,inf
4697,52,5,57,0,inf
4698,54,6,60,0,inf
4699,66,5,71,0,inf
4700,54,5,59,0,inf
4701,57,11,68,0,inf
4702,53,8,61,0,inf
4703,51,9,60,0,inf
4704,64,11,75,0,inf
4705,61,7,68,0,inf
4706,66,11,77,0,inf
4707,61,8,69,0,inf
4708,56,7,63,0,inf
4709,59,9,68,0,inf
4710,50,13,63,0,inf
4711,50,7,57,0,inf
4712,50,12,62,0,inf
4713,67,11,78,0,inf
4714,59,10,69,0,inf
4715,57,7,64,0,inf
4716,51,12,63,0,inf
4717,66,12,78,0,inf
4718,56,9,65,0,inf
4719,56,10,66,0,inf
4720,62,6,68,0,inf
4721,59,9,68,0,inf
4722,53,10,63,0,inf
4723,56,5,61,0,inf
4724,51,9,60,0,inf
4725,65,7,72,0,inf
4726,59,8,67,0,inf
4727,50,7,57,0,inf
4728,54,11,65,0,inf
4729,59,12,71,0,inf
4730,67,7,74,1,2.571285253258665
4731,66,5,71,0,inf
4732,56,7,63,0,inf
4733,67,11,78,0,inf
4734,57,5,62,0,inf
4735,64,7,71,0,inf
4736,53,9,62,0,inf
4737,50,13,63,0,inf
4738,61,7,68,0,inf
4739,54,6,60,0,inf
4740,63,8,71,0,inf
4741,66,8,74,0,inf
4742,61,7,68,0,inf
4743,67,11,78,0,inf
4744,60,12,72,0,inf
4745,54,7,61,0,inf
4746,65,13,78,0,inf
4747,51,12,63,0,inf
4748,50,13,63,0,inf
4749,60,10,70,0,inf
4750,65,8,73,0,inf
4751,51,5,56,0,inf
4752,60,9,69,0,inf
4753,50,5,55,0,inf
4754,51,12,63,0,inf
4755,60,12,72,0,inf
4756,52,8,60,0,inf
4757,57,10,67,0,inf
4758,63,11,74,0,inf
4759,66,5,71,0,inf
4760,57,12,69,0,inf
4761,62,12,74,0,inf
4762,66,9,75,0,inf
4763,55,12,67,0,inf
4764,60,12,72,0,inf
4765,61,5,66,0,inf
4766,67,6,73,0,inf
4767,52,8,60,0,inf
4768,53,9,62,0,inf
4769,58,13,71,0,inf
4770,61,8,69,0,inf
4771,60,7,67,0,inf
4772,54,5,59,0,inf
4773,66,10,76,0,inf
4774,65,10,75,0,inf
4775,56,12,68,0,inf
4776,67,5,72,0,inf
4777,54,11,65,0,inf
4778,52,13,65,0,inf
4779,63,5,68,0,inf
4780,67,8,75,0,inf
4781,65,9,74,0,inf
4782,58,13,71,0,inf
4783,66,6,72,0,inf
4784,55,11,66,0,inf
4785,58,10,68,0,inf
4786,50,13,63,0,inf
4787,61,9,70,0,inf
4788,62,13,75,0,inf
4789,59,5,64,0,inf
4790,50,8,58,0,inf
4791,52,7,59,0,inf
4792,60,10,70,0,inf
4793,61,8,69,0,inf
4794,67,12,79,0,inf
4795,57,13,70,0,inf
4796,53,10,63,0,inf
4797,63,7,70,0,inf
4798,64,6,70,0,inf
4799,55,6,61,0,inf
4800,50,10,60,0,inf
4801,62,13,75,0,inf
4802,61,7,68,0,inf
4803,64,10,74,0,inf
4804,56,8,64,0,inf
4805,54,13,67,0,inf
4806,58,8,66,0,inf
4807,52,6,58,0,inf
4808,65,12,77,0,inf
4809,60,10,70,0,inf
4810,61,7,68,0,inf
4811,55,8,63,0,inf
4812,64,8,72,0,inf
4813,57,10,67,0,inf
4814,53,11,64,0,inf
4815,51,6,57,0,inf
4816,65,12,77,0,inf
4817,61,9,70,0,inf
4818,57,10,67,0,inf
4819,52,6,58,0,inf
4820,65,9,74,0,inf
4821,53,10,63,0,inf
4822,61,11,72,0,inf
4823,52,13,65,0,inf
4824,61,13,74,0,inf
4825,52,12,64,0,inf
4826,52,11,63,0,inf
4827,56,5,61,0,inf
4828,55,12,67,0,inf
4829,67,10,77,0,inf
4830,58,12,70,0,inf
4831,52,6,58,0,inf
4832,54,9,63,0,inf
4833,61,8,69,0,inf
4834,60,13,73,0,inf
4835,67,7,74,0,inf
4836,58,7,65,1,1.1656425751472668
4837,51,7,58,0,inf
4838,50,5,55,0,inf
4839,62,12,74,0,inf
4840,56,7,63,0,inf
4841,58,12,70,0,inf
4842,51,10,61,0,inf
4843,66,7,73,0,inf
4844,51,13,64,0,inf
4845,54,9,63,0,inf
4846,60,5,65,0,inf
4847,56,9,65,0,inf
4848,62,9,71,0,inf
4849,51,5,56,0,inf
4850,61,10,71,0,inf
4851,60,12,72,0,inf
4852,65,7,72,0,inf
4853,65,12,77,0,inf
4854,63,13,76,0,inf
4855,57,10,67,0,inf
4856,58,5,63,0,inf
4857,64,7,71,0,inf
4858,52,7,59,0,inf
4859,53,6,59,0,inf
4860,52,11,63,0,inf
4861,62,5,67,0,inf
4862,61,12,73,0,inf
4863,54,13,67,0,inf
4864,58,11,69,0,inf
4865,52,7,59,0,inf
4866,50,10,60,0,inf
4867,64,12,76,0,inf
4868,58,12,70,0,inf
4869,57,13,70,0,inf
4870,60,11,71,0,inf
4871,55,12,67,0,inf
4872,62,11,73,0,inf
4873,64,12,76,0,inf
4874,63,10,73,0,inf
4875,56,9,65,0,inf
4876,50,6,56,0,inf
4877,56,11,67,0,inf
4878,67,6,73,0,inf
4879,63,8,71,0,inf
4880,65,11,76,0,inf
4881,67,7,74,0,inf
4882,59,5,64,0,inf
4883,50,6,56,0,inf
4884,51,7,58,0,inf
4885,61,7,68,0,inf
4886,67,11,78,0,inf
4887,54,10,64,0,inf
4888,64,12,76,0,inf
4889,56,12,68,0,inf
4890,65,5,70,0,inf
4891,64,6,70,0,inf
4892,55,12,67,0,inf
4893,60,10,70,0,inf
4894,60,7,67,0,inf
4895,50,8,58,0,inf
4896,59,12,71,0,inf
4897,61,13,74,0,inf
4898,63,11,74,0,inf
4899,57,10,67,0,inf
4900,62,7,69,0,inf
4901,50,12,62,0,inf
4902,67,12,79,0,inf
4903,57,9,66,0,inf
4904,59,10,69,0,inf
4905,54,11,65,0,inf
4906,64,8,72,0,inf
4907,57,12,69,0,inf
4908,50,7,57,0,inf
4909,52,6,58,0,inf
4910,54,12,66,0,inf
4911,61,13,74,0,inf
4912,54,5,59,0,inf
4913,60,11,71,0,inf
4914,64,6,70,0,inf
4915,64,8,72,0,inf
4916,55,7,62,0,inf
4917,61,8,69,0,inf
4918,63,5,68,0,inf
4919,51,6,57,0,inf
4920,58,12,70,0,inf
4921,64,11,75,0,inf
4922,56,7,63,0,inf
4923,58,7,65,0,inf
4924,66,10,76,0,inf
4925,58,11,69,1,6.787610188640059
4926,63,5,68,0,inf
4927,63,11,74,0,inf
4928,57,7,64,0,inf
4929,58,13,71,0,inf
4930,54,8,62,0,inf
4931,61,10,71,0,inf
4932,56,9,65,0,inf
4933,61,12,73,0,inf
4934,54,7,61,0,inf
4935,62,10,72,0,inf
4936,56,9,65,0,inf
4937,58,10,68,0,inf
4938,62,5,67,0,inf
4939,52,11,63,0,inf
4940,53,12,65,0,inf
4941,64,7,71,0,inf
4942,56,7,63,0,inf
4943,51,11,62,0,inf
4944,66,7,73,0,inf
4945,54,6,60,0,inf
4946,67,12,79,0,inf
4947,55,5,60,0,inf
4948,54,12,66,0,inf
4949,62,13,75,0,inf
4950,65,8,73,0,inf
4951,56,8,64,0,inf
4952,61,11,72,0,inf
4953,62,7,69,0,inf
4954,59,5,64,0,inf
4955,54,5,59,0,inf
4956,66,8,74,0,inf
4957,66,9,75,0,inf
4958,51,7,58,0,inf
4959,50,6,56,0,inf
4960,52,7,59,0,inf
4961,60,10,70,0,inf
4962,56,13,69,0,inf
4963,61,11,72,0,inf
4964,50,6,56,0,inf
4965,62,13,75,0,inf
4966,62,5,67,0,inf
4967,58,7,65,0,inf
4968,52,6,58,0,inf
4969,67,12,79,0,inf
4970,51,10,61,0,inf
4971,65,12,77,0,inf
4972,55,13,68,0,inf
4973,56,9,65,0,inf
4974,55,5,60,0,inf
4975,61,6,67,0,inf
4976,61,12,73,0,inf
4977,57,10,67,0,inf
4978,58,10,68,0,inf
4979,56,11,67,0,inf
4980,62,9,71,0,inf
4981,50,7,57,0,inf
4982,64,7,71,0,inf
4983,54,12,66,0,inf
4984,64,8,72,0,inf
4985,52,11,63,1,4.197060671451929
4986,64,6,70,0,inf
4987,53,5,58,0,inf
4988,62,9,71,0,inf
4989,61,9,70,0,inf
4990,60,13,73,0,inf
4991,63,11,74,0,inf
4992,56,7,63,0,inf
4993,62,6,68,0,inf
4994,67,6,73,0,inf
4995,51,13,64,0,inf
4996,55,6,61,0,inf
4997,56,12,68,0,inf
4998,62,9,71,0,inf
4999,53,8,61,0,inf
5000,60,10,70,0,inf
5001,50,5,55,0,inf
5002,64,5,69,0,inf
5003,60,9,69,0,inf
5004,54,12,66,0,inf
5005,58,13,71,0,inf
5006,53,7,60,0,inf
5007,51,5,56,0,inf
5008,52,7,59,0,inf
5009,61,5,66,0,inf
5010,51,10,61,0,inf
5011,66,13,79,0,inf
5012,59,6,65,0,inf
5013,65,11,76,0,inf
5014,50,11,61,0,inf
5015,63,5,68,0,inf
5016,52,10,62,0,inf
5017,59,8,67,0,inf
5018,54,10,64,0,inf
5019,64,10,74,0,inf
5020,58,10,68,0,inf
5021,63,9,72,0,inf
5022,51,10,61,0,inf
5023,56,5,61,0,inf
5024,63,11,74,0,inf
5025,63,9,72,0,inf
5026,52,5,57,0,inf
5027,60,10,70,0,inf
5028,67,9,76,0,inf
5029,59,8,67,0,inf
5030,59,9,68,0,inf
5031,59,13,72,0,inf
5032,64,5,69,0,inf
5033,60,12,72,0,inf
5034,50,6,56,0,inf
5035,58,10,68,0,inf
5036,51,12,63,0,inf
5037,64,12,76,0,inf
5038,59,6,65,0,inf
5039,65,6,71,0,inf
5040,66,5,71,0,inf
5041,63,6,69,0,inf
5042,61,7,68,0,inf
5043,50,5,55,0,inf
5044,53,8,61,0,inf
5045,55,13,68,0,inf
5046,59,8,67,0,inf
5047,66,8,74,0,inf
5048,56,6,62,0,inf
5049,61,10,71,0,inf
5050,58,9,67,0,inf
5051,50,13,63,0,inf
5052,67,11,78,0,inf
5053,62,8,70,0,inf
5054,64,10,74,1,8.740725103924376
5055,65,11,76,0,inf
5056,54,12,66,0,inf
5057,59,8,67,0,inf
5058,64,5,69,0,inf
5059,66,11,77,0,inf
5060,53,9,62,0,inf
5061,55,13,68,0,inf
5062,54,8,62,0,inf
5063,50,8,58,0,inf
5064,51,10,61,0,inf
5065,58,10,68,0,inf
5066,57,12,69,0,inf
5067,65,13,78,0,inf
5068,62,7,69,0,inf
5069,51,7,58,0,inf
5070,53,7,60,0,inf
5071,58,12,70,0,inf
5072,61,10,71,0,inf
5073,50,8,58,0,inf
5074,58,13,71,0,inf
5075,52,8,60,0,inf
5076,65,5,70,0,inf
5077,67,6,73,0,inf
5078,50,8,58,0,inf
5079,50,11,61,0,inf
5080,61,8,69,0,inf
5081,61,6,67,0,inf
5082,55,9,64,0,inf
5083,59,12,71,0,inf
5084,59,9,68,0,inf
5085,54,10,64,0,inf
5086,52,9,61,0,inf
5087,57,13,70,0,inf
5088,57,9,66,0,inf
5089,62,11,73,0,inf
5090,59,10,69,0,inf
5091,56,8,64,0,inf
5092,60,13,73,0,inf
5093,65,6,71,0,inf
5094,57,13,70,0,inf
5095,65,11,76,0,inf
5096,51,5,56,0,inf
5097,52,13,65,0,inf
5098,50,11,61,0,inf
5099,62,13,75,0,inf
5100,61,13,74,0,inf
5101,58,8,66,0,inf
5102,66,6,72,0,inf
5103,50,5,55,0,inf
5104,64,6,70,0,inf
5105,50,8,58,0,inf
5106,59,10,69,0,inf
5107,62,5,67,0,inf
5108,61,5,66,0,inf
5109,55,10,65,0,inf
5110,53,5,58,0,inf
5111,55,13,68,0,inf
5112,54,12,66,0,inf
5113,50,8,58,0,inf
5114,65,11,76,0,inf
5115,61,8,69,0,inf
5116,61,5,66,0,inf
5117,61,6,67,0,inf
5118,54,8,62,0,inf
5119,53,9,62,0,inf
5120,51,12,63,0,inf
5121,53,10,63,1,0.37779186736411674
5122,50,6,56,0,inf
5123,63,6,69,0,inf
5124,62,6,68,0,inf
5125,66,7,73,0,inf
5126,52,10,62,0,inf
5127,62,12,74,0,inf
5128,57,13,70,0,inf
5129,67,7,74,0,inf
5130,58,11,69,0,inf
5131,67,11,78,0,inf
5132,64,10,74,0,inf
5133,59,6,65,0,inf
5134,58,12,70,0,inf
5135,61,13,74,0,inf
5136,52,7,59,0,inf
5137,62,10,72,0,inf
5138,64,11,75,0,inf
5139,53,13,66,0,inf
5140,56,13,69,0,inf
5141,66,12,78,0,inf
5142,64,7,71,0,inf
5143,65,10,75,0,inf
5144,58,5,63,0,inf
5145,66,13,79,0,inf
5146,56,11,67,0,inf
5147,67,11,78,0,inf
5148,66,11,77,0,inf
5149,61,12,73,0,inf
5150,63,8,71,0,inf
5151,56,12,68,0,inf
5152,50,6,56,0,inf
5153,60,12,72,0,inf
5154,52,11,63,0,inf
5155,59,11,70,0,inf
5156,54,9,63,0,inf
5157,54,10,64,0,inf
5158,65,6,71,0,inf
5159,53,13,66,0,inf
5160,54,5,59,0,inf
5161,58,10,68,0,inf
5162,63,7,70,0,inf
5163,60,11,71,0,inf
5164,66,10,76,0,inf
5165,63,11,74,0,inf
5166,50,10,60,0,inf
5167,60,11,71,0,inf
5168,50,8,58,0,inf
5169,52,9,61,0,inf
5170,50,6,56,0,inf
5171,55,10,65,0,inf
5172,51,9,60,0,inf
5173,50,13,63,0,inf
5174,54,13,67,0,inf
5175,54,13,67,0,inf
5176,59,12,71,0,inf
5177,50,13,63,0,inf
5178,67,9,76,0,inf
5179,60,13,73,1,2.6923372741754577
5180,62,11,73,0,inf
5181,56,11,67,0,inf
5182,59,5,64,0,inf
5183,52,11,63,0,inf
5184,52,6,58,0,inf
5185,59,13,72,0,inf
5186,65,12,77,0,inf
5187,59,5,64,0,inf
5188,62,8,70,0,inf
5189,52,7,59,0,inf
5190,60,13,73,0,inf
5191,60,7,67,0,inf
5192,58,10,68,1,8.342844707462973
5193,51,9,60,0,inf
5194,50,8,58,0,inf
5195,50,11,61,0,inf
5196,66,6,72,0,inf
5197,57,6,63,0,inf
5198,55,10,65,0,inf
5199,67,11,78,0,inf
5200,62,5,67,0,inf
5201,67,5,72,0,inf
5202,51,8,59,0,inf
5203,53,7,60,0,inf
5204,54,9,63,0,inf
5205,64,8,72,0,inf
5206,53,9,62,0,inf
5207,57,10,67,0,inf
5208,55,11,66,0,inf
5209,51,9,60,0,inf
5210,60,10,70,0,inf
5211,58,5,63,0,inf
5212,59,9,68,0,inf
5213,55,8,63,0,inf
5214,62,11,73,0,inf
5215,51,8,59,0,inf
5216,58,6,64,0,inf
5217,52,10,62,0,inf
5218,62,7,69,0,inf
5219,65,6,71,0,inf
5220,53,7,60,0,inf
5221,60,12,72,0,inf
5222,63,7,70,0,inf
5223,63,6,69,0,inf
5224,50,12,62,0,inf
5225,56,13,69,0,inf
5226,55,11,66,0,inf
5227,56,6,62,0,inf
5228,52,13,65,0,inf
5229,67,9,76,0,inf
5230,61,6,67,0,inf
5231,53,9,62,0,inf
5232,60,10,70,0,inf
5233,63,13,76,0,inf
5234,65,6,71,0,inf
5235,66,5,71,0,inf
5236,60,6,66,0,inf
5237,50,7,57,0,inf
5238,58,8,66,0,inf
5239,67,5,72,0,inf
5240,62,5,67,0,inf
5241,53,9,62,0,inf
5242,66,7,73,0,inf
5243,56,13,69,0,inf
5244,52,9,61,0,inf
5245,55,12,67,0,inf
5246,67,9,76,0,inf
5247,63,13,76,0,inf
5248,66,11,77,0,inf
5249,50,12,62,0,inf
5250,56,6,62,0,inf
5251,57,5,62,0,inf
5252,64,13,77,0,inf
5253,61,12,73,0,inf
5254,66,9,75,0,inf
5255,64,5,69,0,inf
5256,50,5,55,0,inf
5257,54,9,63,1,7.562638997188863
5258,50,12,62,0,inf
5259,66,13,79,1,5.727127225184262
5260,52,6,58,0,inf
5261,56,5,61,0,inf
5262,54,12,66,0,inf
5263,61,13,74,0,inf
5264,61,6,67,0,inf
5265,51,7,58,0,inf
5266,59,5,64,0,inf
5267,52,13,65,0,inf
5268,64,6,70,0,inf
5269,64,6,70,0,inf
5270,57,9,66,0,inf
5271,55,7,62,0,inf
5272,52,5,57,0,inf
5273,64,8,72,0,inf
5274,50,5,55,0,inf
5275,53,7,60,0,inf
5276,63,6,69,0,inf
5277,62,7,69,0,inf
5278,57,13,70,0,inf
5279,63,6,69,0,inf
5280,61,11,72,0,inf
5281,62,6,68,0,inf
5282,54,8,62,0,inf
5283,59,11,70,0,inf
5284,56,11,67,0,inf
5285,50,10,60,0,inf
5286,50,5,55,0,inf
5287,65,12,77,0,inf
5288,65,9,74,0,inf
5289,61,5,66,0,inf
5290,64,12,76,0,inf
5291,52,11,63,0,inf
5292,67,10,77,0,inf
5293,66,13,79,0,inf
5294,50,6,56,0,inf
5295,58,9,67,0,inf
5296,52,12,64,0,inf
5297,60,10,70,0,inf
5298,52,5,57,0,inf
5299,67,13,80,0,inf
5300,67,12,79,1,10.576975829891936
5301,52,11,63,0,inf
5302,65,13,78,0,inf
5303,65,7,72,0,inf
5304,59,8,67,0,inf
5305,51,10,61,0,inf
5306,61,11,72,0,inf
5307,55,6,61,0,inf
5308,59,8,67,0,inf
5309,65,8,73,0,inf
5310,66,12,78,0,inf
5311,64,9,73,0,inf
5312,51,5,56,0,inf
5313,67,5,72,0,inf
5314,63,13,76,0,inf
5315,66,6,72,0,inf
5316,59,9,68,0,inf
5317,64,7,71,0,inf
5318,59,6,65,0,inf
5319,59,7,66,0,inf
5320,58,12,70,0,inf
5321,58,5,63,0,inf
5322,54,9,63,0,inf
5323,65,6,71,0,inf
5324,59,5,64,0,inf
5325,51,13,64,0,inf
5326,54,9,63,0,inf
5327,56,11,67,1,6.032392882507182
5328,60,13,73,0,inf
5329,57,10,67,0,inf
5330,63,13,76,0,inf
5331,67,11,78,1,7.6659907833509635
5332,65,11,76,0,inf
5333,59,12,71,0,inf
5334,64,6,70,0,inf
5335,61,11,72,0,inf
5336,54,5,59,0,inf
5337,62,10,72,0,inf
5338,50,5,55,0,inf
5339,56,6,62,0,inf
5340,67,8,75,0,inf
5341,65,5,70,0,inf
5342,50,9,59,0,inf
5343,52,12,64,0,inf
5344,62,11,73,0,inf
5345,66,5,71,0,inf
5346,50,10,60,0,inf
5347,58,11,69,0,inf
5348,50,7,57,0,inf
5349,55,10,65,0,inf
5350,66,9,75,0,inf
5351,65,7,72,0,inf
5352,57,13,70,0,inf
5353,51,10,61,0,inf
5354,54,5,59,0,inf
5355,63,10,73,0,inf
5356,58,13,71,0,inf
5357,66,11,77,0,inf
5358,62,5,67,0,inf
5359,54,13,67,0,inf
5360,52,7,59,0,inf
5361,51,10,61,0,inf
5362,65,10,75,0,inf
5363,62,9,71,0,inf
5364,62,11,73,0,inf
5365,65,13,78,0,inf
5366,57,9,66,0,inf
5367,50,6,56,0,inf
5368,67,9,76,0,inf
5369,60,12,72,0,inf
5370,56,13,69,0,inf
5371,50,12,62,0,inf
5372,54,13,67,0,inf
5373,54,5,59,0,inf
5374,52,5,57,0,inf
5375,55,9,64,0,inf
5376,57,6,63,0,inf
5377,54,7,61,0,inf
5378,59,12,71,0,inf
5379,59,6,65,0,inf
5380,58,5,63,0,inf
5381,67,7,74,0,inf
5382,60,8,68,0,inf
5383,64,8,72,0,inf
5384,52,6,58,0,inf
5385,60,10,70,0,inf
5386,56,7,63,0,inf
5387,50,5,55,0,inf
5388,62,5,67,0,inf
5389,52,8,60,0,inf
5390,55,8,63,0,inf
5391,50,7,57,0,inf
5392,59,5,64,0,inf
5393,62,6,68,0,inf
5394,51,6,57,0,inf
5395,64,13,77,0,inf
5396,65,8,73,0,inf
5397,63,6,69,0,inf
5398,64,12,76,0,inf
5399,65,12,77,0,inf
5400,53,5,58,0,inf
5401,58,10,68,0,inf
5402,66,5,71,0,inf
5403,53,6,59,0,inf
5404,50,6,56,0,inf
5405,55,12,67,0,inf
5406,52,13,65,0,inf
5407,66,6,72,0,inf
5408,63,11,74,0,inf
5409,60,12,72,0,inf
5410,59,6,65,0,inf
5411,63,6,69,0,inf
5412,64,7,71,0,inf
5413,53,11,64,0,inf
5414,58,13,71,0,inf
5415,55,12,67,0,inf
5416,67,8,75,0,inf
5417,61,5,66,0,inf
5418,51,6,57,0,inf
5419,67,9,76,0,inf
5420,63,11,74,0,inf
5421,52,8,60,0,inf
5422,66,13,79,0,inf
5423,64,12,76,0,inf
5424,62,6,68,0,inf
5425,53,9,62,0,inf
5426,54,11,65,0,inf
5427,55,9,64,1,1.2682014146655405
5428,51,10,61,0,inf
5429,50,10,60,0,inf
5430,60,10,70,0,inf
5431,51,5,56,0,inf
5432,56,11,67,0,inf
5433,54,13,67,0,inf
5434,53,7,60,0,inf
5435,57,5,62,0,inf
5436,59,12,71,0,inf
5437,53,8,61,0,inf
5438,66,7,73,0,inf
5439,55,12,67,0,inf
5440,50,12,62,0,inf
5441,67,5,72,0,inf
5442,53,11,64,0,inf
5443,64,6,70,0,inf
5444,56,5,61,0,inf
5445,60,9,69,0,inf
5446,65,12,77,0,inf
5447,51,10,61,0,inf
5448,63,10,73,0,inf
5449,56,8,64,0,inf
5450,52,5,57,0,inf
5451,63,5,68,0,inf
5452,59,10,69,0,inf
5453,64,13,77,0,inf
5454,60,11,71,0,inf
5455,53,7,60,0,inf
5456,52,9,61,0,inf
5457,54,10,64,0,inf
5458,57,11,68,0,inf
5459,58,8,66,0,inf
5460,51,5,56,0,inf
5461,51,12,63,0,inf
5462,60,9,69,0,inf
5463,52,11,63,0,inf
5464,61,10,71,0,inf
5465,52,13,65,0,inf
5466,60,11,71,0,inf
5467,56,6,62,0,inf
5468,53,13,66,0,inf
5469,56,10,66,0,inf
5470,58,5,63,0,inf
5471,62,5,67,0,inf
5472,61,5,66,0,inf
5473,63,6,69,0,inf
5474,50,12,62,0,inf
5475,65,8,73,0,inf
5476,66,6,72,0,inf
5477,54,5,59,0,inf
5478,66,11,77,0,inf
5479,62,12,74,0,inf
5480,58,6,64,0,inf
5481,60,10,70,0,inf
5482,59,13,72,0,inf
5483,54,5,59,0,inf
5484,60,5,65,0,inf
5485,54,7,61,0,inf
5486,53,8,61,0,inf
5487,51,5,56,0,inf
5488,55,8,63,0,inf
5489,64,7,71,0,inf
5490,58,11,69,0,inf
5491,54,7,61,0,inf
5492,57,10,67,0,inf
5493,61,7,68,0,inf
5494,52,5,57,0,inf
5495,66,11,77,0,inf
5496,56,11,67,0,inf
5497,53,11,64,0,inf
5498,65,5,70,0,inf
5499,52,9,61,0,inf
5500,57,11,68,0,inf
5501,55,6,61,0,inf
5502,61,13,74,0,inf
5503,63,12,75,0,inf
5504,60,8,68,0,inf
5505,51,10,61,0,inf
5506,62,10,72,0,inf
5507,67,6,73,0,inf
5508,63,7,70,0,inf
5509,53,8,61,0,inf
5510,66,6,72,0,inf
5511,67,8,75,0,inf
5512,67,7,74,0,inf
5513,63,12,75,0,inf
5514,55,5,60,0,inf
5515,50,8,58,0,inf
5516,67,9,76,0,inf
5517,61,9,70,0,inf
5518,60,13,73,1,4.883698985862665
5519,63,12,75,0,inf
5520,55,9,64,0,inf
5521,63,11,74,0,inf
5522,58,7,65,0,inf
5523,61,6,67,0,inf
5524,52,10,62,0,inf
5525,55,5,60,0,inf
5526,56,9,65,1,4.695645647308872
5527,52,7,59,0,inf
5528,63,10,73,0,inf
5529,60,13,73,0,inf
5530,59,11,70,0,inf
5531,65,5,70,1,1.075864533551993
5532,52,7,59,0,inf
5533,65,7,72,0,inf
5534,52,8,60,0,inf
5535,55,8,63,0,inf
5536,67,12,79,0,inf
5537,67,12,79,0,inf
5538,57,5,62,0,inf
5539,57,9,66,0,inf
5540,56,13,69,0,inf
5541,59,9,68,0,inf
5542,58,9,67,0,inf
5543,57,9,66,0,inf
5544,55,6,61,0,inf
5545,67,9,76,0,inf
5546,51,10,61,0,inf
5547,53,12,65,0,inf
5548,61,6,67,0,inf
5549,55,9,64,0,inf
5550,63,6,69,0,inf
5551,65,12,77,0,inf
5552,66,6,72,0,inf
5553,53,9,62,0,inf
5554,61,11,72,0,inf
5555,56,11,67,0,inf
5556,64,12,76,0,inf
5557,65,7,72,0,inf
5558,55,12,67,0,inf
5559,66,9,75,0,inf
5560,56,5,61,0,inf
5561,65,10,75,0,inf
5562,67,8,75,0,inf
5563,61,5,66,0,inf
5564,61,5,66,0,inf
5565,51,5,56,0,inf
5566,61,7,68,0,inf
5567,67,5,72,0,inf
5568,61,6,67,0,inf
5569,66,10,76,0,inf
5570,60,13,73,0,inf
5571,63,7,70,0,inf
5572,50,12,62,0,inf
5573,51,7,58,0,inf
5574,55,10,65,0,inf
5575,64,12,76,0,inf
5576,50,10,60,0,inf
5577,52,5,57,0,inf
5578,62,9,71,0,inf
5579,54,12,66,0,inf
5580,63,13,76,0,inf
5581,62,6,68,0,inf
5582,63,6,69,0,inf
5583,58,9,67,0,inf
5584,51,13,64,0,inf
5585,53,10,63,0,inf
5586,56,5,61,0,inf
5587,57,12,69,0,inf
5588,61,8,69,0,inf
5589,53,11,64,0,inf
5590,61,12,73,0,inf
5591,56,10,66,0,inf
5592,57,7,64,1,5.274846212684167
5593,50,7,57,0,inf
5594,59,11,70,0,inf
5595,55,8,63,0,inf
5596,62,12,74,0,inf
5597,64,13,77,0,inf
5598,67,12,79,0,inf
5599,63,9,72,0,inf
5600,51,8,59,0,inf
5601,52,9,61,0,inf
5602,54,10,64,0,inf
5603,51,7,58,0,inf
5604,58,8,66,0,inf
5605,65,11,76,0,inf
5606,65,13,78,0,inf
5607,64,6,70,0,inf
5608,56,8,64,0,inf
5609,67,6,73,0,inf
5610,63,8,71,0,inf
5611,51,10,61,0,inf
5612,58,11,69,0,inf
5613,62,9,71,1,0.9918974295880076
5614,64,13,77,0,inf
5615,60,5,65,0,inf
5616,61,6,67,0,inf
5617,63,12,75,0,inf
5618,57,12,69,0,inf
5619,57,8,65,0,inf
5620,59,9,68,0,inf
5621,52,10,62,0,inf
5622,51,9,60,0,inf
5623,54,10,64,0,inf
5624,56,7,63,0,inf
5625,50,13,63,0,inf
5626,54,8,62,0,inf
5627,55,6,61,0,inf
5628,67,10,77,0,inf
5629,65,5,70,0,inf
5630,57,11,68,0,inf
5631,56,9,65,0,inf
5632,66,6,72,0,inf
5633,56,11,67,0,inf
5634,67,7,74,0,inf
5635,66,8,74,0,inf
5636,50,11,61,0,inf
5637,62,11,73,0,inf
5638,53,10,63,0,inf
5639,67,5,72,0,inf
5640,50,10,60,0,inf
5641,58,8,66,0,inf
5642,52,11,63,0,inf
5643,58,12,70,0,inf
5644,55,11,66,0,inf
5645,54,6,60,0,inf
5646,51,8,59,0,inf
5647,54,10,64,0,inf
5648,59,10,69,0,inf
5649,53,8,61,0,inf
5650,52,5,57,0,inf
5651,53,8,61,0,inf
5652,55,7,62,0,inf
5653,50,13,63,0,inf
5654,55,6,61,0,inf
5655,66,8,74,1,1.13273478721581
5656,59,5,64,0,inf
5657,58,9,67,0,inf
5658,50,12,62,0,inf
5659,67,6,73,0,inf
5660,58,13,71,0,inf
5661,52,11,63,0,inf
5662,60,10,70,0,inf
5663,59,11,70,0,inf
5664,60,10,70,0,inf
5665,60,7,67,0,inf
5666,64,12,76,0,inf
5667,56,6,62,0,inf
5668,58,9,67,0,inf
5669,63,10,73,0,inf
5670,57,11,68,0,inf
5671,53,10,63,0,inf
5672,66,7,73,0,inf
5673,62,7,69,0,inf
5674,62,5,67,0,inf
5675,55,13,68,0,inf
5676,62,10,72,0,inf
5677,67,10,77,0,inf
5678,63,12,75,0,inf
5679,65,9,74,0,inf
5680,64,6,70,0,inf
5681,58,12,70,0,inf
5682,66,5,71,0,inf
5683,53,8,61,0,inf
5684,56,10,66,0,inf
5685,62,9,71,0,inf
5686,59,12,71,0,inf
5687,55,5,60,0,inf
5688,63,8,71,0,inf
5689,52,11,63,0,inf
5690,67,12,79,0,inf
5691,57,10,67,0,inf
5692,53,5,58,0,inf
5693,64,9,73,0,inf
5694,55,6,61,0,inf
5695,64,12,76,0,inf
5696,57,12,69,0,inf
5697,59,12,71,0,inf
5698,63,6,69,0,inf
5699,53,11,64,0,inf
5700,54,12,66,0,inf
5701,66,10,76,1,9.017900421232852
5702,56,11,67,0,inf
5703,50,10,60,0,inf
5704,66,11,77,0,inf
5705,56,10,66,0,inf
5706,56,13,69,0,inf
5707,54,5,59,0,inf
5708,50,8,58,0,inf
5709,54,7,61,0,inf
5710,56,9,65,0,inf
5711,54,11,65,0,inf
5712,53,12,65,0,inf
5713,61,5,66,0,inf
5714,50,5,55,0,inf
5715,59,7,66,0,inf
5716,60,10,70,0,inf
5717,61,7,68,0,inf
5718,56,6,62,0,inf
5719,51,13,64,0,inf
5720,65,12,77,0,inf
5721,58,5,63,0,inf
5722,59,9,68,0,inf
5723,52,9,61,0,inf
5724,67,6,73,0,inf
5725,53,7,60,0,inf
5726,50,9,59,0,inf
5727,51,13,64,0,inf
5728,50,8,58,0,inf
5729,61,10,71,0,inf
5730,59,11,70,0,inf
5731,62,10,72,0,inf
5732,57,11,68,0,inf
5733,55,12,67,0,inf
5734,55,10,65,0,inf
5735,57,8,65,0,inf
5736,64,11,75,0,inf
5737,54,6,60,0,inf
5738,65,13,78,0,inf
5739,64,13,77,0,inf
5740,58,13,71,0,inf
5741,65,12,77,0,inf
5742,52,5,57,0,inf
5743,63,7,70,0,inf
5744,60,11,71,0,inf
5745,66,5,71,0,inf
5746,59,12,71,0,inf
5747,50,9,59,0,inf
5748,52,13,65,0,inf
5749,58,5,63,0,inf
5750,53,11,64,0,inf
5751,53,6,59,0,inf
5752,50,5,55,0,inf
5753,65,6,71,0,inf
5754,60,6,66,0,inf
5755,54,11,65,0,inf
5756,50,6,56,0,inf
5757,64,10,74,0,inf
5758,51,11,62,0,inf
5759,54,6,60,0,inf
5760,56,11,67,0,inf
5761,66,9,75,0,inf
5762,67,12,79,0,inf
5763,64,13,77,0,inf
5764,56,11,67,0,inf
5765,53,10,63,0,inf
5766,51,7,58,0,inf
5767,64,7,71,0,inf
5768,62,7,69,0,inf
5769,64,13,77,0,inf
5770,51,6,57,1,3.6270550015652816
5771,59,12,71,0,inf
5772,51,6,57,0,inf
5773,61,10,71,1,9.99815255857763
5774,58,13,71,0,inf
5775,65,10,75,0,inf
5776,58,10,68,0,inf
5777,62,9,71,0,inf
5778,67,7,74,0,inf
5779,56,12,68,0,inf
5780,66,13,79,0,inf
5781,64,7,71,0,inf
5782,66,12,78,0,inf
5783,66,12,78,0,inf
5784,57,12,69,0,inf
5785,51,10,61,0,inf
5786,54,5,59,0,inf
5787,65,8,73,0,inf
5788,53,11,64,0,inf
5789,55,10,65,0,inf
5790,53,11,64,0,inf
5791,56,8,64,0,inf
5792,54,9,63,1,4.540292389737537
5793,58,5,63,0,inf
5794,61,13,74,0,inf
5795,54,5,59,0,inf
5796,54,5,59,0,inf
5797,54,8,62,0,inf
5798,53,8,61,0,inf
5799,53,11,64,0,inf
5800,65,11,76,0,inf
5801,54,9,63,0,inf
5802,58,6,64,0,inf
5803,63,11,74,0,inf
5804,57,6,63,0,inf
5805,58,12,70,0,inf
5806,50,9,59,0,inf
5807,55,6,61,0,inf
5808,64,6,70,0,inf
5809,67,9,76,0,inf
5810,58,8,66,0,inf
5811,54,13,67,0,inf
5812,65,13,78,0,inf
5813,55,7,62,0,inf
5814,53,7,60,0,inf
5815,51,5,56,0,inf
5816,57,10,67,0,inf
5817,62,7,69,0,inf
5818,59,11,70,0,inf
5819,54,9,63,0,inf
5820,65,8,73,0,inf
5821,67,7,74,0,inf
5822,60,11,71,0,inf
5823,50,6,56,0,inf
5824,59,7,66,0,inf
5825,59,11,70,0,inf
5826,52,7,59,0,inf
5827,51,9,60,0,inf
5828,63,13,76,0,inf
5829,59,9,68,0,inf
5830,63,8,71,0,inf
5831,66,5,71,0,inf
5832,55,6,61,0,inf
5833,53,6,59,0,inf
5834,53,6,59,0,inf
5835,62,8,70,0,inf
5836,52,9,61,0,inf
5837,64,12,76,0,inf
5838,54,6,60,0,inf
5839,66,13,79,0,inf
5840,51,13,64,0,inf
5841,67,9,76,0,inf
5842,63,10,73,0,inf
5843,60,8,68,0,inf
5844,63,7,70,0,inf
5845,65,7,72,0,inf
5846,61,8,69,0,inf
5847,52,11,63,0,inf
5848,53,6,59,0,inf
5849,54,11,65,0,inf
5850,62,6,68,0,inf
5851,57,9,66,0,inf
5852,62,7,69,0,inf
5853,50,12,62,0,inf
5854,60,8,68,0,inf
5855,60,7,67,0,inf
5856,67,9,76,0,inf
5857,63,10,73,0,inf
5858,59,12,71,0,inf
5859,50,13,63,0,inf
5860,54,9,63,1,8.496166583184284
5861,57,6,63,0,inf
5862,58,9,67,0,inf
5863,66,13,79,1,11.338541296947241
5864,57,5,62,0,inf
5865,63,6,69,0,inf
5866,63,8,71,0,inf
5867,62,9,71,1,2.757585469088596
5868,63,8,71,0,inf
5869,58,11,69,0,inf
5870,62,6,68,0,inf
5871,59,11,70,0,inf
5872,54,9,63,0,inf
5873,57,5,62,0,inf
5874,65,10,75,0,inf
5875,56,11,67,0,inf
5876,53,8,61,0,inf
5877,51,13,64,0,inf
5878,50,11,61,0,inf
5879,67,9,76,0,inf
5880,55,8,63,0,inf
5881,53,7,60,0,inf
5882,58,7,65,0,inf
5883,52,8,60,0,inf
5884,66,7,73,0,inf
5885,59,7,66,0,inf
5886,62,8,70,0,inf
5887,60,12,72,0,inf
5888,53,5,58,0,inf
5889,67,13,80,0,inf
5890,59,5,64,0,inf
5891,51,13,64,0,inf
5892,56,9,65,0,inf
5893,52,9,61,0,inf
5894,54,5,59,0,inf
5895,58,10,68,0,inf
5896,61,7,68,0,inf
5897,57,12,69,0,inf
5898,66,7,73,0,inf
5899,56,13,69,0,inf
5900,53,13,66,0,inf
5901,54,12,66,0,inf
5902,65,11,76,0,inf
5903,52,9,61,0,inf
5904,65,7,72,0,inf
5905,56,11,67,0,inf
5906,57,6,63,0,inf
5907,63,6,69,0,inf
5908,58,10,68,0,inf
5909,53,13,66,0,inf
5910,50,8,58,0,inf
5911,56,12,68,0,inf
5912,65,10,75,0,inf
5913,55,9,64,0,inf
5914,52,8,60,0,inf
5915,58,11,69,1,9.331138490927543
5916,63,12,75,0,inf
5917,54,7,61,0,inf
5918,66,8,74,0,inf
5919,59,7,66,0,inf
5920,64,6,70,0,inf
5921,52,5,57,0,inf
5922,50,12,62,0,inf
5923,64,8,72,0,inf
5924,57,9,66,0,inf
5925,60,5,65,0,inf
5926,58,5,63,0,inf
5927,54,11,65,0,inf
5928,54,10,64,0,inf
5929,50,10,60,0,inf
5930,56,5,61,0,inf
5931,62,8,70,0,inf
5932,57,9,66,0,inf
5933,63,11,74,0,inf
5934,51,6,57,0,inf
5935,56,7,63,0,inf
5936,56,5,61,0,inf
5937,53,11,64,1,9.911253933048442
5938,57,9,66,0,inf
5939,66,9,75,0,inf
5940,58,13,71,0,inf
5941,56,11,67,0,inf
5942,60,8,68,0,inf
5943,51,8,59,0,inf
5944,54,6,60,0,inf
5945,66,6,72,0,inf
5946,57,12,69,0,inf
5947,59,10,69,0,inf
5948,64,10,74,1,0.9980502880441691
5949,61,5,66,0,inf
5950,55,6,61,0,inf
5951,51,7,58,0,inf
5952,56,13,69,0,inf
5953,66,9,75,0,inf
5954,61,10,71,0,inf
5955,50,5,55,0,inf
5956,55,7,62,0,inf
5957,62,12,74,0,inf
5958,63,12,75,0,inf
5959,50,9,59,0,inf
5960,56,8,64,0,inf
5961,66,5,71,0,inf
5962,55,9,64,0,inf
5963,58,12,70,0,inf
5964,56,11,67,0,inf
5965,67,5,72,0,inf
5966,65,6,71,0,inf
5967,57,8,65,0,inf
5968,57,5,62,0,inf
5969,59,5,64,0,inf
5970,51,7,58,0,inf
5971,57,5,62,0,inf
5972,60,13,73,0,inf
5973,54,9,63,0,inf
5974,66,6,72,0,inf
5975,60,13,73,0,inf
5976,63,12,75,0,inf
5977,54,12,66,0,inf
5978,50,8,58,0,inf
5979,60,13,73,0,inf
5980,65,11,76,0,inf
5981,58,12,70,0,inf
5982,50,9,59,0,inf
5983,60,13,73,1,1.1744035335249379
5984,63,10,73,0,inf
5985,59,5,64,0,inf
5986,64,11,75,0,inf
5987,58,13,71,1,8.425112440103334
5988,58,11,69,0,inf
5989,56,8,64,0,inf
5990,55,8,63,0,inf
5991,56,9,65,0,inf
5992,62,5,67,0,inf
5993,62,7,69,0,inf
5994,63,10,73,0,inf
5995,64,6,70,0,inf
5996,55,13,68,0,inf
5997,56,7,63,0,inf
5998,51,12,63,0,inf
5999,56,7,63,0,inf
6000,62,10,72,0,inf
6001,52,6,58,0,inf
6002,59,5,64,0,inf
6003,56,7,63,0,inf
6004,54,9,63,0,inf
6005,57,13,70,0,inf
6006,64,11,75,0,inf
6007,59,11,70,0,inf
6008,60,13,73,0,inf
6009,64,8,72,0,inf
6010,53,6,59,0,inf
6011,50,7,57,0,inf
6012,64,9,73,0,inf
6013,52,10,62,0,inf
6014,56,5,61,0,inf
6015,51,11,62,0,inf
6016,52,7,59,0,inf
6017,66,9,75,0,inf
6018,61,7,68,0,inf
6019,57,5,62,0,inf
6020,54,10,64,0,inf
6021,56,12,68,0,inf
6022,65,6,71,0,inf
6023,60,11,71,0,inf
6024,59,10,69,0,inf
6025,55,9,64,0,inf
6026,51,10,61,0,inf
6027,52,12,64,0,inf
6028,58,5,63,0,inf
6029,55,9,64,0,inf
6030,61,8,69,0,inf
6031,64,9,73,0,inf
6032,66,9,75,0,inf
6033,54,7,61,0,inf
6034,59,11,70,0,inf
6035,62,8,70,0,inf
6036,67,12,79,0,inf
6037,53,7,60,0,inf
6038,50,7,57,0,inf
6039,53,13,66,0,inf
6040,56,11,67,0,inf
6041,50,9,59,0,inf
6042,54,7,61,0,inf
6043,66,7,73,0,inf
6044,62,7,69,0,inf
6045,55,12,67,0,inf
6046,64,5,69,0,inf
6047,58,8,66,0,inf
6048,53,8,61,0,inf
6049,61,10,71,0,inf
6050,63,6,69,0,inf
6051,50,9,59,0,inf
6052,56,5,61,0,inf
6053,66,11,77,0,inf
6054,64,12,76,0,inf
6055,55,5,60,0,inf
6056,63,13,76,0,inf
6057,50,6,56,0,inf
6058,60,13,73,0,inf
6059,53,6,59,0,inf
6060,54,9,63,0,inf
6061,60,9,69,0,inf
6062,63,5,68,0,inf
6063,67,6,73,0,inf
6064,51,12,63,0,inf
6065,63,10,73,0,inf
6066,67,9,76,0,inf
6067,66,11,77,0,inf
6068,62,13,75,1,9.913387913339335
6069,64,6,70,1,0.03850043389276436
6070,57,12,69,0,inf
6071,66,10,76,0,inf
6072,53,5,58,0,inf
6073,51,8,59,0,inf
6074,59,11,70,0,inf
6075,63,5,68,0,inf
6076,52,11,63,0,inf
6077,60,5,65,0,inf
6078,58,11,69,1,10.28398179884907
6079,52,9,61,0,inf
6080,51,6,57,0,inf
6081,56,12,68,0,inf
6082,67,9,76,0,inf
6083,50,13,63,0,inf
6084,55,8,63,0,inf
6085,63,12,75,0,inf
6086,66,8,74,0,inf
6087,51,12,63,0,inf
6088,50,7,57,0,inf
6089,50,13,63,0,inf
6090,50,11,61,0,inf
6091,51,7,58,0,inf
6092,56,9,65,0,inf
6093,67,11,78,0,inf
6094,62,6,68,0,inf
6095,52,8,60,0,inf
6096,61,11,72,0,inf
6097,57,11,68,0,inf
6098,66,5,71,0,inf
6099,64,10,74,0,inf
6100,64,10,74,0,inf
6101,65,13,78,0,inf
6102,53,13,66,0,inf
6103,66,12,78,0,inf
6104,50,13,63,0,inf
6105,63,13,76,0,inf
6106,52,11,63,0,inf
6107,53,6,59,0,inf
6108,51,13,64,0,inf
6109,64,6,70,0,inf
6110,53,7,60,0,inf
6111,54,9,63,0,inf
6112,56,6,62,0,inf
6113,65,9,74,1,6.926892973926158
6114,56,11,67,0,inf
6115,59,5,64,0,inf
6116,50,12,62,0,inf
6117,62,6,68,0,inf
6118,67,7,74,0,inf
6119,62,10,72,0,inf
6120,56,13,69,0,inf
6121,63,10,73,0,inf
6122,66,7,73,0,inf
6123,66,6,72,1,5.717403366378193
6124,58,6,64,0,inf
6125,63,13,76,0,inf
6126,64,5,69,0,inf
6127,50,12,62,0,inf
6128,64,8,72,0,inf
6129,58,8,66,0,inf
6130,57,9,66,0,inf
6131,64,12,76,0,inf
6132,51,10,61,0,inf
6133,54,8,62,0,inf
6134,63,12,75,0,inf
6135,66,10,76,0,inf
6136,54,12,66,0,inf
6137,67,5,72,0,inf
6138,62,8,70,0,inf
6139,56,12,68,0,inf
6140,60,7,67,0,inf
6141,60,9,69,0,inf
6142,61,6,67,0,inf
6143,51,6,57,0,inf
6144,62,8,70,0,inf
6145,57,7,64,0,inf
6146,63,11,74,0,inf
6147,65,6,71,0,inf
6148,65,5,70,0,inf
6149,59,13,72,0,inf
6150,52,7,59,0,inf
6151,50,7,57,0,inf
6152,59,13,72,0,inf
6153,65,10,75,0,inf
6154,57,12,69,0,inf
6155,66,11,77,0,inf
6156,63,11,74,0,inf
6157,65,12,77,0,inf
6158,54,5,59,0,inf
6159,63,12,75,0,inf
6160,64,7,71,0,inf
6161,65,11,76,0,inf
6162,66,10,76,0,inf
6163,64,12,76,0,inf
6164,51,6,57,0,inf
6165,66,12,78,0,inf
6166,52,7,59,0,inf
6167,53,11,64,0,inf
6168,62,5,67,0,inf
6169,54,11,65,0,inf
6170,51,11,62,0,inf
6171,54,5,59,0,inf
6172,50,8,58,0,inf
6173,59,8,67,0,inf
6174,52,12,64,0,inf
6175,60,13,73,0,inf
6176,54,8,62,0,inf
6177,51,10,61,0,inf
6178,59,7,66,0,inf
6179,67,8,75,0,inf
6180,51,8,59,1,4.59048898774526
6181,62,5,67,0,inf
6182,55,13,68,0,inf
6183,63,6,69,0,inf
6184,56,11,67,0,inf
6185,57,6,63,0,inf
6186,56,10,66,0,inf
6187,67,9,76,1,7.781876765897508
6188,56,8,64,0,inf
6189,51,12,63,0,inf
6190,63,13,76,0,inf
6191,65,13,78,0,inf
6192,59,9,68,1,4.059375734999705
6193,64,10,74,0,inf
6194,62,9,71,0,inf
6195,67,13,80,0,inf
6196,50,7,57,0,inf
6197,54,12,66,1,7.711557390707661
6198,59,13,72,0,inf
6199,67,11,78,0,inf
6200,54,11,65,0,inf
6201,59,7,66,0,inf
6202,50,11,61,0,inf
6203,51,8,59,0,inf
6204,57,5,62,0,inf
6205,52,13,65,0,inf
6206,55,10,65,0,inf
6207,61,11,72,1,3.6877233610633624
6208,52,5,57,0,inf
6209,63,8,71,0,inf
6210,54,8,62,0,inf
6211,67,8,75,0,inf
6212,64,5,69,0,inf
6213,58,8,66,0,inf
6214,67,7,74,0,inf
6215,66,8,74,0,inf
6216,61,5,66,0,inf
6217,51,10,61,0,inf
6218,67,5,72,0,inf
6219,50,6,56,0,inf
6220,52,11,63,0,inf
6221,62,6,68,0,inf
6222,55,5,60,0,inf
6223,65,7,72,0,inf
6224,56,13,69,0,inf
6225,65,10,75,0,inf
6226,67,10,77,0,inf
6227,51,5,56,0,inf
6228,56,13,69,0,inf
6229,56,12,68,0,inf
6230,53,9,62,0,inf
6231,56,5,61,0,inf
6232,59,7,66,0,inf
6233,66,9,75,0,inf
6234,57,8,65,0,inf
6235,59,6,65,0,inf
6236,58,7,65,0,inf
6237,56,7,63,0,inf
6238,61,12,73,0,inf
6239,58,10,68,0,inf
6240,51,5,56,0,inf
6241,60,13,73,0,inf
6242,62,11,73,0,inf
6243,59,11,70,0,inf
6244,63,12,75,0,inf
6245,61,6,67,0,inf
6246,58,12,70,0,inf
6247,50,9,59,0,inf
6248,65,7,72,0,inf
6249,62,12,74,0,inf
6250,59,6,65,0,inf
6251,64,9,73,0,inf
6252,50,11,61,0,inf
6253,62,6,68,0,inf
6254,59,5,64,0,inf
6255,64,6,70,0,inf
6256,62,6,68,0,inf
6257,52,9,61,0,inf
6258,57,12,69,0,inf
6259,63,7,70,0,inf
6260,53,11,64,0,inf
6261,58,5,63,0,inf
6262,63,6,69,0,inf
6263,55,9,64,0,inf
6264,54,6,60,0,inf
6265,55,10,65,0,inf
6266,54,13,67,0,inf
6267,66,8,74,0,inf
6268,50,7,57,0,inf
6269,51,8,59,0,inf
6270,55,6,61,0,inf
6271,63,11,74,0,inf
6272,52,7,59,0,inf
6273,60,11,71,0,inf
6274,64,7,71,0,inf
6275,51,13,64,0,inf
6276,58,9,67,0,inf
6277,58,7,65,0,inf
6278,52,12,64,0,inf
6279,53,13,66,1,1.3459519134076245
6280,62,7,69,0,inf
6281,57,6,63,0,inf
6282,50,7,57,0,inf
6283,58,6,64,0,inf
6284,53,10,63,0,inf
6285,50,6,56,0,inf
6286,54,12,66,0,inf
6287,67,6,73,0,inf
6288,54,11,65,0,inf
6289,51,10,61,0,inf
6290,60,8,68,0,inf
6291,60,7,67,0,inf
6292,55,12,67,0,inf
6293,64,13,77,1,0.35381509996643956
6294,53,10,63,0,inf
6295,54,10,64,0,inf
6296,56,11,67,0,inf
6297,65,6,71,0,inf
6298,64,7,71,0,inf
6299,55,9,64,0,inf
6300,63,13,76,0,inf
6301,61,7,68,0,inf
6302,59,11,70,0,inf
6303,63,11,74,0,inf
6304,52,10,62,0,inf
6305,57,12,69,0,inf
6306,56,12,68,0,inf
6307,57,11,68,0,inf
6308,66,11,77,0,inf
6309,63,8,71,0,inf
6310,67,5,72,0,inf
6311,55,13,68,0,inf
6312,59,11,70,0,inf
6313,50,6,56,0,inf
6314,50,11,61,0,inf
6315,52,7,59,0,inf
6316,53,9,62,0,inf
6317,58,9,67,0,inf
6318,59,13,72,0,inf
6319,57,6,63,0,inf
6320,54,11,65,0,inf
6321,58,5,63,0,inf
6322,54,8,62,0,inf
6323,66,11,77,0,inf
6324,62,6,68,0,inf
6325,62,13,75,0,inf
6326,55,12,67,0,inf
6327,64,11,75,0,inf
6328,63,7,70,0,inf
6329,55,13,68,0,inf
6330,65,10,75,0,inf
6331,66,6,72,0,inf
6332,50,11,61,0,inf
6333,65,9,74,0,inf
6334,61,7,68,0,inf
6335,61,9,70,0,inf
6336,52,10,62,0,inf
6337,57,12,69,0,inf
6338,55,12,67,0,inf
6339,61,10,71,0,inf
6340,66,8,74,0,inf
6341,65,10,75,1,7.4800089565344905
6342,59,11,70,0,inf
6343,56,13,69,0,inf
6344,66,6,72,0,inf
6345,54,11,65,0,inf
6346,54,10,64,0,inf
6347,58,13,71,0,inf
6348,65,9,74,0,inf
6349,52,7,59,0,inf
6350,55,7,62,0,inf
6351,60,7,67,0,inf
6352,57,11,68,0,inf
6353,54,11,65,0,inf
6354,53,5,58,0,inf
6355,64,13,77,0,inf
6356,50,12,62,0,inf
6357,66,10,76,0,inf
6358,51,10,61,0,inf
6359,55,10,65,0,inf
6360,56,12,68,0,inf
6361,51,8,59,0,inf
6362,57,13,70,0,inf
6363,53,5,58,0,inf
6364,60,11,71,0,inf
6365,58,11,69,0,inf
6366,65,7,72,1,2.809884011504849
6367,51,13,64,0,inf
6368,56,13,69,0,inf
6369,53,12,65,0,inf
6370,59,7,66,0,inf
6371,54,8,62,0,inf
6372,52,13,65,0,inf
6373,62,6,68,0,inf
6374,66,11,77,0,inf
6375,64,8,72,0,inf
6376,58,5,63,0,inf
6377,50,11,61,0,inf
6378,65,12,77,0,inf
6379,58,8,66,0,inf
6380,58,6,64,0,inf
6381,56,12,68,0,inf
6382,57,9,66,0,inf
6383,63,10,73,0,inf
6384,66,7,73,0,inf
6385,67,6,73,0,inf
6386,64,11,75,0,inf
6387,61,7,68,0,inf
6388,63,6,69,0,inf
6389,63,7,70,0,inf
6390,61,11,72,0,inf
6391,67,8,75,0,inf
6392,52,6,58,0,inf
6393,61,8,69,0,inf
6394,52,13,65,0,inf
6395,50,11,61,0,inf
6396,55,7,62,0,inf
6397,59,9,68,1,1.7036001621648325
6398,53,6,59,0,inf
6399,66,6,72,0,inf
6400,62,10,72,0,inf
6401,53,7,60,0,inf
6402,50,8,58,0,inf
6403,58,11,69,0,inf
6404,65,11,76,0,inf
6405,60,7,67,0,inf
6406,60,7,67,0,inf
6407,55,12,67,0,inf
6408,56,7,63,0,inf
6409,59,5,64,0,inf
6410,64,5,69,0,inf
6411,64,10,74,0,inf
6412,66,9,75,0,inf
6413,62,5,67,0,inf
6414,64,11,75,1,7.937638654454318
6415,60,9,69,0,inf
6416,51,12,63,0,inf
6417,50,13,63,0,inf
6418,67,10,77,0,inf
6419,50,13,63,0,inf
6420,62,10,72,0,inf
6421,54,7,61,0,inf
6422,52,13,65,0,inf
6423,64,8,72,0,inf
6424,60,6,66,0,inf
6425,52,13,65,0,inf
6426,51,9,60,0,inf
6427,65,5,70,0,inf
6428,57,8,65,0,inf
6429,52,5,57,0,inf
6430,55,11,66,0,inf
6431,55,12,67,0,inf
6432,58,5,63,0,inf
6433,55,6,61,0,inf
6434,61,12,73,0,inf
6435,61,11,72,0,inf
6436,54,5,59,0,inf
6437,57,10,67,0,inf
6438,61,6,67,0,inf
6439,67,12,79,0,inf
6440,62,5,67,0,inf
6441,66,9,75,0,inf
6442,58,10,68,0,inf
6443,60,12,72,0,inf
6444,56,12,68,0,inf
6445,51,6,57,0,inf
6446,66,8,74,0,inf
6447,50,9,59,0,inf
6448,64,10,74,0,inf
6449,50,10,60,0,inf
6450,58,13,71,0,inf
6451,53,9,62,0,inf
6452,64,7,71,0,inf
6453,53,7,60,0,inf
6454,65,8,73,0,inf
6455,57,11,68,0,inf
6456,56,11,67,0,inf
6457,51,5,56,0,inf
6458,63,12,75,0,inf
6459,53,7,60,0,inf
6460,67,8,75,0,inf
6461,56,13,69,0,inf
6462,59,7,66,0,inf
6463,62,13,75,0,inf
6464,60,6,66,0,inf
6465,63,9,72,0,inf
6466,65,13,78,0,inf
6467,67,5,72,0,inf
6468,55,5,60,0,inf
6469,61,11,72,0,inf
6470,62,13,75,0,inf
6471,55,6,61,0,inf
6472,66,12,78,0,inf
6473,65,6,71,0,inf
6474,55,8,63,0,inf
6475,50,13,63,1,2.874984207173547
6476,54,12,66,0,inf
6477,55,9,64,0,inf
6478,52,10,62,0,inf
6479,54,7,61,0,inf
6480,51,11,62,0,inf
6481,56,13,69,0,inf
6482,66,10,76,0,inf
6483,66,12,78,0,inf
6484,65,6,71,0,inf
6485,56,6,62,0,inf
6486,62,10,72,0,inf
6487,54,8,62,0,inf
6488,65,12,77,0,inf
6489,56,6,62,0,inf
6490,59,6,65,0,inf
6491,50,7,57,0,inf
6492,64,11,75,0,inf
6493,55,9,64,0,inf
6494,60,13,73,0,inf
6495,54,7,61,0,inf
6496,53,11,64,0,inf
6497,64,7,71,0,inf
6498,63,5,68,0,inf
6499,61,5,66,0,inf
6500,52,5,57,0,inf
6501,57,9,66,0,inf
6502,57,12,69,0,inf
6503,59,11,70,0,inf
6504,60,13,73,0,inf
6505,59,12,71,0,inf
6506,60,8,68,0,inf
6507,66,10,76,0,inf
6508,57,12,69,0,inf
6509,59,9,68,0,inf
6510,51,10,61,0,inf
6511,62,13,75,0,inf
6512,67,6,73,0,inf
6513,59,10,69,0,inf
6514,52,13,65,0,inf
6515,66,11,77,0,inf
6516,58,8,66,0,inf
6517,64,7,71,0,inf
6518,58,11,69,0,inf
6519,61,13,74,0,inf
6520,64,5,69,0,inf
6521,63,10,73,0,inf
6522,51,8,59,0,inf
6523,59,6,65,0,inf
6524,50,13,63,0,inf
6525,53,7,60,0,inf
6526,62,12,74,0,inf
6527,62,8,70,0,inf
6528,61,13,74,0,inf
6529,55,9,64,0,inf
6530,57,10,67,0,inf
6531,56,8,64,0,inf
6532,54,10,64,0,inf
6533,67,11,78,0,inf
6534,63,7,70,0,inf
6535,63,8,71,0,inf
6536,58,7,65,0,inf
6537,60,7,67,0,inf
6538,59,11,70,0,inf
6539,53,8,61,0,inf
6540,52,13,65,0,inf
6541,50,11,61,0,inf
6542,66,5,71,0,inf
6543,59,7,66,0,inf
6544,57,10,67,1,9.636560506009943
6545,64,12,76,0,inf
6546,52,6,58,0,inf
6547,50,9,59,0,inf
6548,57,13,70,0,inf
6549,58,9,67,0,inf
6550,62,8,70,0,inf
6551,59,5,64,0,inf
6552,63,12,75,0,inf
6553,63,7,70,1,5.240583587688917
6554,54,8,62,0,inf
6555,56,10,66,0,inf
6556,67,11,78,0,inf
6557,55,13,68,0,inf
6558,52,10,62,0,inf
6559,50,7,57,0,inf
6560,52,12,64,0,inf
6561,58,11,69,0,inf
6562,53,11,64,0,inf
6563,56,7,63,0,inf
6564,60,11,71,0,inf
6565,56,8,64,0,inf
6566,66,8,74,0,inf
6567,62,12,74,0,inf
6568,60,12,72,1,3.8610540263113577
6569,53,5,58,0,inf
6570,65,7,72,0,inf
6571,57,9,66,0,inf
6572,54,11,65,0,inf
6573,55,11,66,1,10.814289005206945
6574,52,5,57,0,inf
6575,60,9,69,0,inf
6576,65,8,73,0,inf
6577,62,8,70,0,inf
6578,63,13,76,0,inf
6579,63,5,68,0,inf
6580,56,10,66,0,inf
6581,63,12,75,1,2.6827900894073906
6582,67,8,75,0,inf
6583,51,6,57,0,inf
6584,57,10,67,0,inf
6585,67,13,80,0,inf
6586,59,5,64,0,inf
6587,59,11,70,0,inf
6588,56,13,69,0,inf
6589,55,11,66,0,inf
6590,64,7,71,0,inf
6591,63,5,68,0,inf
6592,57,13,70,0,inf
6593,53,12,65,0,inf
6594,65,7,72,0,inf
6595,61,12,73,0,inf
6596,62,9,71,0,inf
6597,58,12,70,0,inf
6598,52,6,58,0,inf
6599,56,12,68,0,inf
6600,51,13,64,0,inf
6601,54,12,66,1,11.659056495857214
6602,54,13,67,0,inf
6603,50,7,57,0,inf
6604,57,11,68,0,inf
6605,63,8,71,0,inf
6606,57,5,62,0,inf
6607,55,13,68,0,inf
6608,60,7,67,0,inf
6609,62,5,67,0,inf
6610,51,13,64,0,inf
6611,51,10,61,1,0.9590152637594116
6612,64,10,74,0,inf
6613,65,12,77,0,inf
6614,56,9,65,0,inf
6615,56,11,67,0,inf
6616,61,9,70,0,inf
6617,52,6,58,0,inf
6618,63,13,76,0,inf
6619,51,11,62,0,inf
6620,56,9,65,0,inf
6621,66,12,78,0,inf
6622,64,7,71,0,inf
6623,50,12,62,0,inf
6624,60,7,67,0,inf
6625,67,9,76,0,inf
6626,62,9,71,0,inf
6627,51,6,57,0,inf
6628,63,11,74,0,inf
6629,64,9,73,0,inf
6630,56,8,64,0,inf
6631,58,11,69,0,inf
6632,51,8,59,0,inf
6633,67,6,73,0,inf
6634,51,7,58,0,inf
6635,59,6,65,0,inf
6636,60,8,68,0,inf
6637,58,9,67,0,inf
6638,58,5,63,1,4.4725908993613785
6639,60,5,65,0,inf
6640,59,11,70,0,inf
6641,67,10,77,0,inf
6642,57,7,64,0,inf
6643,66,8,74,0,inf
6644,60,10,70,0,inf
6645,65,5,70,0,inf
6646,62,13,75,0,inf
6647,56,10,66,0,inf
6648,51,11,62,0,inf
6649,62,11,73,0,inf
6650,65,11,76,0,inf
6651,50,12,62,0,inf
6652,54,12,66,0,inf
6653,51,13,64,0,inf
6654,56,7,63,0,inf
6655,62,11,73,0,inf
6656,56,13,69,0,inf
6657,57,13,70,0,inf
6658,67,6,73,0,inf
6659,67,5,72,1,4.167066986152065
6660,55,9,64,0,inf
6661,52,6,58,0,inf
6662,51,12,63,0,inf
6663,66,7,73,0,inf
6664,64,12,76,0,inf
6665,66,10,76,0,inf
6666,63,7,70,0,inf
6667,53,6,59,0,inf
6668,63,8,71,0,inf
6669,55,6,61,0,inf
6670,55,9,64,0,inf
6671,59,13,72,0,inf
6672,52,12,64,1,9.816176026634942
6673,52,10,62,0,inf
6674,50,5,55,0,inf
6675,63,12,75,0,inf
6676,65,10,75,0,inf
6677,59,7,66,0,inf
6678,59,12,71,0,inf
6679,60,11,71,0,inf
6680,51,10,61,0,inf
6681,50,11,61,0,inf
6682,67,9,76,0,inf
6683,62,5,67,0,inf
6684,63,5,68,0,inf
6685,59,12,71,0,inf
6686,67,7,74,0,inf
6687,64,11,75,0,inf
6688,63,8,71,0,inf
6689,54,13,67,1,7.711603193623958
6690,54,9,63,0,inf
6691,58,11,69,0,inf
6692,56,11,67,0,inf
6693,50,8,58,0,inf
6694,67,10,77,0,inf
6695,61,6,67,0,inf
6696,66,9,75,0,inf
6697,59,6,65,0,inf
6698,63,10,73,0,inf
6699,57,13,70,0,inf
6700,67,13,80,0,inf
6701,58,11,69,0,inf
6702,53,10,63,0,inf
6703,57,12,69,0,inf
6704,65,7,72,0,inf
6705,64,8,72,0,inf
6706,53,11,64,0,inf
6707,66,8,74,0,inf
6708,61,11,72,0,inf
6709,50,10,60,0,inf
6710,62,6,68,0,inf
6711,50,8,58,0,inf
6712,66,10,76,0,inf
6713,67,6,73,0,inf
6714,60,7,67,0,inf
6715,66,10,76,0,inf
6716,54,7,61,0,inf
6717,52,5,57,0,inf
6718,62,12,74,0,inf
6719,60,8,68,0,inf
6720,65,7,72,0,inf
6721,59,7,66,0,inf
6722,50,6,56,0,inf
6723,65,11,76,0,inf
6724,60,13,73,0,inf
6725,53,8,61,0,inf
6726,60,6,66,0,inf
6727,54,7,61,0,inf
6728,56,9,65,0,inf
6729,65,7,72,0,inf
6730,60,9,69,0,inf
6731,54,10,64,0,inf
6732,56,7,63,0,inf
6733,62,6,68,0,inf
6734,53,12,65,0,inf
6735,61,6,67,0,inf
6736,65,12,77,0,inf
6737,60,10,70,0,inf
6738,60,6,66,0,inf
6739,63,12,75,0,inf
6740,62,10,72,0,inf
6741,51,9,60,0,inf
6742,60,8,68,0,inf
6743,61,8,69,0,inf
6744,62,6,68,1,4.445168159584753
6745,63,8,71,0,inf
6746,67,13,80,0,inf
6747,53,10,63,0,inf
6748,65,11,76,0,inf
6749,62,6,68,0,inf
6750,67,6,73,0,inf
6751,57,5,62,0,inf
6752,67,12,79,0,inf
6753,64,11,75,0,inf
6754,67,7,74,0,inf
6755,64,7,71,0,inf
6756,58,8,66,0,inf
6757,60,10,70,0,inf
6758,62,9,71,0,inf
6759,52,5,57,0,inf
6760,67,10,77,0,inf
6761,51,11,62,0,inf
6762,63,9,72,0,inf
6763,64,13,77,0,inf
6764,66,11,77,0,inf
6765,50,10,60,0,inf
6766,60,11,71,0,inf
6767,52,12,64,0,inf
6768,57,12,69,0,inf
6769,59,11,70,0,inf
6770,55,11,66,0,inf
6771,65,9,74,0,inf
6772,62,6,68,0,inf
6773,51,9,60,0,inf
6774,63,9,72,0,inf
6775,52,13,65,0,inf
6776,56,5,61,0,inf
6777,55,10,65,0,inf
6778,60,10,70,0,inf
6779,65,10,75,0,inf
6780,67,6,73,0,inf
6781,64,7,71,0,inf
6782,57,10,67,0,inf
6783,62,10,72,0,inf
6784,52,9,61,0,inf
6785,50,5,55,0,inf
6786,65,7,72,0,inf
6787,61,10,71,0,inf
6788,50,10,60,0,inf
6789,62,13,75,0,inf
6790,52,9,61,0,inf
6791,50,5,55,0,inf
6792,63,7,70,0,inf
6793,61,5,66,0,inf
6794,60,12,72,0,inf
6795,60,12,72,0,inf
6796,50,9,59,0,inf
6797,52,8,60,0,inf
6798,56,6,62,0,inf
6799,59,13,72,0,inf
6800,55,5,60,0,inf
6801,66,8,74,0,inf
6802,66,9,75,0,inf
6803,65,5,70,0,inf
6804,56,9,65,0,inf
6805,65,6,71,1,5.70368274524526
6806,57,11,68,0,inf
6807,63,8,71,0,inf
6808,67,8,75,0,inf
6809,56,9,65,0,inf
6810,61,9,70,0,inf
6811,51,7,58,0,inf
6812,65,8,73,0,inf
6813,63,9,72,0,inf
6814,61,8,69,0,inf
6815,57,10,67,0,inf
6816,58,13,71,0,inf
6817,65,9,74,0,inf
6818,54,5,59,0,inf
6819,50,12,62,0,inf
6820,56,10,66,0,inf
6821,58,11,69,0,inf
6822,66,12,78,0,inf
6823,55,9,64,0,inf
6824,51,5,56,0,inf
6825,57,6,63,0,inf
6826,51,12,63,0,inf
6827,67,7,74,0,inf
6828,53,11,64,0,inf
6829,54,5,59,0,inf
6830,54,6,60,0,inf
6831,56,13,69,0,inf
6832,63,5,68,0,inf
6833,58,6,64,0,inf
6834,55,7,62,0,inf
6835,65,6,71,0,inf
6836,51,6,57,0,inf
6837,65,8,73,0,inf
6838,59,12,71,0,inf
6839,59,12,71,0,inf
6840,62,9,71,0,inf
6841,66,9,75,0,inf
6842,61,10,71,0,inf
6843,55,6,61,0,inf
6844,56,10,66,0,inf
6845,66,6,72,0,inf
6846,66,12,78,0,inf
6847,54,8,62,0,inf
6848,65,12,77,0,inf
6849,56,8,64,0,inf
6850,59,11,70,0,inf
6851,51,11,62,0,inf
6852,60,13,73,0,inf
6853,59,5,64,0,inf
6854,53,10,63,0,inf
6855,64,8,72,0,inf
6856,65,6,71,0,inf
6857,50,6,56,0,inf
6858,62,6,68,0,inf
6859,61,5,66,0,inf
6860,54,7,61,0,inf
6861,67,10,77,0,inf
6862,67,7,74,0,inf
6863,63,10,73,0,inf
6864,62,9,71,0,inf
6865,57,8,65,0,inf
6866,66,12,78,0,inf
6867,53,5,58,0,inf
6868,62,6,68,0,inf
6869,61,5,66,0,inf
6870,64,11,75,0,inf
6871,59,5,64,0,inf
6872,50,11,61,0,inf
6873,53,12,65,0,inf
6874,66,6,72,0,inf
6875,55,12,67,0,inf
6876,67,12,79,0,inf
6877,57,9,66,0,inf
6878,57,10,67,0,inf
6879,50,11,61,0,inf
6880,54,10,64,0,inf
6881,65,11,76,0,inf
6882,55,10,65,1,8.888552854705843
6883,59,9,68,0,inf
6884,55,9,64,0,inf
6885,58,6,64,0,inf
6886,62,8,70,0,inf
6887,57,12,69,0,inf
6888,60,12,72,0,inf
6889,57,13,70,0,inf
6890,64,8,72,0,inf
6891,66,11,77,0,inf
6892,57,6,63,0,inf
6893,62,9,71,0,inf
6894,55,13,68,0,inf
6895,51,12,63,0,inf
6896,67,7,74,0,inf
6897,65,6,71,0,inf
6898,54,9,63,0,inf
6899,67,12,79,0,inf
6900,50,10,60,0,inf
6901,55,8,63,0,inf
6902,63,6,69,0,inf
6903,65,10,75,0,inf
6904,55,13,68,0,inf
6905,62,8,70,0,inf
6906,66,7,73,0,inf
6907,65,8,73,0,inf
6908,64,12,76,0,inf
6909,63,5,68,0,inf
6910,65,13,78,0,inf
6911,67,8,75,0,inf
6912,56,7,63,0,inf
6913,64,12,76,0,inf
6914,62,10,72,0,inf
6915,50,8,58,0,inf
6916,53,13,66,0,inf
6917,63,8,71,0,inf
6918,56,12,68,0,inf
6919,50,7,57,0,inf
6920,50,9,59,0,inf
6921,51,7,58,0,inf
6922,51,7,58,0,inf
6923,55,10,65,0,inf
6924,63,8,71,0,inf
6925,54,5,59,0,inf
6926,55,13,68,0,inf
6927,66,9,75,0,inf
6928,64,8,72,0,inf
6929,63,9,72,0,inf
6930,56,9,65,0,inf
6931,59,10,69,0,inf
6932,61,6,67,0,inf
6933,63,9,72,0,inf
6934,58,11,69,0,inf
6935,62,8,70,0,inf
6936,54,9,63,0,inf
6937,63,6,69,0,inf
6938,62,6,68,0,inf
6939,60,10,70,0,inf
6940,50,12,62,0,inf
6941,50,13,63,0,inf
6942,62,10,72,0,inf
6943,62,5,67,0,inf
6944,56,7,63,0,inf
6945,64,7,71,0,inf
6946,50,7,57,0,inf
6947,59,12,71,1,11.383677489413415
6948,67,11,78,0,inf
6949,54,6,60,0,inf
6950,50,6,56,0,inf
6951,67,13,80,0,inf
6952,62,7,69,0,inf
6953,60,11,71,0,inf
6954,53,8,61,0,inf
6955,63,12,75,0,inf
6956,63,13,76,0,inf
6957,54,13,67,0,inf
6958,58,9,67,0,inf
6959,63,11,74,0,inf
6960,58,10,68,0,inf
6961,59,11,70,0,inf
6962,52,10,62,0,inf
6963,57,6,63,0,inf
6964,61,12,73,0,inf
6965,59,9,68,0,inf
6966,52,9,61,0,inf
6967,63,11,74,0,inf
6968,50,9,59,0,inf
6969,54,13,67,0,inf
6970,51,12,63,0,inf
6971,62,13,75,0,inf
6972,52,10,62,0,inf
6973,53,6,59,0,inf
6974,67,12,79,0,inf
6975,51,7,58,0,inf
6976,52,6,58,0,inf
6977,56,5,61,0,inf
6978,52,9,61,0,inf
6979,58,10,68,0,inf
6980,63,13,76,0,inf
6981,51,8,59,0,inf
6982,63,10,73,0,inf
6983,60,9,69,0,inf
6984,53,5,58,0,inf
6985,62,11,73,0,inf
6986,52,10,62,0,inf
6987,61,13,74,0,inf
6988,58,8,66,0,inf
6989,51,10,61,0,inf
6990,65,11,76,0,inf
6991,66,11,77,0,inf
6992,56,11,67,0,inf
6993,63,12,75,0,inf
6994,55,11,66,0,inf
6995,54,13,67,0,inf
6996,63,5,68,0,inf
6997,63,8,71,0,inf
6998,51,6,57,0,inf
6999,54,5,59,0,inf
7000,50,9,59,0,inf
7001,67,11,78,0,inf
7002,58,9,67,0,inf
7003,64,10,74,0,inf
7004,52,6,58,0,inf
7005,54,12,66,0,inf
7006,51,12,63,0,inf
7007,62,7,69,0,inf
7008,60,11,71,0,inf
7009,50,13,63,0,inf
7010,60,10,70,0,inf
7011,61,9,70,0,inf
7012,53,6,59,0,inf
7013,50,8,58,0,inf
7014,62,11,73,0,inf
7015,64,9,73,0,inf
7016,50,5,55,0,inf
7017,55,7,62,0,inf
7018,58,5,63,0,inf
7019,56,6,62,0,inf
7020,55,10,65,0,inf
7021,65,8,73,0,inf
7022,59,5,64,1,4.124058340849338
7023,64,13,77,0,inf
7024,55,11,66,0,inf
7025,52,6,58,0,inf
7026,52,8,60,0,inf
7027,66,11,77,0,inf
7028,66,12,78,0,inf
7029,66,9,75,0,inf
7030,62,5,67,0,inf
7031,54,6,60,0,inf
7032,54,8,62,0,inf
7033,51,9,60,0,inf
7034,50,13,63,0,inf
7035,61,8,69,0,inf
7036,64,10,74,0,inf
7037,55,5,60,0,inf
7038,53,9,62,0,inf
7039,53,10,63,0,inf
7040,62,9,71,0,inf
7041,60,8,68,0,inf
7042,63,8,71,0,inf
7043,59,9,68,1,5.361232785859926
7044,62,8,70,0,inf
7045,55,13,68,0,inf
7046,61,9,70,0,inf
7047,59,7,66,0,inf
7048,57,5,62,0,inf
7049,51,10,61,0,inf
7050,63,5,68,0,inf
7051,63,7,70,0,inf
7052,59,11,70,0,inf
7053,63,9,72,0,inf
7054,61,11,72,1,0.4477991234463943
7055,65,7,72,0,inf
7056,63,8,71,0,inf
7057,52,10,62,0,inf
7058,67,9,76,0,inf
7059,54,8,62,0,inf
7060,62,5,67,0,inf
7061,57,12,69,0,inf
7062,64,12,76,0,inf
7063,56,12,68,0,inf
7064,51,6,57,0,inf
7065,55,13,68,0,inf
7066,57,10,67,0,inf
7067,54,10,64,0,inf
7068,61,11,72,0,inf
7069,50,10,60,0,inf
7070,52,9,61,0,inf
7071,53,13,66,0,inf
7072,59,5,64,0,inf
7073,65,12,77,0,inf
7074,53,10,63,0,inf
7075,57,13,70,0,inf
7076,51,5,56,0,inf
7077,59,12,71,0,inf
7078,51,7,58,0,inf
7079,65,9,74,0,inf
7080,53,7,60,0,inf
7081,57,9,66,0,inf
7082,64,11,75,0,inf
7083,60,9,69,0,inf
7084,61,7,68,0,inf
7085,61,10,71,0,inf
7086,55,11,66,0,inf
7087,52,12,64,0,inf
7088,64,5,69,0,inf
7089,59,11,70,0,inf
7090,67,7,74,0,inf
7091,55,6,61,0,inf
7092,62,7,69,0,inf
7093,67,5,72,0,inf
7094,54,8,62,0,inf
7095,59,9,68,0,inf
7096,60,11,71,0,inf
7097,66,8,74,0,inf
7098,50,5,55,0,inf
7099,61,10,71,0,inf
7100,58,7,65,0,inf
7101,61,5,66,0,inf
7102,64,11,75,0,inf
7103,62,8,70,0,inf
7104,62,5,67,0,inf
7105,55,10,65,0,inf
7106,54,8,62,0,inf
7107,64,10,74,0,inf
7108,55,9,64,0,inf
7109,67,8,75,0,inf
7110,56,11,67,0,inf
7111,56,11,67,0,inf
7112,50,13,63,0,inf
7113,59,8,67,0,inf
7114,57,5,62,0,inf
7115,51,5,56,0,inf
7116,52,10,62,0,inf
7117,65,5,70,0,inf
7118,55,11,66,0,inf
7119,57,8,65,0,inf
7120,64,8,72,0,inf
7121,53,7,60,1,2.7992319325799997
7122,50,6,56,0,inf
7123,60,10,70,0,inf
7124,54,5,59,0,inf
7125,66,13,79,0,inf
7126,65,12,77,0,inf
7127,63,12,75,0,inf
7128,66,9,75,0,inf
7129,60,11,71,0,inf
7130,50,13,63,0,inf
7131,58,12,70,0,inf
7132,61,5,66,0,inf
7133,56,7,63,0,inf
7134,64,11,75,0,inf
7135,64,7,71,0,inf
7136,60,8,68,0,inf
7137,53,12,65,0,inf
7138,57,8,65,0,inf
7139,65,5,70,0,inf
7140,56,12,68,0,inf
7141,57,9,66,0,inf
7142,54,8,62,0,inf
7143,52,11,63,0,inf
7144,59,10,69,0,inf
7145,60,12,72,0,inf
7146,52,6,58,0,inf
7147,57,7,64,0,inf
7148,57,9,66,0,inf
7149,65,12,77,0,inf
7150,59,13,72,0,inf
7151,62,5,67,0,inf
7152,50,10,60,0,inf
7153,66,13,79,0,inf
7154,56,11,67,0,inf
7155,57,5,62,0,inf
7156,52,12,64,0,inf
7157,62,8,70,0,inf
7158,55,13,68,0,inf
7159,65,7,72,0,inf
7160,66,6,72,0,inf
7161,66,12,78,0,inf
7162,60,9,69,0,inf
7163,57,13,70,0,inf
7164,62,13,75,0,inf
7165,54,10,64,0,inf
7166,54,9,63,0,inf
7167,50,12,62,0,inf
7168,53,11,64,0,inf
7169,54,13,67,0,inf
7170,54,6,60,0,inf
7171,51,12,63,0,inf
7172,58,8,66,0,inf
7173,62,9,71,0,inf
7174,50,11,61,0,inf
7175,65,5,70,0,inf
7176,55,10,65,0,inf
7177,53,10,63,0,inf
7178,61,10,71,0,inf
7179,61,5,66,0,inf
7180,60,9,69,0,inf
7181,67,11,78,0,inf
7182,62,7,69,0,inf
7183,51,10,61,0,inf
7184,61,13,74,0,inf
7185,65,8,73,0,inf
7186,50,10,60,0,inf
7187,62,8,70,0,inf
7188,67,10,77,1,7.544786048000731
7189,59,5,64,1,0.24642913874298245
7190,60,7,67,0,inf
7191,67,8,75,0,inf
7192,52,12,64,0,inf
7193,66,11,77,0,inf
7194,60,6,66,0,inf
7195,57,8,65,1,6.480290140388057
7196,61,5,66,0,inf
7197,66,10,76,0,inf
7198,62,5,67,0,inf
7199,62,7,69,0,inf
7200,57,8,65,0,inf
7201,62,8,70,0,inf
7202,57,11,68,0,inf
7203,51,10,61,0,inf
7204,55,9,64,0,inf
7205,61,13,74,0,inf
7206,62,11,73,0,inf
7207,67,11,78,0,inf
7208,53,10,63,0,inf
7209,54,8,62,0,inf
7210,62,13,75,0,inf
7211,55,6,61,0,inf
7212,58,7,65,0,inf
7213,52,10,62,0,inf
7214,50,9,59,0,inf
7215,52,9,61,0,inf
7216,59,11,70,0,inf
7217,64,6,70,0,inf
7218,63,6,69,0,inf
7219,50,13,63,0,inf
7220,61,6,67,0,inf
7221,56,6,62,0,inf
7222,50,13,63,0,inf
7223,63,13,76,0,inf
7224,55,12,67,0,inf
7225,65,5,70,1,0.2662085654471156
7226,58,11,69,0,inf
7227,66,5,71,0,inf
7228,66,6,72,0,inf
7229,56,12,68,0,inf
7230,62,5,67,0,inf
7231,65,12,77,0,inf
7232,64,11,75,0,inf
7233,52,13,65,0,inf
7234,53,12,65,0,inf
7235,55,6,61,0,inf
7236,65,13,78,0,inf
7237,66,6,72,0,inf
7238,52,11,63,0,inf
7239,52,12,64,0,inf
7240,55,8,63,0,inf
7241,56,13,69,0,inf
7242,61,10,71,0,inf
7243,54,10,64,0,inf
7244,56,10,66,0,inf
7245,62,13,75,0,inf
7246,51,9,60,0,inf
7247,62,13,75,0,inf
7248,60,10,70,0,inf
7249,56,5,61,0,inf
7250,57,11,68,0,inf
7251,51,8,59,0,inf
7252,63,8,71,0,inf
7253,58,7,65,0,inf
7254,60,10,70,0,inf
7255,55,9,64,0,inf
7256,51,13,64,0,inf
7257,64,10,74,0,inf
7258,65,12,77,0,inf
7259,59,10,69,0,inf
7260,57,6,63,0,inf
7261,64,9,73,0,inf
7262,51,13,64,0,inf
7263,64,7,71,0,inf
7264,67,8,75,0,inf
7265,60,6,66,0,inf
7266,61,8,69,1,0.09084224339306957
7267,51,5,56,0,inf
7268,53,6,59,0,inf
7269,67,5,72,0,inf
7270,59,8,67,0,inf
7271,53,10,63,0,inf
7272,51,10,61,0,inf
7273,65,11,76,0,inf
7274,54,12,66,0,inf
7275,56,13,69,0,inf
7276,53,6,59,0,inf
7277,52,9,61,0,inf
7278,60,11,71,0,inf
7279,52,6,58,0,inf
7280,59,7,66,0,inf
7281,66,7,73,0,inf
7282,60,6,66,0,inf
7283,62,10,72,0,inf
7284,60,13,73,0,inf
7285,63,5,68,0,inf
7286,53,7,60,0,inf
7287,62,10,72,0,inf
7288,58,6,64,0,inf
7289,66,7,73,0,inf
7290,60,7,67,0,inf
7291,59,11,70,0,inf
7292,54,10,64,0,inf
7293,66,6,72,0,inf
7294,64,6,70,0,inf
7295,57,11,68,0,inf
7296,60,9,69,0,inf
7297,52,7,59,0,inf
7298,66,6,72,0,inf
7299,62,5,67,0,inf
7300,59,8,67,0,inf
7301,54,11,65,0,inf
7302,55,13,68,0,inf
7303,54,12,66,0,inf
7304,56,11,67,0,inf
7305,55,9,64,0,inf
7306,55,5,60,0,inf
7307,50,13,63,0,inf
7308,64,5,69,0,inf
7309,52,10,62,0,inf
7310,58,12,70,0,inf
7311,67,12,79,0,inf
7312,50,11,61,0,inf
7313,52,6,58,0,inf
7314,67,11,78,0,inf
7315,52,10,62,0,inf
7316,53,6,59,0,inf
7317,52,10,62,0,inf
7318,51,10,61,0,inf
7319,53,7,60,0,inf
7320,65,5,70,0,inf
7321,60,7,67,0,inf
7322,50,12,62,0,inf
7323,64,11,75,0,inf
7324,65,11,76,1,0.07870191071361887
7325,63,10,73,0,inf
7326,67,5,72,0,inf
7327,52,5,57,0,inf
7328,52,9,61,0,inf
7329,59,6,65,0,inf
7330,55,11,66,1,8.828049078901174
7331,57,11,68,0,inf
7332,56,9,65,0,inf
7333,58,6,64,0,inf
7334,62,9,71,0,inf
7335,61,12,73,0,inf
7336,54,10,64,0,inf
7337,56,13,69,0,inf
7338,53,12,65,0,inf
7339,52,13,65,0,inf
7340,50,12,62,0,inf
7341,64,11,75,0,inf
7342,61,5,66,0,inf
7343,51,6,57,0,inf
7344,64,7,71,0,inf
7345,59,13,72,0,inf
7346,60,9,69,0,inf
7347,57,9,66,1,0.042056440699923314
7348,66,13,79,0,inf
7349,51,11,62,0,inf
7350,60,9,69,0,inf
7351,50,11,61,0,inf
7352,61,5,66,0,inf
7353,62,13,75,0,inf
7354,67,8,75,0,inf
7355,59,11,70,0,inf
7356,62,11,73,0,inf
7357,62,9,71,0,inf
7358,64,9,73,0,inf
7359,56,9,65,0,inf
7360,51,11,62,0,inf
7361,56,12,68,0,inf
7362,57,10,67,0,inf
7363,64,6,70,0,inf
7364,62,8,70,0,inf
7365,58,11,69,0,inf
7366,55,5,60,0,inf
7367,61,13,74,0,inf
7368,64,5,69,0,inf
7369,53,6,59,0,inf
7370,51,6,57,0,inf
7371,57,12,69,0,inf
7372,54,10,64,0,inf
7373,60,5,65,0,inf
7374,67,11,78,0,inf
7375,65,9,74,0,inf
7376,56,8,64,0,inf
7377,63,13,76,0,inf
7378,54,7,61,0,inf
7379,66,10,76,0,inf
7380,54,13,67,0,inf
7381,61,5,66,0,inf
7382,58,8,66,0,inf
7383,59,7,66,0,inf
7384,52,5,57,0,inf
7385,60,12,72,0,inf
7386,66,5,71,0,inf
7387,50,11,61,0,inf
7388,59,9,68,1,7.593189301044973
7389,54,8,62,0,inf
7390,53,9,62,0,inf
7391,61,11,72,0,inf
7392,61,12,73,0,inf
7393,64,6,70,0,inf
7394,64,13,77,0,inf
7395,60,8,68,0,inf
7396,59,12,71,0,inf
7397,59,9,68,0,inf
7398,59,9,68,0,inf
7399,60,12,72,1,11.581101300584521
7400,55,6,61,0,inf
7401,59,5,64,0,inf
7402,50,10,60,0,inf
7403,63,6,69,0,inf
7404,53,10,63,0,inf
7405,60,6,66,0,inf
7406,62,5,67,0,inf
7407,52,13,65,0,inf
7408,63,6,69,0,inf
7409,60,10,70,0,inf
7410,65,12,77,0,inf
7411,57,13,70,0,inf
7412,50,8,58,0,inf
7413,67,11,78,0,inf
7414,65,13,78,0,inf
7415,53,8,61,0,inf
7416,64,8,72,0,inf
7417,56,11,67,0,inf
7418,53,5,58,0,inf
7419,67,5,72,0,inf
7420,62,9,71,0,inf
7421,65,5,70,0,inf
7422,66,12,78,0,inf
7423,62,10,72,0,inf
7424,59,11,70,0,inf
7425,62,11,73,0,inf
7426,52,9,61,0,inf
7427,52,5,57,0,inf
7428,51,12,63,0,inf
7429,63,8,71,0,inf
7430,59,5,64,0,inf
7431,63,5,68,0,inf
7432,52,9,61,0,inf
7433,58,5,63,0,inf
7434,56,7,63,0,inf
7435,61,13,74,0,inf
7436,63,9,72,0,inf
7437,51,7,58,0,inf
7438,63,6,69,0,inf
7439,51,10,61,0,inf
7440,60,13,73,0,inf
7441,54,7,61,0,inf
7442,57,12,69,1,11.063257868717812
7443,65,11,76,0,inf
7444,54,9,63,0,inf
7445,50,8,58,0,inf
7446,58,5,63,0,inf
7447,53,5,58,0,inf
7448,51,9,60,0,inf
7449,56,13,69,0,inf
7450,67,8,75,0,inf
7451,58,5,63,0,inf
7452,63,12,75,0,inf
7453,66,5,71,0,inf
7454,51,7,58,0,inf
7455,50,11,61,0,inf
7456,52,5,57,0,inf
7457,59,10,69,0,inf
7458,55,10,65,0,inf
7459,57,9,66,0,inf
7460,58,11,69,0,inf
7461,52,11,63,0,inf
7462,55,7,62,0,inf
7463,54,7,61,0,inf
7464,53,9,62,0,inf
7465,54,12,66,0,inf
7466,60,12,72,0,inf
7467,57,13,70,0,inf
7468,67,10,77,0,inf
7469,61,8,69,0,inf
7470,51,7,58,0,inf
7471,58,5,63,0,inf
7472,65,10,75,0,inf
7473,64,11,75,0,inf
7474,62,8,70,0,inf
7475,56,6,62,0,inf
7476,61,13,74,0,inf
7477,66,7,73,0,inf
7478,66,11,77,0,inf
7479,54,7,61,0,inf
7480,63,5,68,0,inf
7481,66,12,78,0,inf
7482,52,10,62,0,inf
7483,60,10,70,0,inf
7484,63,5,68,0,inf
7485,60,9,69,0,inf
7486,50,6,56,0,inf
7487,53,11,64,0,inf
7488,67,12,79,0,inf
7489,66,12,78,0,inf
7490,51,7,58,0,inf
7491,56,13,69,0,inf
7492,57,11,68,0,inf
7493,62,12,74,0,inf
7494,63,12,75,0,inf
7495,61,5,66,0,inf
7496,55,12,67,0,inf
7497,54,11,65,0,inf
7498,65,12,77,0,inf
7499,64,10,74,0,inf
7500,50,9,59,0,inf
7501,61,7,68,0,inf
7502,52,7,59,0,inf
7503,61,6,67,0,inf
7504,50,8,58,0,inf
7505,51,11,62,0,inf
7506,58,8,66,0,inf
7507,59,12,71,1,5.183900973331333
7508,52,13,65,0,inf
7509,60,9,69,0,inf
7510,65,7,72,0,inf
7511,53,8,61,0,inf
7512,56,12,68,0,inf
7513,65,13,78,0,inf
7514,62,5,67,0,inf
7515,53,7,60,0,inf
7516,63,8,71,0,inf
7517,52,9,61,0,inf
7518,56,8,64,0,inf
7519,66,5,71,0,inf
7520,52,5,57,0,inf
7521,56,5,61,0,inf
7522,54,11,65,0,inf
7523,58,11,69,0,inf
7524,63,11,74,0,inf
7525,59,6,65,0,inf
7526,61,10,71,0,inf
7527,55,13,68,0,inf
7528,51,7,58,0,inf
7529,51,9,60,0,inf
7530,67,13,80,0,inf
7531,54,10,64,0,inf
7532,56,11,67,0,inf
7533,57,7,64,0,inf
7534,56,5,61,0,inf
7535,58,6,64,0,inf
7536,50,8,58,0,inf
7537,54,5,59,0,inf
7538,63,13,76,0,inf
7539,63,6,69,0,inf
7540,58,12,70,0,inf
7541,62,5,67,0,inf
7542,51,6,57,0,inf
7543,52,5,57,0,inf
7544,51,10,61,0,inf
7545,58,12,70,0,inf
7546,51,7,58,0,inf
7547,51,8,59,0,inf
7548,66,9,75,0,inf
7549,59,8,67,0,inf
7550,67,13,80,0,inf
7551,53,12,65,0,inf
7552,66,9,75,0,inf
7553,60,6,66,0,inf
7554,50,13,63,0,inf
7555,54,13,67,0,inf
7556,61,6,67,0,inf
7557,64,7,71,0,inf
7558,60,13,73,0,inf
7559,53,13,66,0,inf
7560,57,9,66,0,inf
7561,53,9,62,0,inf
7562,50,5,55,0,inf
7563,60,5,65,0,inf
7564,60,8,68,0,inf
7565,66,12,78,0,inf
7566,61,5,66,0,inf
7567,62,11,73,0,inf
7568,64,5,69,0,inf
7569,67,9,76,0,inf
7570,62,7,69,0,inf
7571,50,7,57,0,inf
7572,52,11,63,0,inf
7573,58,6,64,0,inf
7574,62,7,69,0,inf
7575,58,8,66,0,inf
7576,58,6,64,0,inf
7577,57,13,70,0,inf
7578,52,13,65,0,inf
7579,61,6,67,0,inf
7580,62,12,74,0,inf
7581,53,6,59,0,inf
7582,51,8,59,0,inf
7583,65,9,74,0,inf
7584,60,7,67,0,inf
7585,53,13,66,0,inf
7586,54,9,63,0,inf
7587,60,10,70,1,6.028839208836914
7588,65,9,74,0,inf
7589,53,13,66,0,inf
7590,62,5,67,0,inf
7591,66,5,71,0,inf
7592,56,5,61,0,inf
7593,60,7,67,0,inf
7594,53,11,64,1,10.399270157812786
7595,59,9,68,0,inf
7596,54,11,65,0,inf
7597,63,10,73,0,inf
7598,67,13,80,0,inf
7599,62,5,67,0,inf
7600,66,6,72,0,inf
7601,55,10,65,0,inf
7602,66,9,75,0,inf
7603,55,13,68,0,inf
7604,56,12,68,0,inf
7605,50,11,61,0,inf
7606,54,11,65,0,inf
7607,60,7,67,0,inf
7608,55,5,60,0,inf
7609,55,8,63,0,inf
7610,63,8,71,0,inf
7611,55,9,64,0,inf
7612,67,13,80,0,inf
7613,61,7,68,0,inf
7614,55,5,60,0,inf
7615,57,12,69,0,inf
7616,58,11,69,0,inf
7617,67,9,76,0,inf
7618,60,11,71,0,inf
7619,50,12,62,0,inf
7620,62,9,71,0,inf
7621,60,13,73,0,inf
7622,61,13,74,0,inf
7623,67,7,74,0,inf
7624,62,11,73,0,inf
7625,50,12,62,0,inf
7626,54,11,65,0,inf
7627,63,11,74,0,inf
7628,56,7,63,0,inf
7629,61,8,69,0,inf
7630,53,8,61,0,inf
7631,58,11,69,0,inf
7632,53,10,63,0,inf
7633,55,5,60,0,inf
7634,63,6,69,0,inf
7635,50,9,59,0,inf
7636,61,7,68,0,inf
7637,64,5,69,0,inf
7638,67,11,78,0,inf
7639,66,12,78,0,inf
7640,63,10,73,0,inf
7641,54,6,60,0,inf
7642,55,11,66,0,inf
7643,51,5,56,0,inf
7644,62,12,74,0,inf
7645,65,12,77,1,10.856608764581807
7646,56,8,64,0,inf
7647,62,10,72,0,inf
7648,64,11,75,0,inf
7649,56,11,67,0,inf
7650,58,9,67,0,inf
7651,65,12,77,0,inf
7652,50,8,58,0,inf
7653,57,8,65,0,inf
7654,62,10,72,0,inf
7655,52,8,60,0,inf
7656,66,11,77,0,inf
7657,50,5,55,0,inf
7658,50,11,61,0,inf
7659,62,9,71,0,inf
7660,51,7,58,0,inf
7661,60,7,67,0,inf
7662,50,12,62,0,inf
7663,63,9,72,0,inf
7664,61,8,69,0,inf
7665,64,12,76,0,inf
7666,59,5,64,0,inf
7667,55,8,63,0,inf
7668,51,12,63,0,inf
7669,54,7,61,0,inf
7670,57,13,70,0,inf
7671,66,10,76,0,inf
7672,53,12,65,0,inf
7673,66,6,72,0,inf
7674,65,10,75,0,inf
7675,56,11,67,0,inf
7676,50,12,62,0,inf
7677,53,13,66,0,inf
7678,52,9,61,0,inf
7679,55,8,63,0,inf
7680,56,7,63,0,inf
7681,51,7,58,0,inf
7682,65,7,72,0,inf
7683,55,9,64,0,inf
7684,52,7,59,0,inf
7685,66,13,79,0,inf
7686,62,12,74,0,inf
7687,50,6,56,0,inf
7688,59,10,69,1,4.179732885709285
7689,54,13,67,0,inf
7690,52,13,65,0,inf
7691,63,5,68,0,inf
7692,55,6,61,0,inf
7693,67,6,73,0,inf
7694,57,9,66,0,inf
7695,67,10,77,0,inf
7696,50,5,55,0,inf
7697,63,7,70,0,inf
7698,51,9,60,0,inf
7699,58,9,67,0,inf
7700,57,5,62,0,inf
7701,62,10,72,0,inf
7702,56,11,67,0,inf
7703,53,6,59,0,inf
7704,64,10,74,0,inf
7705,67,10,77,0,inf
7706,52,8,60,0,inf
7707,62,9,71,0,inf
7708,60,6,66,0,inf
7709,61,6,67,0,inf
7710,56,13,69,0,inf
7711,52,9,61,0,inf
7712,67,10,77,0,inf
7713,60,6,66,0,inf
7714,63,13,76,0,inf
7715,59,11,70,0,inf
7716,62,10,72,0,inf
7717,58,6,64,0,inf
7718,50,13,63,0,inf
7719,50,7,57,0,inf
7720,61,13,74,1,6.532233693663969
7721,61,7,68,0,inf
7722,53,13,66,0,inf
7723,60,6,66,0,inf
7724,56,7,63,0,inf
7725,60,10,70,0,inf
7726,54,12,66,0,inf
7727,65,12,77,0,inf
7728,52,8,60,0,inf
7729,65,11,76,0,inf
7730,54,11,65,0,inf
7731,51,10,61,0,inf
7732,51,8,59,1,2.269082592577476
7733,51,12,63,1,11.347952573761638
7734,51,10,61,0,inf
7735,51,7,58,0,inf
7736,56,9,65,0,inf
7737,61,5,66,0,inf
7738,62,11,73,0,inf
7739,66,8,74,0,inf
7740,63,11,74,0,inf
7741,67,6,73,0,inf
7742,61,5,66,0,inf
7743,53,7,60,0,inf
7744,54,9,63,1,1.8526834401450785
7745,54,7,61,0,inf
7746,62,9,71,0,inf
7747,55,5,60,0,inf
7748,51,7,58,0,inf
7749,54,5,59,0,inf
7750,55,9,64,0,inf
7751,54,5,59,0,inf
7752,57,9,66,0,inf
7753,66,6,72,0,inf
7754,54,6,60,0,inf
7755,67,8,75,0,inf
7756,60,5,65,0,inf
7757,58,5,63,0,inf
7758,54,10,64,0,inf
7759,60,6,66,0,inf
7760,65,5,70,0,inf
7761,50,13,63,0,inf
7762,54,7,61,0,inf
7763,58,13,71,1,1.068620121779567
7764,63,12,75,0,inf
7765,65,5,70,0,inf
7766,55,13,68,0,inf
7767,50,13,63,0,inf
7768,64,10,74,0,inf
7769,67,7,74,0,inf
7770,63,5,68,0,inf
7771,61,5,66,0,inf
7772,61,12,73,0,inf
7773,51,8,59,0,inf
7774,55,6,61,0,inf
7775,58,7,65,0,inf
7776,57,12,69,0,inf
7777,50,9,59,0,inf
7778,62,10,72,0,inf
7779,60,11,71,0,inf
7780,51,9,60,0,inf
7781,63,11,74,0,inf
7782,62,6,68,0,inf
7783,57,11,68,0,inf
7784,50,11,61,0,inf
7785,61,12,73,0,inf
7786,58,13,71,0,inf
7787,58,10,68,0,inf
7788,61,6,67,0,inf
7789,51,5,56,0,inf
7790,67,9,76,0,inf
7791,51,10,61,0,inf
7792,61,6,67,0,inf
7793,51,10,61,1,0.6621487936103705
7794,54,12,66,0,inf
7795,66,9,75,0,inf
7796,59,6,65,0,inf
7797,65,13,78,0,inf
7798,67,7,74,0,inf
7799,59,10,69,0,inf
7800,67,6,73,0,inf
7801,54,5,59,0,inf
7802,57,11,68,0,inf
7803,62,5,67,0,inf
7804,54,6,60,0,inf
7805,64,10,74,0,inf
7806,58,11,69,0,inf
7807,63,12,75,0,inf
7808,58,6,64,0,inf
7809,61,9,70,0,inf
7810,65,6,71,0,inf
7811,55,7,62,0,inf
7812,60,6,66,0,inf
7813,59,10,69,0,inf
7814,65,13,78,0,inf
7815,62,11,73,0,inf
7816,60,6,66,0,inf
7817,50,9,59,0,inf
7818,67,5,72,0,inf
7819,63,7,70,0,inf
7820,58,10,68,0,inf
7821,54,6,60,0,inf
7822,56,6,62,0,inf
7823,56,11,67,0,inf
7824,57,13,70,0,inf
7825,51,7,58,0,inf
7826,59,10,69,0,inf
7827,54,5,59,1,3.9179241475344284
7828,53,8,61,0,inf
7829,52,7,59,0,inf
7830,64,5,69,0,inf
7831,55,11,66,0,inf
7832,67,8,75,1,7.67390467197022
7833,62,7,69,0,inf
7834,67,12,79,0,inf
7835,51,6,57,0,inf
7836,67,5,72,0,inf
7837,63,7,70,0,inf
7838,51,13,64,0,inf
7839,65,11,76,0,inf
7840,67,13,80,0,inf
7841,63,5,68,0,inf
7842,59,8,67,0,inf
7843,54,10,64,0,inf
7844,52,8,60,0,inf
7845,52,11,63,0,inf
7846,57,8,65,0,inf
7847,55,11,66,0,inf
7848,50,7,57,0,inf
7849,57,6,63,0,inf
7850,55,9,64,0,inf
7851,51,9,60,0,inf
7852,57,13,70,0,inf
7853,63,12,75,0,inf
7854,62,13,75,0,inf
7855,56,8,64,0,inf
7856,52,10,62,0,inf
7857,58,6,64,0,inf
7858,62,7,69,0,inf
7859,53,10,63,0,inf
7860,63,13,76,0,inf
7861,50,7,57,0,inf
7862,56,12,68,1,7.816244556920374
7863,67,9,76,0,inf
7864,62,6,68,0,inf
7865,64,5,69,0,inf
7866,60,12,72,0,inf
7867,65,6,71,0,inf
7868,57,8,65,0,inf
7869,52,8,60,0,inf
7870,65,10,75,0,inf
7871,62,9,71,0,inf
7872,64,5,69,0,inf
7873,54,6,60,0,inf
7874,57,7,64,0,inf
7875,51,7,58,0,inf
7876,56,7,63,0,inf
7877,67,7,74,0,inf
7878,50,7,57,0,inf
7879,63,5,68,0,inf
7880,63,13,76,0,inf
7881,67,7,74,0,inf
7882,60,10,70,1,6.358866346199548
7883,61,13,74,0,inf
7884,66,5,71,0,inf
7885,52,8,60,0,inf
7886,64,9,73,0,inf
7887,56,7,63,0,inf
7888,66,6,72,0,inf
7889,57,11,68,0,inf
7890,50,6,56,0,inf
7891,63,7,70,0,inf
7892,58,9,67,0,inf
7893,62,9,71,0,inf
7894,63,13,76,0,inf
7895,51,10,61,0,inf
7896,52,12,64,0,inf
7897,67,8,75,0,inf
7898,56,7,63,0,inf
7899,56,13,69,0,inf
7900,59,5,64,0,inf
7901,58,6,64,0,inf
7902,64,13,77,1,10.793994319525822
7903,50,6,56,0,inf
7904,59,12,71,0,inf
7905,57,6,63,0,inf
7906,56,8,64,0,inf
7907,57,10,67,0,inf
7908,60,9,69,0,inf
7909,58,11,69,0,inf
7910,50,10,60,0,inf
7911,62,12,74,0,inf
7912,59,13,72,0,inf
7913,65,5,70,0,inf
7914,51,10,61,0,inf
7915,60,11,71,0,inf
7916,63,5,68,0,inf
7917,54,5,59,0,inf
7918,61,11,72,0,inf
7919,57,8,65,0,inf
7920,61,7,68,0,inf
7921,61,13,74,0,inf
7922,62,9,71,0,inf
7923,65,8,73,0,inf
7924,54,5,59,0,inf
7925,53,9,62,0,inf
7926,59,12,71,0,inf
7927,55,5,60,0,inf
7928,54,10,64,0,inf
7929,51,5,56,0,inf
7930,62,12,74,0,inf
7931,62,9,71,0,inf
7932,67,8,75,0,inf
7933,60,13,73,0,inf
7934,58,9,67,0,inf
7935,66,13,79,0,inf
7936,65,13,78,0,inf
7937,50,9,59,0,inf
7938,54,8,62,0,inf
7939,58,7,65,0,inf
7940,51,10,61,0,inf
7941,64,12,76,0,inf
7942,59,13,72,0,inf
7943,60,9,69,0,inf
7944,50,13,63,0,inf
7945,58,12,70,0,inf
7946,67,9,76,0,inf
7947,63,8,71,0,inf
7948,51,12,63,0,inf
7949,60,12,72,0,inf
7950,55,7,62,0,inf
7951,56,9,65,0,inf
7952,61,7,68,0,inf
7953,60,5,65,0,inf
7954,56,10,66,0,inf
7955,59,13,72,0,inf
7956,67,9,76,0,inf
7957,60,9,69,0,inf
7958,50,13,63,0,inf
7959,65,8,73,0,inf
7960,54,11,65,0,inf
7961,53,13,66,0,inf
7962,54,10,64,0,inf
7963,56,8,64,0,inf
7964,55,7,62,0,inf
7965,57,9,66,0,inf
7966,62,13,75,0,inf
7967,62,5,67,0,inf
7968,51,13,64,0,inf
7969,54,6,60,0,inf
7970,61,6,67,0,inf
7971,64,7,71,0,inf
7972,51,7,58,0,inf
7973,58,7,65,0,inf
7974,50,10,60,0,inf
7975,56,12,68,0,inf
7976,67,11,78,0,inf
7977,61,7,68,0,inf
7978,51,13,64,0,inf
7979,63,5,68,0,inf
7980,54,7,61,0,inf
7981,54,6,60,0,inf
7982,66,10,76,0,inf
7983,57,9,66,0,inf
7984,59,5,64,0,inf
7985,65,10,75,0,inf
7986,66,11,77,0,inf
7987,63,12,75,0,inf
7988,62,6,68,0,inf
7989,63,13,76,0,inf
7990,58,12,70,0,inf
7991,52,12,64,0,inf
7992,62,6,68,0,inf
7993,61,7,68,0,inf
7994,51,11,62,0,inf
7995,63,10,73,0,inf
7996,61,13,74,0,inf
7997,60,10,70,0,inf
7998,67,10,77,0,inf
7999,54,12,66,0,inf
8000,59,13,72,0,inf
8001,65,6,71,0,inf
8002,65,11,76,0,inf
8003,57,7,64,0,inf
8004,61,8,69,0,inf
8005,57,12,69,0,inf
8006,62,12,74,0,inf
8007,51,10,61,0,inf
8008,50,7,57,0,inf
8009,65,7,72,0,inf
8010,65,6,71,0,inf
8011,50,7,57,0,inf
8012,66,6,72,0,inf
8013,59,13,72,0,inf
8014,63,6,69,0,inf
8015,60,12,72,1,3.4541178615137156
8016,66,7,73,0,inf
8017,52,7,59,0,inf
8018,57,6,63,0,inf
8019,56,8,64,0,inf
8020,61,9,70,0,inf
8021,62,10,72,0,inf
8022,55,12,67,0,inf
8023,53,9,62,0,inf
8024,55,8,63,0,inf
8025,53,8,61,0,inf
8026,60,8,68,0,inf
8027,60,8,68,0,inf
8028,50,7,57,0,inf
8029,58,8,66,0,inf
8030,52,8,60,0,inf
8031,54,10,64,0,inf
8032,66,9,75,0,inf
8033,52,11,63,0,inf
8034,61,11,72,0,inf
8035,57,9,66,0,inf
8036,50,10,60,0,inf
8037,66,5,71,0,inf
8038,62,13,75,0,inf
8039,66,8,74,0,inf
8040,60,6,66,0,inf
8041,56,13,69,0,inf
8042,57,10,67,0,inf
8043,58,5,63,0,inf
8044,63,8,71,0,inf
8045,64,12,76,1,0.9622863271095099
8046,53,6,59,0,inf
8047,54,9,63,0,inf
8048,61,9,70,0,inf
8049,51,13,64,0,inf
8050,51,12,63,0,inf
8051,55,8,63,0,inf
8052,54,8,62,0,inf
8053,66,6,72,0,inf
8054,60,7,67,0,inf
8055,61,13,74,0,inf
8056,64,5,69,0,inf
8057,53,13,66,1,10.801144958985432
8058,55,10,65,0,inf
8059,67,8,75,0,inf
8060,62,9,71,0,inf
8061,63,7,70,0,inf
8062,67,7,74,0,inf
8063,57,10,67,0,inf
8064,61,7,68,0,inf
8065,53,7,60,0,inf
8066,54,5,59,0,inf
8067,60,5,65,0,inf
8068,66,5,71,0,inf
8069,61,9,70,0,inf
8070,67,9,76,0,inf
8071,63,11,74,0,inf
8072,64,13,77,0,inf
8073,58,6,64,0,inf
8074,50,13,63,0,inf
8075,51,9,60,0,inf
8076,52,8,60,0,inf
8077,63,9,72,0,inf
8078,61,8,69,1,5.212503823994325
8079,66,11,77,0,inf
8080,51,13,64,0,inf
8081,62,10,72,0,inf
8082,66,10,76,0,inf
8083,65,8,73,0,inf
8084,64,7,71,0,inf
8085,64,7,71,0,inf
8086,53,9,62,0,inf
8087,58,8,66,0,inf
8088,59,8,67,0,inf
8089,65,12,77,0,inf
8090,67,13,80,1,12.119687995704155
8091,54,13,67,0,inf
8092,50,6,56,1,0.9325692178181839
8093,62,5,67,0,inf
8094,60,13,73,0,inf
8095,61,10,71,0,inf
8096,57,6,63,0,inf
8097,59,9,68,0,inf
8098,52,7,59,0,inf
8099,54,11,65,0,inf
8100,53,13,66,0,inf
8101,59,10,69,0,inf
8102,55,9,64,0,inf
8103,61,8,69,0,inf
8104,52,8,60,0,inf
8105,57,6,63,0,inf
8106,55,9,64,0,inf
8107,63,7,70,0,inf
8108,51,6,57,0,inf
8109,66,9,75,0,inf
8110,56,7,63,0,inf
8111,65,12,77,0,inf
8112,59,8,67,0,inf
8113,56,10,66,0,inf
8114,59,10,69,0,inf
8115,62,6,68,0,inf
8116,62,8,70,0,inf
8117,56,8,64,0,inf
8118,50,5,55,0,inf
8119,54,5,59,0,inf
8120,66,12,78,0,inf
8121,54,13,67,0,inf
8122,60,13,73,0,inf
8123,66,5,71,0,inf
8124,64,13,77,0,inf
8125,67,5,72,0,inf
8126,54,9,63,0,inf
8127,52,5,57,0,inf
8128,64,7,71,0,inf
8129,66,11,77,0,inf
8130,65,5,70,0,inf
8131,60,8,68,0,inf
8132,57,11,68,0,inf
8133,57,12,69,0,inf
8134,57,12,69,0,inf
8135,60,13,73,0,inf
8136,67,7,74,0,inf
8137,63,11,74,0,inf
8138,50,9,59,0,inf
8139,53,9,62,0,inf
8140,61,12,73,0,inf
8141,53,9,62,0,inf
8142,67,10,77,0,inf
8143,59,10,69,0,inf
8144,55,5,60,0,inf
8145,52,7,59,0,inf
8146,50,9,59,0,inf
8147,50,13,63,0,inf
8148,66,7,73,0,inf
8149,58,7,65,0,inf
8150,66,12,78,0,inf
8151,50,7,57,0,inf
8152,63,12,75,0,inf
8153,54,6,60,0,inf
8154,57,8,65,0,inf
8155,61,9,70,0,inf
8156,53,8,61,0,inf
8157,65,11,76,0,inf
8158,60,13,73,0,inf
8159,52,11,63,0,inf
8160,64,7,71,0,inf
8161,51,11,62,0,inf
8162,50,12,62,1,9.068318198875176
8163,57,7,64,0,inf
8164,58,7,65,0,inf
8165,56,7,63,0,inf
8166,50,11,61,0,inf
8167,55,13,68,0,inf
8168,65,9,74,0,inf
8169,61,8,69,0,inf
8170,65,11,76,0,inf
8171,56,6,62,0,inf
8172,59,12,71,0,inf
8173,63,13,76,0,inf
8174,56,6,62,0,inf
8175,50,10,60,0,inf
8176,57,11,68,1,1.2909650829159958
8177,59,8,67,0,inf
8178,50,10,60,0,inf
8179,63,10,73,0,inf
8180,65,10,75,0,inf
8181,59,8,67,0,inf
8182,50,8,58,0,inf
8183,53,8,61,0,inf
8184,51,9,60,1,4.949470377643614
8185,63,5,68,0,inf
8186,50,9,59,0,inf
8187,63,8,71,0,inf
8188,53,7,60,0,inf
8189,52,6,58,0,inf
8190,66,11,77,0,inf
8191,62,9,71,0,inf
8192,63,12,75,0,inf
8193,51,7,58,0,inf
8194,55,12,67,0,inf
8195,52,11,63,0,inf
8196,51,6,57,0,inf
8197,59,10,69,0,inf
8198,61,9,70,0,inf
8199,65,11,76,0,inf
8200,60,12,72,0,inf
8201,54,10,64,0,inf
8202,56,10,66,0,inf
8203,63,13,76,0,inf
8204,51,7,58,0,inf
8205,60,5,65,0,inf
8206,65,8,73,0,inf
8207,66,9,75,1,1.4732546929199657
8208,52,12,64,0,inf
8209,63,8,71,0,inf
8210,58,9,67,0,inf
8211,64,7,71,0,inf
8212,54,11,65,0,inf
8213,51,9,60,0,inf
8214,59,8,67,0,inf
8215,54,7,61,0,inf
8216,56,6,62,0,inf
8217,65,6,71,0,inf
8218,55,8,63,0,inf
8219,65,9,74,0,inf
8220,65,11,76,0,inf
8221,59,8,67,0,inf
8222,53,9,62,0,inf
8223,64,13,77,0,inf
8224,54,11,65,1,6.010337539856124
8225,51,8,59,0,inf
8226,66,12,78,0,inf
8227,57,11,68,0,inf
8228,52,7,59,0,inf
8229,63,9,72,0,inf
8230,59,12,71,0,inf
8231,61,5,66,0,inf
8232,50,10,60,0,inf
8233,61,7,68,0,inf
8234,56,8,64,0,inf
8235,59,9,68,0,inf
8236,50,13,63,0,inf
8237,67,10,77,0,inf
8238,55,12,67,0,inf
8239,51,9,60,0,inf
8240,58,7,65,0,inf
8241,62,9,71,0,inf
8242,60,11,71,0,inf
8243,64,10,74,0,inf
8244,54,11,65,0,inf
8245,61,5,66,0,inf
8246,55,6,61,0,inf
8247,53,10,63,0,inf
8248,67,6,73,0,inf
8249,51,8,59,0,inf
8250,60,8,68,0,inf
8251,60,10,70,0,inf
8252,66,10,76,0,inf
8253,53,10,63,0,inf
8254,63,9,72,0,inf
8255,67,5,72,0,inf
8256,52,5,57,0,inf
8257,59,7,66,0,inf
8258,62,8,70,0,inf
8259,65,10,75,0,inf
8260,55,13,68,0,inf
8261,53,11,64,0,inf
8262,51,11,62,0,inf
8263,51,5,56,0,inf
8264,51,13,64,0,inf
8265,56,8,64,0,inf
8266,63,9,72,0,inf
8267,56,7,63,0,inf
8268,63,9,72,0,inf
8269,52,5,57,0,inf
8270,50,5,55,0,inf
8271,57,13,70,0,inf
8272,67,9,76,0,inf
8273,56,6,62,0,inf
8274,64,8,72,0,inf
8275,61,5,66,0,inf
8276,64,9,73,0,inf
8277,64,8,72,0,inf
8278,57,5,62,0,inf
8279,67,8,75,0,inf
8280,54,6,60,0,inf
8281,66,10,76,0,inf
8282,58,5,63,0,inf
8283,53,12,65,0,inf
8284,60,8,68,0,inf
8285,57,9,66,0,inf
8286,62,12,74,0,inf
8287,62,6,68,0,inf
8288,67,6,73,0,inf
8289,56,7,63,0,inf
8290,65,13,78,0,inf
8291,52,11,63,0,inf
8292,64,10,74,0,inf
8293,50,9,59,0,inf
8294,61,7,68,0,inf
8295,61,8,69,0,inf
8296,53,9,62,0,inf
8297,64,13,77,0,inf
8298,56,11,67,0,inf
8299,56,6,62,0,inf
8300,59,7,66,0,inf
8301,67,10,77,0,inf
8302,67,8,75,1,4.7539940218485555
8303,67,12,79,0,inf
8304,60,5,65,0,inf
8305,53,7,60,0,inf
8306,65,10,75,0,inf
8307,50,5,55,0,inf
8308,55,8,63,0,inf
8309,51,13,64,0,inf
8310,54,6,60,0,inf
8311,51,13,64,0,inf
8312,55,13,68,0,inf
8313,52,7,59,0,inf
8314,56,7,63,0,inf
8315,60,6,66,0,inf
8316,61,13,74,0,inf
8317,67,13,80,0,inf
8318,67,5,72,0,inf
8319,50,13,63,0,inf
8320,53,11,64,0,inf
8321,64,10,74,0,inf
8322,50,5,55,0,inf
8323,65,10,75,0,inf
8324,54,11,65,0,inf
8325,51,12,63,0,inf
8326,57,12,69,0,inf
8327,60,6,66,0,inf
8328,53,5,58,0,inf
8329,50,13,63,0,inf
8330,54,12,66,0,inf
8331,57,9,66,0,inf
8332,64,13,77,0,inf
8333,50,13,63,0,inf
8334,64,8,72,0,inf
8335,67,9,76,1,4.234635066255976
8336,62,13,75,0,inf
8337,55,8,63,0,inf
8338,60,8,68,0,inf
8339,52,13,65,0,inf
8340,58,10,68,0,inf
8341,52,12,64,0,inf
8342,59,13,72,0,inf
8343,66,9,75,0,inf
8344,58,13,71,0,inf
8345,57,12,69,0,inf
8346,58,8,66,0,inf
8347,66,13,79,0,inf
8348,52,7,59,0,inf
8349,57,6,63,0,inf
8350,65,8,73,0,inf
8351,59,12,71,0,inf
8352,57,12,69,0,inf
8353,57,5,62,0,inf
8354,67,11,78,0,inf
8355,66,6,72,0,inf
8356,59,9,68,0,inf
8357,53,11,64,0,inf
8358,62,5,67,0,inf
8359,66,5,71,0,inf
8360,53,9,62,0,inf
8361,52,6,58,0,inf
8362,61,5,66,0,inf
8363,53,10,63,0,inf
8364,54,11,65,0,inf
8365,67,6,73,0,inf
8366,53,8,61,0,inf
8367,67,7,74,0,inf
8368,55,7,62,0,inf
8369,64,6,70,0,inf
8370,53,9,62,0,inf
8371,53,6,59,0,inf
8372,61,5,66,0,inf
8373,50,13,63,0,inf
8374,56,7,63,0,inf
8375,66,10,76,0,inf
8376,66,8,74,0,inf
8377,65,7,72,0,inf
8378,58,6,64,0,inf
8379,66,5,71,0,inf
8380,54,11,65,0,inf
8381,63,9,72,0,inf
8382,67,9,76,0,inf
8383,66,6,72,0,inf
8384,51,12,63,0,inf
8385,66,13,79,0,inf
8386,60,13,73,0,inf
8387,65,13,78,0,inf
8388,65,11,76,0,inf
8389,52,8,60,0,inf
8390,59,11,70,0,inf
8391,65,11,76,0,inf
8392,51,11,62,0,inf
8393,55,8,63,0,inf
8394,53,8,61,0,inf
8395,57,11,68,0,inf
8396,63,11,74,0,inf
8397,61,5,66,0,inf
8398,61,5,66,0,inf
8399,66,13,79,0,inf
8400,56,9,65,0,inf
8401,58,7,65,0,inf
8402,56,8,64,0,inf
8403,60,7,67,0,inf
8404,60,13,73,0,inf
8405,64,7,71,0,inf
8406,52,6,58,0,inf
8407,62,9,71,0,inf
8408,53,9,62,0,inf
8409,67,13,80,0,inf
8410,64,12,76,0,inf
8411,60,10,70,0,inf
8412,55,13,68,0,inf
8413,59,11,70,0,inf
8414,58,10,68,0,inf
8415,50,8,58,0,inf
8416,64,5,69,0,inf
8417,65,9,74,0,inf
8418,60,11,71,0,inf
8419,62,6,68,0,inf
8420,56,11,67,0,inf
8421,63,9,72,0,inf
8422,67,10,77,0,inf
8423,60,6,66,0,inf
8424,55,10,65,0,inf
8425,62,8,70,0,inf
8426,60,6,66,0,inf
8427,60,12,72,0,inf
8428,52,6,58,0,inf
8429,63,13,76,1,10.88408943643266
8430,59,8,67,0,inf
8431,51,12,63,0,inf
8432,65,13,78,0,inf
8433,50,5,55,0,inf
8434,52,7,59,0,inf
8435,61,7,68,0,inf
8436,59,6,65,0,inf
8437,51,12,63,0,inf
8438,55,7,62,0,inf
8439,65,10,75,0,inf
8440,65,10,75,0,inf
8441,52,8,60,0,inf
8442,51,10,61,0,inf
8443,56,7,63,0,inf
8444,61,7,68,0,inf
8445,60,11,71,0,inf
8446,66,7,73,0,inf
8447,61,13,74,0,inf
8448,64,9,73,0,inf
8449,55,7,62,0,inf
8450,64,6,70,0,inf
8451,66,11,77,0,inf
8452,51,6,57,0,inf
8453,58,12,70,0,inf
8454,52,12,64,0,inf
8455,51,5,56,0,inf
8456,58,9,67,0,inf
8457,62,6,68,0,inf
8458,58,8,66,0,inf
8459,60,6,66,0,inf
8460,64,13,77,0,inf
8461,65,5,70,0,inf
8462,57,5,62,0,inf
8463,60,11,71,0,inf
8464,59,10,69,0,inf
8465,63,8,71,0,inf
8466,54,10,64,0,inf
8467,55,13,68,0,inf
8468,58,11,69,0,inf
8469,66,10,76,0,inf
8470,58,11,69,0,inf
8471,62,7,69,0,inf
8472,67,13,80,0,inf
8473,55,10,65,0,inf
8474,50,6,56,0,inf
8475,58,12,70,0,inf
8476,52,6,58,0,inf
8477,54,9,63,0,inf
8478,66,13,79,0,inf
8479,64,8,72,0,inf
8480,51,10,61,0,inf
8481,66,10,76,0,inf
8482,56,10,66,0,inf
8483,50,10,60,0,inf
8484,60,13,73,0,inf
8485,53,6,59,0,inf
8486,52,12,64,0,inf
8487,58,5,63,0,inf
8488,53,7,60,0,inf
8489,58,6,64,0,inf
8490,62,13,75,1,2.779109890402495
8491,65,10,75,0,inf
8492,56,7,63,0,inf
8493,63,12,75,0,inf
8494,58,10,68,0,inf
8495,65,11,76,0,inf
8496,59,7,66,0,inf
8497,63,9,72,0,inf
8498,65,11,76,0,inf
8499,53,5,58,0,inf
8500,52,5,57,0,inf
8501,63,12,75,0,inf
8502,64,5,69,0,inf
8503,61,11,72,0,inf
8504,50,8,58,0,inf
8505,50,9,59,0,inf
8506,62,10,72,0,inf
8507,54,7,61,0,inf
8508,55,13,68,0,inf
8509,60,5,65,0,inf
8510,50,11,61,0,inf
8511,53,12,65,0,inf
8512,63,9,72,0,inf
8513,65,5,70,0,inf
8514,67,11,78,0,inf
8515,58,13,71,0,inf
8516,58,11,69,0,inf
8517,61,6,67,0,inf
8518,65,9,74,0,inf
8519,66,6,72,0,inf
8520,61,8,69,0,inf
8521,63,11,74,0,inf
8522,56,8,64,0,inf
8523,59,13,72,0,inf
8524,61,10,71,0,inf
8525,62,13,75,0,inf
8526,60,13,73,0,inf
8527,64,6,70,0,inf
8528,56,8,64,0,inf
8529,63,11,74,0,inf
8530,64,10,74,0,inf
8531,54,9,63,0,inf
8532,52,8,60,0,inf
8533,59,11,70,0,inf
8534,57,12,69,0,inf
8535,55,10,65,0,inf
8536,57,13,70,0,inf
8537,51,7,58,0,inf
8538,50,13,63,0,inf
8539,53,12,65,0,inf
8540,53,5,58,0,inf
8541,64,5,69,0,inf
8542,57,13,70,0,inf
8543,62,8,70,0,inf
8544,53,10,63,0,inf
8545,63,10,73,0,inf
8546,65,9,74,0,inf
8547,53,10,63,0,inf
8548,52,7,59,0,inf
8549,61,11,72,0,inf
8550,54,11,65,0,inf
8551,57,10,67,0,inf
8552,65,9,74,0,inf
8553,54,12,66,0,inf
8554,62,12,74,0,inf
8555,64,8,72,0,inf
8556,60,9,69,0,inf
8557,55,11,66,0,inf
8558,54,5,59,0,inf
8559,61,8,69,0,inf
8560,55,7,62,0,inf
8561,66,13,79,0,inf
8562,60,6,66,0,inf
8563,57,6,63,0,inf
8564,65,8,73,0,inf
8565,54,12,66,1,0.42738284962317863
8566,53,6,59,0,inf
8567,62,8,70,0,inf
8568,65,11,76,0,inf
8569,65,12,77,0,inf
8570,56,5,61,0,inf
8571,65,10,75,0,inf
8572,62,13,75,0,inf
8573,65,9,74,0,inf
8574,62,11,73,0,inf
8575,61,12,73,0,inf
8576,52,8,60,0,inf
8577,63,5,68,0,inf
8578,55,8,63,0,inf
8579,50,10,60,0,inf
8580,50,12,62,0,inf
8581,56,11,67,0,inf
8582,63,13,76,0,inf
8583,53,9,62,0,inf
8584,59,13,72,0,inf
8585,58,6,64,0,inf
8586,67,13,80,0,inf
8587,58,5,63,0,inf
8588,50,6,56,0,inf
8589,67,5,72,0,inf
8590,53,5,58,0,inf
8591,65,8,73,0,inf
8592,55,13,68,0,inf
8593,56,13,69,0,inf
8594,67,7,74,0,inf
8595,50,12,62,1,8.527077268103866
8596,64,6,70,0,inf
8597,53,13,66,0,inf
8598,65,13,78,0,inf
8599,56,5,61,0,inf
8600,50,7,57,0,inf
8601,50,5,55,0,inf
8602,64,7,71,0,inf
8603,53,10,63,0,inf
8604,59,7,66,0,inf
8605,60,6,66,0,inf
8606,67,8,75,0,inf
8607,59,5,64,0,inf
8608,55,8,63,0,inf
8609,64,5,69,0,inf
8610,54,11,65,0,inf
8611,58,12,70,1,3.8872007135063527
8612,53,6,59,0,inf
8613,52,11,63,0,inf
8614,52,11,63,0,inf
8615,53,11,64,0,inf
8616,58,12,70,0,inf
8617,59,9,68,0,inf
8618,65,5,70,0,inf
8619,53,12,65,0,inf
8620,62,13,75,0,inf
8621,61,11,72,0,inf
8622,66,11,77,0,inf
8623,60,12,72,0,inf
8624,61,8,69,0,inf
8625,63,13,76,1,4.989057089699273
8626,50,8,58,0,inf
8627,57,6,63,0,inf
8628,50,7,57,0,inf
8629,57,13,70,0,inf
8630,64,10,74,0,inf
8631,59,13,72,0,inf
8632,53,6,59,0,inf
8633,61,13,74,0,inf
8634,63,7,70,0,inf
8635,64,8,72,0,inf
8636,63,12,75,0,inf
8637,52,5,57,0,inf
8638,55,5,60,0,inf
8639,66,11,77,0,inf
8640,56,8,64,0,inf
8641,52,10,62,0,inf
8642,65,12,77,0,inf
8643,53,8,61,0,inf
8644,58,10,68,0,inf
8645,58,5,63,0,inf
8646,67,7,74,0,inf
8647,57,11,68,0,inf
8648,66,12,78,1,11.000938234706155
8649,57,7,64,0,inf
8650,67,7,74,0,inf
8651,52,10,62,0,inf
8652,60,11,71,0,inf
8653,59,12,71,0,inf
8654,61,10,71,0,inf
8655,50,5,55,0,inf
8656,50,7,57,0,inf
8657,67,8,75,0,inf
8658,52,11,63,0,inf
8659,56,12,68,0,inf
8660,67,9,76,0,inf
8661,57,8,65,0,inf
8662,53,11,64,0,inf
8663,58,9,67,0,inf
8664,67,10,77,0,inf
8665,61,6,67,0,inf
8666,50,5,55,0,inf
8667,66,10,76,0,inf
8668,63,5,68,0,inf
8669,59,6,65,0,inf
8670,54,6,60,0,inf
8671,57,5,62,0,inf
8672,63,9,72,0,inf
8673,57,7,64,0,inf
8674,65,9,74,0,inf
8675,61,10,71,0,inf
8676,58,10,68,0,inf
8677,62,10,72,0,inf
8678,51,8,59,0,inf
8679,52,11,63,0,inf
8680,63,8,71,0,inf
8681,62,10,72,0,inf
8682,58,10,68,1,3.673881308690113
8683,54,7,61,0,inf
8684,54,6,60,0,inf
8685,51,5,56,0,inf
8686,50,12,62,0,inf
8687,61,7,68,0,inf
8688,55,7,62,0,inf
8689,58,10,68,0,inf
8690,64,6,70,0,inf
8691,65,11,76,0,inf
8692,58,8,66,0,inf
8693,59,9,68,0,inf
8694,62,12,74,0,inf
8695,60,12,72,0,inf
8696,52,6,58,0,inf
8697,50,12,62,0,inf
8698,53,6,59,0,inf
8699,57,6,63,0,inf
8700,67,5,72,0,inf
8701,64,12,76,0,inf
8702,55,5,60,0,inf
8703,66,12,78,0,inf
8704,52,6,58,0,inf
8705,54,5,59,0,inf
8706,64,7,71,0,inf
8707,65,7,72,0,inf
8708,59,5,64,0,inf
8709,65,8,73,0,inf
8710,52,11,63,0,inf
8711,57,11,68,0,inf
8712,50,6,56,0,inf
8713,62,7,69,0,inf
8714,60,9,69,0,inf
8715,61,5,66,0,inf
8716,58,10,68,0,inf
8717,54,7,61,0,inf
8718,58,8,66,0,inf
8719,50,7,57,0,inf
8720,54,8,62,0,inf
8721,58,5,63,0,inf
8722,56,8,64,0,inf
8723,54,5,59,0,inf
8724,63,10,73,0,inf
8725,53,9,62,0,inf
8726,59,7,66,1,2.7732199161784976
8727,54,13,67,0,inf
8728,59,8,67,0,inf
8729,51,6,57,0,inf
8730,52,5,57,0,inf
8731,66,11,77,0,inf
8732,63,9,72,0,inf
8733,59,9,68,0,inf
8734,51,9,60,0,inf
8735,63,13,76,0,inf
8736,51,11,62,0,inf
8737,62,11,73,0,inf
8738,59,10,69,0,inf
8739,52,11,63,0,inf
8740,60,5,65,0,inf
8741,67,12,79,0,inf
8742,54,7,61,0,inf
8743,55,10,65,0,inf
8744,59,7,66,0,inf
8745,53,11,64,0,inf
8746,67,8,75,0,inf
8747,66,12,78,0,inf
8748,62,11,73,0,inf
8749,58,7,65,0,inf
8750,53,9,62,0,inf
8751,57,5,62,0,inf
8752,50,9,59,1,5.500532459938924
8753,54,6,60,0,inf
8754,66,7,73,0,inf
8755,66,5,71,0,inf
8756,55,10,65,0,inf
8757,62,10,72,0,inf
8758,58,11,69,0,inf
8759,62,13,75,0,inf
8760,67,7,74,0,inf
8761,56,10,66,0,inf
8762,64,6,70,0,inf
8763,56,11,67,0,inf
8764,50,7,57,0,inf
8765,66,11,77,0,inf
8766,52,13,65,0,inf
8767,61,8,69,0,inf
8768,66,8,74,0,inf
8769,63,9,72,0,inf
8770,61,7,68,0,inf
8771,58,8,66,0,inf
8772,54,5,59,0,inf
8773,64,12,76,0,inf
8774,64,7,71,0,inf
8775,63,6,69,0,inf
8776,64,12,76,0,inf
8777,60,9,69,0,inf
8778,56,7,63,0,inf
8779,59,8,67,0,inf
8780,57,7,64,1,3.546809123993384
8781,56,12,68,0,inf
8782,65,13,78,0,inf
8783,62,6,68,0,inf
8784,56,9,65,0,inf
8785,58,8,66,0,inf
8786,53,12,65,0,inf
8787,56,9,65,0,inf
8788,54,12,66,0,inf
8789,55,10,65,0,inf
8790,64,8,72,0,inf
8791,60,6,66,0,inf
8792,53,11,64,0,inf
8793,55,12,67,0,inf
8794,51,7,58,0,inf
8795,53,5,58,0,inf
8796,58,13,71,1,9.711225440302002
8797,60,9,69,0,inf
8798,67,9,76,0,inf
8799,62,9,71,0,inf
8800,50,9,59,0,inf
8801,53,7,60,0,inf
8802,55,12,67,0,inf
8803,63,11,74,0,inf
8804,51,12,63,0,inf
8805,57,8,65,0,inf
8806,55,9,64,0,inf
8807,60,12,72,0,inf
8808,55,5,60,0,inf
8809,63,11,74,1,1.5010919099329527
8810,66,9,75,0,inf
8811,59,5,64,0,inf
8812,64,8,72,0,inf
8813,64,9,73,0,inf
8814,60,6,66,0,inf
8815,55,9,64,0,inf
8816,51,10,61,0,inf
8817,54,6,60,0,inf
8818,50,6,56,0,inf
8819,52,6,58,0,inf
8820,55,13,68,0,inf
8821,58,10,68,0,inf
8822,55,8,63,0,inf
8823,61,8,69,0,inf
8824,53,12,65,0,inf
8825,59,6,65,0,inf
8826,55,7,62,0,inf
8827,62,5,67,0,inf
8828,58,12,70,0,inf
8829,50,7,57,0,inf
8830,50,8,58,0,inf
8831,64,8,72,0,inf
8832,53,12,65,0,inf
8833,55,5,60,0,inf
8834,60,7,67,0,inf
8835,67,13,80,0,inf
8836,67,9,76,0,inf
8837,62,12,74,0,inf
8838,54,10,64,0,inf
8839,56,5,61,0,inf
8840,66,6,72,0,inf
8841,59,7,66,1,5.751110297132229
8842,64,12,76,0,inf
8843,59,6,65,0,inf
8844,66,13,79,0,inf
8845,61,12,73,0,inf
8846,51,6,57,0,inf
8847,50,11,61,0,inf
8848,54,5,59,0,inf
8849,67,12,79,0,inf
8850,63,12,75,0,inf
8851,55,8,63,0,inf
8852,55,13,68,0,inf
8853,63,8,71,0,inf
8854,66,7,73,0,inf
8855,56,7,63,0,inf
8856,62,12,74,0,inf
8857,64,11,75,0,inf
8858,60,9,69,0,inf
8859,50,7,57,0,inf
8860,66,11,77,0,inf
8861,56,7,63,0,inf
8862,58,5,63,0,inf
8863,53,7,60,0,inf
8864,50,6,56,0,inf
8865,66,11,77,0,inf
8866,57,8,65,0,inf
8867,56,10,66,0,inf
8868,50,6,56,0,inf
8869,63,6,69,0,inf
8870,65,9,74,0,inf
8871,56,9,65,0,inf
8872,65,8,73,0,inf
8873,67,7,74,0,inf
8874,51,11,62,0,inf
8875,59,12,71,0,inf
8876,65,11,76,0,inf
8877,50,10,60,0,inf
8878,53,7,60,0,inf
8879,57,7,64,0,inf
8880,59,5,64,0,inf
8881,59,12,71,0,inf
8882,66,9,75,0,inf
8883,65,8,73,0,inf
8884,57,8,65,0,inf
8885,61,13,74,0,inf
8886,63,9,72,1,1.9556613493136865
8887,50,11,61,0,inf
8888,63,12,75,0,inf
8889,60,6,66,0,inf
8890,50,12,62,0,inf
8891,50,12,62,0,inf
8892,50,5,55,0,inf
8893,66,7,73,0,inf
8894,59,9,68,0,inf
8895,63,13,76,0,inf
8896,64,12,76,0,inf
8897,66,10,76,0,inf
8898,50,9,59,0,inf
8899,59,13,72,0,inf
8900,50,10,60,0,inf
8901,50,13,63,0,inf
8902,60,12,72,0,inf
8903,53,9,62,0,inf
8904,63,7,70,0,inf
8905,62,9,71,0,inf
8906,53,8,61,0,inf
8907,60,8,68,0,inf
8908,55,6,61,0,inf
8909,51,10,61,0,inf
8910,67,9,76,0,inf
8911,58,13,71,0,inf
8912,61,10,71,0,inf
8913,62,6,68,0,inf
8914,56,9,65,0,inf
8915,53,6,59,0,inf
8916,57,7,64,0,inf
8917,61,11,72,0,inf
8918,58,6,64,0,inf
8919,65,10,75,0,inf
8920,67,10,77,0,inf
8921,60,6,66,0,inf
8922,56,10,66,0,inf
8923,62,11,73,0,inf
8924,53,10,63,0,inf
8925,62,9,71,0,inf
8926,61,11,72,0,inf
8927,67,7,74,0,inf
8928,59,7,66,0,inf
8929,67,12,79,0,inf
8930,53,9,62,0,inf
8931,55,10,65,0,inf
8932,61,7,68,0,inf
8933,58,9,67,0,inf
8934,56,11,67,0,inf
8935,66,8,74,0,inf
8936,57,12,69,0,inf
8937,67,12,79,0,inf
8938,53,11,64,0,inf
8939,60,12,72,0,inf
8940,63,6,69,0,inf
8941,51,8,59,0,inf
8942,58,13,71,0,inf
8943,57,12,69,0,inf
8944,56,12,68,1,5.654454532455524
8945,61,9,70,0,inf
8946,55,10,65,0,inf
8947,65,5,70,0,inf
8948,58,7,65,0,inf
8949,52,5,57,0,inf
8950,56,8,64,0,inf
8951,50,10,60,0,inf
8952,65,5,70,0,inf
8953,62,13,75,0,inf
8954,55,11,66,0,inf
8955,55,9,64,0,inf
8956,55,13,68,0,inf
8957,50,13,63,0,inf
8958,52,6,58,0,inf
8959,67,7,74,0,inf
8960,59,6,65,0,inf
8961,59,6,65,0,inf
8962,51,11,62,0,inf
8963,60,6,66,0,inf
8964,65,12,77,0,inf
8965,59,11,70,0,inf
8966,55,6,61,0,inf
8967,66,10,76,0,inf
8968,59,9,68,0,inf
8969,58,13,71,0,inf
8970,62,8,70,0,inf
8971,65,11,76,0,inf
8972,55,5,60,0,inf
8973,67,10,77,0,inf
8974,58,5,63,0,inf
8975,60,7,67,0,inf
8976,58,12,70,0,inf
8977,61,12,73,0,inf
8978,59,7,66,1,2.3368404221829806
8979,50,11,61,0,inf
8980,52,13,65,1,5.659872512763741
8981,52,7,59,0,inf
8982,50,11,61,0,inf
8983,60,9,69,0,inf
8984,51,9,60,0,inf
8985,56,10,66,0,inf
8986,64,10,74,0,inf
8987,54,12,66,0,inf
8988,54,7,61,0,inf
8989,59,10,69,0,inf
8990,63,9,72,0,inf
8991,54,5,59,0,inf
8992,50,10,60,0,inf
8993,60,10,70,0,inf
8994,51,9,60,0,inf
8995,67,5,72,0,inf
8996,51,6,57,0,inf
8997,65,9,74,0,inf
8998,60,10,70,0,inf
8999,63,13,76,0,inf
9000,63,10,73,0,inf
9001,67,5,72,0,inf
9002,53,9,62,0,inf
9003,60,11,71,0,inf
9004,54,5,59,0,inf
9005,62,5,67,0,inf
9006,50,6,56,0,inf
9007,59,6,65,0,inf
9008,52,6,58,0,inf
9009,56,8,64,0,inf
9010,50,13,63,0,inf
9011,56,12,68,0,inf
9012,66,9,75,0,inf
9013,56,13,69,0,inf
9014,59,13,72,0,inf
9015,65,5,70,0,inf
9016,66,7,73,0,inf
9017,63,5,68,0,inf
9018,66,9,75,0,inf
9019,50,5,55,0,inf
9020,59,6,65,0,inf
9021,60,12,72,0,inf
9022,53,12,65,0,inf
9023,50,6,56,0,inf
9024,51,6,57,0,inf
9025,57,9,66,0,inf
9026,55,9,64,0,inf
9027,64,13,77,0,inf
9028,54,9,63,0,inf
9029,63,13,76,0,inf
9030,64,11,75,0,inf
9031,51,13,64,0,inf
9032,56,6,62,0,inf
9033,59,11,70,0,inf
9034,67,12,79,0,inf
9035,61,9,70,0,inf
9036,65,13,78,0,inf
9037,51,13,64,0,inf
9038,52,12,64,0,inf
9039,55,5,60,0,inf
9040,66,13,79,0,inf
9041,52,5,57,0,inf
9042,59,6,65,0,inf
9043,57,6,63,0,inf
9044,59,10,69,0,inf
9045,51,5,56,0,inf
9046,50,9,59,0,inf
9047,50,10,60,0,inf
9048,56,13,69,0,inf
9049,53,8,61,0,inf
9050,67,6,73,0,inf
9051,56,11,67,0,inf
9052,52,13,65,0,inf
9053,55,6,61,0,inf
9054,56,8,64,0,inf
9055,61,5,66,0,inf
9056,50,13,63,0,inf
9057,58,8,66,0,inf
9058,65,11,76,0,inf
9059,50,13,63,0,inf
9060,61,11,72,0,inf
9061,54,13,67,0,inf
9062,54,8,62,0,inf
9063,52,9,61,0,inf
9064,50,8,58,0,inf
9065,52,7,59,0,inf
9066,54,8,62,0,inf
9067,66,10,76,0,inf
9068,57,13,70,1,11.50778942311689
9069,64,5,69,0,inf
9070,60,12,72,0,inf
9071,52,12,64,0,inf
9072,50,10,60,0,inf
9073,59,5,64,0,inf
9074,54,10,64,0,inf
9075,53,7,60,0,inf
9076,51,6,57,0,inf
9077,53,8,61,1,3.6968230520829763
9078,52,10,62,0,inf
9079,51,11,62,0,inf
9080,54,8,62,0,inf
9081,57,6,63,0,inf
9082,60,6,66,0,inf
9083,52,12,64,0,inf
9084,62,5,67,0,inf
9085,56,10,66,0,inf
9086,51,7,58,0,inf
9087,63,5,68,0,inf
9088,55,11,66,0,inf
9089,61,9,70,0,inf
9090,53,10,63,0,inf
9091,61,5,66,0,inf
9092,66,12,78,0,inf
9093,62,5,67,0,inf
9094,52,11,63,0,inf
9095,65,11,76,0,inf
9096,60,7,67,0,inf
9097,62,12,74,0,inf
9098,58,7,65,0,inf
9099,56,12,68,0,inf
9100,61,12,73,0,inf
9101,50,12,62,0,inf
9102,58,12,70,0,inf
9103,64,12,76,1,7.391917329814504
9104,67,11,78,0,inf
9105,59,11,70,0,inf
9106,52,12,64,1,8.659917509226986
9107,60,13,73,0,inf
9108,58,11,69,0,inf
9109,65,7,72,0,inf
9110,60,5,65,0,inf
9111,51,10,61,0,inf
9112,61,12,73,1,6.824724359117141
9113,50,12,62,0,inf
9114,50,11,61,0,inf
9115,60,13,73,0,inf
9116,50,9,59,1,6.8211637732311345
9117,50,13,63,0,inf
9118,67,11,78,0,inf
9119,52,5,57,0,inf
9120,50,13,63,0,inf
9121,61,9,70,0,inf
9122,63,13,76,0,inf
9123,66,11,77,0,inf
9124,60,9,69,0,inf
9125,62,9,71,0,inf
9126,58,5,63,0,inf
9127,65,9,74,0,inf
9128,58,6,64,0,inf
9129,61,11,72,0,inf
9130,50,10,60,0,inf
9131,62,12,74,0,inf
9132,61,12,73,0,inf
9133,65,10,75,0,inf
9134,63,10,73,0,inf
9135,57,12,69,0,inf
9136,66,12,78,0,inf
9137,55,11,66,0,inf
9138,60,13,73,0,inf
9139,56,5,61,0,inf
9140,56,6,62,0,inf
9141,55,13,68,0,inf
9142,55,11,66,1,6.109131585320675
9143,62,10,72,0,inf
9144,57,10,67,0,inf
9145,53,7,60,0,inf
9146,52,8,60,0,inf
9147,50,9,59,0,inf
9148,65,8,73,0,inf
9149,59,8,67,0,inf
9150,55,6,61,0,inf
9151,67,13,80,0,inf
9152,62,6,68,0,inf
9153,66,11,77,0,inf
9154,54,13,67,0,inf
9155,50,8,58,0,inf
9156,66,5,71,0,inf
9157,52,8,60,0,inf
9158,60,8,68,0,inf
9159,56,6,62,0,inf
9160,54,10,64,1,9.749209279483452
9161,60,9,69,0,inf
9162,61,10,71,0,inf
9163,61,6,67,0,inf
9164,64,5,69,0,inf
9165,62,6,68,0,inf
9166,53,11,64,0,inf
9167,67,9,76,0,inf
9168,61,5,66,0,inf
9169,61,7,68,0,inf
9170,50,9,59,0,inf
9171,65,5,70,0,inf
9172,64,9,73,0,inf
9173,53,11,64,0,inf
9174,58,7,65,0,inf
9175,55,6,61,0,inf
9176,52,7,59,0,inf
9177,58,6,64,0,inf
9178,67,7,74,0,inf
9179,67,5,72,0,inf
9180,61,9,70,0,inf
9181,56,7,63,0,inf
9182,55,12,67,0,inf
9183,50,8,58,0,inf
9184,51,6,57,0,inf
9185,61,8,69,0,inf
9186,63,12,75,0,inf
9187,57,8,65,0,inf
9188,64,9,73,0,inf
9189,53,9,62,0,inf
9190,65,10,75,0,inf
9191,53,11,64,1,8.727691671518244
9192,50,5,55,0,inf
9193,66,6,72,0,inf
9194,56,13,69,0,inf
9195,56,9,65,0,inf
9196,54,10,64,0,inf
9197,56,8,64,0,inf
9198,52,12,64,0,inf
9199,54,6,60,0,inf
9200,53,11,64,0,inf
9201,52,7,59,0,inf
9202,62,6,68,0,inf
9203,63,7,70,0,inf
9204,65,10,75,0,inf
9205,65,9,74,0,inf
9206,65,8,73,0,inf
9207,50,8,58,0,inf
9208,55,13,68,0,inf
9209,66,11,77,0,inf
9210,58,8,66,0,inf
9211,59,5,64,0,inf
9212,58,7,65,0,inf
9213,66,13,79,0,inf
9214,65,6,71,0,inf
9215,57,5,62,0,inf
9216,53,8,61,0,inf
9217,51,11,62,0,inf
9218,63,13,76,0,inf
9219,66,9,75,0,inf
9220,56,6,62,0,inf
9221,66,10,76,0,inf
9222,50,12,62,0,inf
9223,57,7,64,0,inf
9224,60,9,69,0,inf
9225,65,8,73,0,inf
9226,55,10,65,0,inf
9227,61,11,72,0,inf
9228,52,12,64,0,inf
9229,50,13,63,0,inf
9230,62,12,74,0,inf
9231,67,8,75,0,inf
9232,51,12,63,0,inf
9233,56,8,64,0,inf
9234,56,7,63,1,6.122732434251624
9235,61,11,72,0,inf
9236,53,5,58,0,inf
9237,54,5,59,0,inf
9238,63,8,71,0,inf
9239,57,7,64,0,inf
9240,53,10,63,0,inf
9241,64,9,73,0,inf
9242,65,8,73,0,inf
9243,56,9,65,0,inf
9244,59,7,66,0,inf
9245,57,9,66,0,inf
9246,66,5,71,0,inf
9247,67,11,78,0,inf
9248,62,10,72,0,inf
9249,50,12,62,0,inf
9250,61,8,69,0,inf
9251,65,9,74,0,inf
9252,59,6,65,0,inf
9253,56,5,61,0,inf
9254,63,13,76,0,inf
9255,51,11,62,0,inf
9256,64,9,73,0,inf
9257,59,8,67,0,inf
9258,54,12,66,0,inf
9259,55,8,63,0,inf
9260,58,9,67,0,inf
9261,61,9,70,0,inf
9262,54,5,59,0,inf
9263,59,10,69,0,inf
9264,55,7,62,0,inf
9265,60,11,71,0,inf
9266,65,13,78,0,inf
9267,51,7,58,0,inf
9268,52,13,65,0,inf
9269,65,13,78,0,inf
9270,58,9,67,0,inf
9271,54,5,59,0,inf
9272,50,13,63,0,inf
9273,60,6,66,0,inf
9274,63,5,68,0,inf
9275,52,5,57,0,inf
9276,53,6,59,0,inf
9277,60,13,73,0,inf
9278,64,8,72,0,inf
9279,60,8,68,0,inf
9280,62,9,71,0,inf
9281,60,13,73,0,inf
9282,62,9,71,0,inf
9283,67,12,79,0,inf
9284,59,12,71,0,inf
9285,58,10,68,0,inf
9286,55,12,67,0,inf
9287,58,8,66,0,inf
9288,65,6,71,0,inf
9289,67,8,75,1,6.448572956158856
9290,56,12,68,0,inf
9291,51,5,56,0,inf
9292,58,12,70,0,inf
9293,59,6,65,0,inf
9294,59,8,67,0,inf
9295,52,10,62,0,inf
9296,67,10,77,0,inf
9297,65,6,71,0,inf
9298,61,13,74,0,inf
9299,60,5,65,0,inf
9300,54,6,60,0,inf
9301,62,12,74,0,inf
9302,63,6,69,0,inf
9303,60,5,65,0,inf
9304,57,10,67,0,inf
9305,53,8,61,0,inf
9306,66,12,78,0,inf
9307,54,11,65,0,inf
9308,54,12,66,0,inf
9309,58,11,69,0,inf
9310,65,12,77,1,8.278508864187671
9311,52,6,58,0,inf
9312,57,8,65,0,inf
9313,55,10,65,0,inf
9314,65,12,77,0,inf
9315,55,8,63,0,inf
9316,53,11,64,0,inf
9317,55,13,68,0,inf
9318,64,7,71,0,inf
9319,58,6,64,0,inf
9320,55,10,65,0,inf
9321,57,7,64,0,inf
9322,59,9,68,0,inf
9323,54,13,67,0,inf
9324,53,9,62,0,inf
9325,59,5,64,0,inf
9326,54,11,65,1,4.903063973067319
9327,52,12,64,0,inf
9328,58,11,69,0,inf
9329,60,11,71,1,9.849541361746574
9330,67,11,78,0,inf
9331,51,5,56,0,inf
9332,50,5,55,0,inf
9333,63,7,70,0,inf
9334,64,12,76,0,inf
9335,62,13,75,0,inf
9336,52,5,57,0,inf
9337,54,12,66,0,inf
9338,53,11,64,0,inf
9339,66,9,75,0,inf
9340,55,6,61,0,inf
9341,66,5,71,0,inf
9342,63,9,72,0,inf
9343,58,11,69,0,inf
9344,57,9,66,0,inf
9345,51,9,60,0,inf
9346,58,5,63,0,inf
9347,67,5,72,0,inf
9348,66,9,75,0,inf
9349,64,11,75,0,inf
9350,62,12,74,0,inf
9351,53,5,58,0,inf
9352,64,11,75,0,inf
9353,66,11,77,0,inf
9354,64,10,74,0,inf
9355,59,10,69,0,inf
9356,66,9,75,0,inf
9357,56,9,65,0,inf
9358,66,7,73,0,inf
9359,53,11,64,0,inf
9360,66,12,78,0,inf
9361,59,7,66,0,inf
9362,55,13,68,0,inf
9363,64,12,76,0,inf
9364,53,7,60,0,inf
9365,54,5,59,0,inf
9366,60,6,66,0,inf
9367,50,12,62,0,inf
9368,67,7,74,0,inf
9369,54,11,65,0,inf
9370,64,5,69,0,inf
9371,66,12,78,0,inf
9372,54,13,67,0,inf
9373,53,6,59,0,inf
9374,60,8,68,0,inf
9375,53,12,65,0,inf
9376,52,8,60,0,inf
9377,60,11,71,0,inf
9378,57,11,68,0,inf
9379,53,6,59,0,inf
9380,52,13,65,0,inf
9381,54,5,59,0,inf
9382,56,8,64,0,inf
9383,54,11,65,0,inf
9384,59,13,72,0,inf
9385,59,5,64,0,inf
9386,60,12,72,0,inf
9387,53,6,59,0,inf
9388,61,13,74,0,inf
9389,67,9,76,0,inf
9390,59,5,64,0,inf
9391,64,11,75,0,inf
9392,51,8,59,0,inf
9393,58,11,69,0,inf
9394,51,5,56,0,inf
9395,59,11,70,0,inf
9396,62,12,74,0,inf
9397,55,8,63,1,4.788370694548988
9398,60,10,70,0,inf
9399,54,5,59,0,inf
9400,66,9,75,0,inf
9401,54,6,60,0,inf
9402,64,7,71,0,inf
9403,54,6,60,0,inf
9404,50,13,63,0,inf
9405,66,6,72,0,inf
9406,56,6,62,0,inf
9407,52,11,63,0,inf
9408,50,8,58,0,inf
9409,63,7,70,0,inf
9410,63,13,76,0,inf
9411,52,9,61,0,inf
9412,52,11,63,0,inf
9413,60,6,66,0,inf
9414,60,10,70,0,inf
9415,67,11,78,0,inf
9416,58,7,65,0,inf
9417,55,13,68,0,inf
9418,57,7,64,0,inf
9419,66,13,79,0,inf
9420,51,7,58,0,inf
9421,57,6,63,0,inf
9422,55,9,64,0,inf
9423,55,6,61,0,inf
9424,66,13,79,0,inf
9425,64,12,76,0,inf
9426,50,11,61,0,inf
9427,50,10,60,0,inf
9428,67,11,78,0,inf
9429,52,5,57,0,inf
9430,62,12,74,0,inf
9431,51,10,61,0,inf
9432,57,10,67,0,inf
9433,64,8,72,0,inf
9434,62,13,75,0,inf
9435,64,7,71,0,inf
9436,55,7,62,0,inf
9437,65,9,74,0,inf
9438,50,12,62,0,inf
9439,52,13,65,0,inf
9440,56,13,69,0,inf
9441,64,13,77,0,inf
9442,50,8,58,0,inf
9443,61,7,68,0,inf
9444,61,7,68,0,inf
9445,62,13,75,0,inf
9446,62,9,71,0,inf
9447,56,9,65,0,inf
9448,55,13,68,0,inf
9449,53,10,63,0,inf
9450,56,12,68,0,inf
9451,67,10,77,0,inf
9452,50,12,62,0,inf
9453,66,8,74,0,inf
9454,60,8,68,0,inf
9455,66,9,75,0,inf
9456,56,13,69,0,inf
9457,52,10,62,0,inf
9458,58,6,64,0,inf
9459,55,9,64,0,inf
9460,59,11,70,0,inf
9461,64,7,71,0,inf
9462,50,10,60,1,5.430200655556575
9463,50,12,62,0,inf
9464,50,5,55,0,inf
9465,56,7,63,0,inf
9466,56,8,64,0,inf
9467,55,7,62,0,inf
9468,55,7,62,0,inf
9469,61,9,70,0,inf
9470,59,6,65,1,0.2867411760859184
9471,54,9,63,0,inf
9472,57,6,63,0,inf
9473,57,6,63,0,inf
9474,53,5,58,0,inf
9475,53,10,63,0,inf
9476,67,8,75,0,inf
9477,61,8,69,0,inf
9478,51,7,58,0,inf
9479,65,9,74,0,inf
9480,50,10,60,0,inf
9481,52,12,64,0,inf
9482,51,12,63,0,inf
9483,52,8,60,0,inf
9484,52,13,65,0,inf
9485,63,6,69,0,inf
9486,63,11,74,0,inf
9487,54,7,61,0,inf
9488,64,5,69,0,inf
9489,61,13,74,0,inf
9490,59,11,70,0,inf
9491,64,8,72,0,inf
9492,53,12,65,0,inf
9493,53,10,63,0,inf
9494,63,7,70,0,inf
9495,56,8,64,0,inf
9496,64,12,76,0,inf
9497,52,11,63,0,inf
9498,63,8,71,0,inf
9499,61,8,69,0,inf
9500,55,12,67,0,inf
9501,63,5,68,0,inf
9502,64,9,73,0,inf
9503,60,7,67,0,inf
9504,58,7,65,0,inf
9505,51,11,62,0,inf
9506,51,13,64,0,inf
9507,53,5,58,0,inf
9508,63,7,70,0,inf
9509,64,7,71,0,inf
9510,66,8,74,0,inf
9511,59,11,70,0,inf
9512,55,10,65,0,inf
9513,54,6,60,0,inf
9514,50,5,55,0,inf
9515,52,7,59,0,inf
9516,50,6,56,0,inf
9517,60,13,73,0,inf
9518,56,5,61,0,inf
9519,55,13,68,0,inf
9520,66,10,76,0,inf
9521,64,11,75,0,inf
9522,65,7,72,0,inf
9523,50,6,56,0,inf
9524,62,10,72,1,8.562988507407482
9525,60,12,72,0,inf
9526,56,11,67,1,10.652203243346378
9527,57,8,65,0,inf
9528,64,9,73,0,inf
9529,55,6,61,0,inf
9530,55,7,62,0,inf
9531,55,11,66,0,inf
9532,65,11,76,0,inf
9533,67,11,78,0,inf
9534,57,7,64,0,inf
9535,62,13,75,0,inf
9536,61,7,68,0,inf
9537,66,7,73,0,inf
9538,62,9,71,1,4.846368704575468
9539,50,7,57,0,inf
9540,52,8,60,0,inf
9541,59,12,71,0,inf
9542,57,5,62,0,inf
9543,67,5,72,0,inf
9544,51,11,62,0,inf
9545,66,13,79,0,inf
9546,58,12,70,0,inf
9547,58,8,66,0,inf
9548,65,11,76,0,inf
9549,54,10,64,0,inf
9550,50,12,62,0,inf
9551,66,13,79,0,inf
9552,65,7,72,0,inf
9553,58,7,65,0,inf
9554,58,5,63,0,inf
9555,55,5,60,0,inf
9556,59,13,72,0,inf
9557,59,11,70,0,inf
9558,62,13,75,0,inf
9559,64,7,71,0,inf
9560,50,7,57,0,inf
9561,60,8,68,0,inf
9562,66,8,74,0,inf
9563,54,5,59,0,inf
9564,51,5,56,0,inf
9565,58,10,68,0,inf
9566,55,6,61,0,inf
9567,64,12,76,0,inf
9568,56,11,67,0,inf
9569,65,10,75,0,inf
9570,67,10,77,0,inf
9571,62,10,72,0,inf
9572,54,12,66,0,inf
9573,54,8,62,0,inf
9574,65,7,72,0,inf
9575,56,13,69,0,inf
9576,50,8,58,0,inf
9577,52,13,65,0,inf
9578,50,12,62,0,inf
9579,55,11,66,0,inf
9580,65,13,78,0,inf
9581,51,7,58,0,inf
9582,58,7,65,0,inf
9583,62,10,72,0,inf
9584,65,10,75,0,inf
9585,50,6,56,0,inf
9586,64,10,74,0,inf
9587,63,10,73,0,inf
9588,62,6,68,0,inf
9589,53,7,60,0,inf
9590,63,10,73,0,inf
9591,54,10,64,0,inf
9592,55,10,65,0,inf
9593,53,11,64,0,inf
9594,50,9,59,0,inf
9595,57,6,63,0,inf
9596,65,12,77,0,inf
9597,62,11,73,0,inf
9598,50,9,59,0,inf
9599,66,8,74,0,inf
9600,50,10,60,0,inf
9601,55,5,60,1,4.934113820668671
9602,64,5,69,0,inf
9603,65,9,74,1,2.4434128385015725
9604,58,12,70,0,inf
9605,58,5,63,0,inf
9606,57,6,63,0,inf
9607,61,10,71,0,inf
9608,56,13,69,0,inf
9609,58,10,68,0,inf
9610,65,12,77,0,inf
9611,60,7,67,1,1.1587704175764983
9612,58,11,69,0,inf
9613,65,11,76,0,inf
9614,64,9,73,0,inf
9615,61,5,66,0,inf
9616,62,8,70,0,inf
9617,53,7,60,0,inf
9618,65,12,77,0,inf
9619,67,13,80,0,inf
9620,60,11,71,0,inf
9621,55,13,68,0,inf
9622,52,8,60,0,inf
9623,58,12,70,0,inf
9624,64,7,71,0,inf
9625,60,13,73,0,inf
9626,54,8,62,0,inf
9627,52,11,63,0,inf
9628,62,11,73,0,inf
9629,65,11,76,0,inf
9630,55,7,62,0,inf
9631,59,10,69,0,inf
9632,58,7,65,0,inf
9633,50,8,58,0,inf
9634,59,6,65,0,inf
9635,60,9,69,0,inf
9636,60,11,71,0,inf
9637,61,10,71,0,inf
9638,58,13,71,0,inf
9639,55,13,68,0,inf
9640,53,10,63,1,1.682645079215483
9641,53,7,60,1,0.3526499047571008
9642,56,9,65,0,inf
9643,56,12,68,0,inf
9644,62,10,72,0,inf
9645,66,11,77,0,inf
9646,65,11,76,0,inf
9647,66,5,71,0,inf
9648,62,5,67,0,inf
9649,60,9,69,0,inf
9650,56,8,64,0,inf
9651,62,9,71,0,inf
9652,51,7,58,0,inf
9653,61,9,70,0,inf
9654,58,10,68,0,inf
9655,51,12,63,0,inf
9656,54,10,64,0,inf
9657,66,11,77,0,inf
9658,67,12,79,0,inf
9659,64,9,73,0,inf
9660,56,10,66,0,inf
9661,57,10,67,0,inf
9662,52,10,62,0,inf
9663,56,5,61,0,inf
9664,52,10,62,0,inf
9665,51,7,58,0,inf
9666,50,11,61,0,inf
9667,59,13,72,0,inf
9668,55,9,64,0,inf
9669,64,12,76,0,inf
9670,61,7,68,0,inf
9671,54,5,59,0,inf
9672,59,9,68,0,inf
9673,60,10,70,0,inf
9674,61,9,70,1,3.503723174657253
9675,53,5,58,0,inf
9676,55,12,67,0,inf
9677,57,7,64,0,inf
9678,55,8,63,0,inf
9679,58,8,66,0,inf
9680,56,13,69,0,inf
9681,52,10,62,0,inf
9682,60,5,65,0,inf
9683,58,5,63,0,inf
9684,52,7,59,0,inf
9685,51,6,57,0,inf
9686,57,8,65,0,inf
9687,67,5,72,0,inf
9688,57,13,70,0,inf
9689,63,12,75,0,inf
9690,61,9,70,0,inf
9691,57,5,62,0,inf
9692,59,8,67,0,inf
9693,59,11,70,0,inf
9694,60,8,68,0,inf
9695,61,5,66,0,inf
9696,56,10,66,0,inf
9697,56,11,67,0,inf
9698,60,10,70,0,inf
9699,67,6,73,0,inf
9700,50,11,61,0,inf
9701,61,10,71,0,inf
9702,62,6,68,0,inf
9703,65,5,70,0,inf
9704,53,10,63,0,inf
9705,64,8,72,0,inf
9706,56,11,67,0,inf
9707,64,5,69,0,inf
9708,61,11,72,0,inf
9709,51,10,61,0,inf
9710,58,7,65,0,inf
9711,54,10,64,0,inf
9712,57,13,70,0,inf
9713,57,8,65,0,inf
9714,66,5,71,0,inf
9715,60,5,65,0,inf
9716,66,12,78,0,inf
9717,56,8,64,0,inf
9718,64,9,73,0,inf
9719,56,10,66,0,inf
9720,62,8,70,0,inf
9721,54,8,62,0,inf
9722,51,12,63,0,inf
9723,57,7,64,0,inf
9724,65,9,74,0,inf
9725,53,13,66,0,inf
9726,61,9,70,0,inf
9727,60,5,65,0,inf
9728,56,12,68,0,inf
9729,55,12,67,0,inf
9730,61,9,70,0,inf
9731,67,12,79,0,inf
9732,51,7,58,0,inf
9733,62,13,75,0,inf
9734,52,9,61,0,inf
9735,57,8,65,0,inf
9736,54,12,66,0,inf
9737,61,8,69,0,inf
9738,54,9,63,0,inf
9739,52,5,57,0,inf
9740,58,13,71,1,10.586318540422042
9741,63,12,75,0,inf
9742,55,8,63,0,inf
9743,53,8,61,0,inf
9744,54,12,66,0,inf
9745,51,8,59,0,inf
9746,60,10,70,0,inf
9747,64,11,75,0,inf
9748,51,9,60,0,inf
9749,57,7,64,0,inf
9750,63,8,71,0,inf
9751,61,5,66,0,inf
9752,54,9,63,0,inf
9753,65,12,77,1,8.863649442082888
9754,55,13,68,0,inf
9755,64,8,72,0,inf
9756,51,6,57,0,inf
9757,58,13,71,0,inf
9758,57,6,63,0,inf
9759,55,10,65,0,inf
9760,59,8,67,0,inf
9761,61,10,71,0,inf
9762,60,11,71,0,inf
9763,55,10,65,0,inf
9764,52,8,60,0,inf
9765,65,10,75,0,inf
9766,64,13,77,0,inf
9767,56,8,64,0,inf
9768,67,5,72,0,inf
9769,63,8,71,0,inf
9770,50,12,62,0,inf
9771,64,11,75,0,inf
9772,61,13,74,0,inf
9773,65,10,75,0,inf
9774,62,5,67,0,inf
9775,64,5,69,0,inf
9776,50,5,55,0,inf
9777,55,10,65,0,inf
9778,59,9,68,0,inf
9779,57,9,66,0,inf
9780,51,13,64,0,inf
9781,51,5,56,0,inf
9782,60,9,69,0,inf
9783,51,6,57,0,inf
9784,60,12,72,0,inf
9785,58,9,67,0,inf
9786,62,13,75,0,inf
9787,54,6,60,0,inf
9788,50,11,61,0,inf
9789,63,13,76,1,6.4600841391512205
9790,55,5,60,0,inf
9791,60,6,66,0,inf
9792,60,7,67,0,inf
9793,50,6,56,0,inf
9794,56,11,67,0,inf
9795,58,11,69,0,inf
9796,58,6,64,0,inf
9797,58,11,69,1,8.967613693290971
9798,59,11,70,0,inf
9799,63,8,71,0,inf
9800,55,11,66,0,inf
9801,66,9,75,0,inf
9802,62,11,73,0,inf
9803,50,9,59,0,inf
9804,54,5,59,0,inf
9805,52,13,65,0,inf
9806,52,13,65,0,inf
9807,64,7,71,0,inf
9808,51,11,62,0,inf
9809,50,12,62,0,inf
9810,56,12,68,0,inf
9811,66,6,72,0,inf
9812,55,8,63,1,5.129759045732115
9813,54,12,66,0,inf
9814,65,8,73,0,inf
9815,60,8,68,0,inf
9816,62,9,71,0,inf
9817,54,9,63,0,inf
9818,60,6,66,0,inf
9819,65,12,77,0,inf
9820,56,9,65,0,inf
9821,57,9,66,0,inf
9822,58,6,64,0,inf
9823,53,9,62,0,inf
9824,59,6,65,0,inf
9825,65,9,74,0,inf
9826,63,10,73,0,inf
9827,55,7,62,0,inf
9828,58,13,71,0,inf
9829,59,10,69,0,inf
9830,65,8,73,0,inf
9831,62,9,71,0,inf
9832,54,5,59,0,inf
9833,52,7,59,0,inf
9834,57,13,70,0,inf
9835,54,7,61,0,inf
9836,60,10,70,0,inf
9837,65,13,78,0,inf
9838,65,13,78,0,inf
9839,55,11,66,0,inf
9840,61,5,66,0,inf
9841,58,10,68,0,inf
9842,60,12,72,0,inf
9843,62,9,71,0,inf
9844,64,12,76,0,inf
9845,53,9,62,0,inf
9846,67,5,72,0,inf
9847,61,6,67,0,inf
9848,53,11,64,0,inf
9849,63,12,75,0,inf
9850,54,11,65,0,inf
9851,57,9,66,0,inf
9852,64,10,74,0,inf
9853,67,6,73,0,inf
9854,61,12,73,0,inf
9855,56,9,65,0,inf
9856,64,7,71,0,inf
9857,59,6,65,0,inf
9858,61,5,66,0,inf
9859,65,9,74,0,inf
9860,60,10,70,0,inf
9861,60,8,68,0,inf
9862,66,7,73,0,inf
9863,56,5,61,0,inf
9864,54,5,59,0,inf
9865,51,12,63,0,inf
9866,61,13,74,0,inf
9867,53,6,59,0,inf
9868,52,10,62,0,inf
9869,55,8,63,0,inf
9870,62,8,70,0,inf
9871,57,7,64,0,inf
9872,51,8,59,0,inf
9873,62,6,68,0,inf
9874,64,6,70,1,3.2983698389183473
9875,53,13,66,0,inf
9876,54,12,66,0,inf
9877,54,7,61,0,inf
9878,62,11,73,0,inf
9879,60,5,65,0,inf
9880,55,8,63,0,inf
9881,60,6,66,0,inf
9882,65,12,77,0,inf
9883,56,5,61,0,inf
9884,62,8,70,0,inf
9885,55,10,65,0,inf
9886,65,6,71,0,inf
9887,67,6,73,0,inf
9888,64,6,70,0,inf
9889,60,11,71,0,inf
9890,65,12,77,0,inf
9891,61,5,66,0,inf
9892,60,12,72,0,inf
9893,56,13,69,0,inf
9894,57,9,66,0,inf
9895,53,6,59,0,inf
9896,59,9,68,0,inf
9897,52,5,57,0,inf
9898,64,9,73,0,inf
9899,59,13,72,0,inf
9900,55,10,65,0,inf
9901,62,11,73,0,inf
9902,61,12,73,0,inf
9903,59,13,72,0,inf
9904,53,8,61,0,inf
9905,54,5,59,0,inf
9906,64,10,74,0,inf
9907,65,6,71,0,inf
9908,65,9,74,0,inf
9909,54,5,59,0,inf
9910,63,9,72,0,inf
9911,63,11,74,0,inf
9912,54,9,63,0,inf
9913,64,6,70,0,inf
9914,65,13,78,0,inf
9915,60,10,70,0,inf
9916,57,6,63,0,inf
9917,57,8,65,0,inf
9918,62,12,74,0,inf
9919,57,12,69,0,inf
9920,55,9,64,0,inf
9921,58,12,70,0,inf
9922,63,13,76,0,inf
9923,63,6,69,0,inf
9924,62,8,70,0,inf
9925,64,11,75,0,inf
9926,60,9,69,0,inf
9927,53,5,58,0,inf
9928,66,9,75,0,inf
9929,67,11,78,1,7.645436501195064
9930,67,10,77,1,9.900289534081267
9931,60,8,68,0,inf
9932,57,5,62,0,inf
9933,54,10,64,0,inf
9934,67,5,72,0,inf
9935,52,11,63,0,inf
9936,61,7,68,0,inf
9937,63,5,68,0,inf
9938,62,13,75,0,inf
9939,53,9,62,0,inf
9940,52,12,64,0,inf
9941,66,7,73,0,inf
9942,66,5,71,0,inf
9943,58,9,67,0,inf
9944,52,13,65,0,inf
9945,63,10,73,0,inf
9946,67,9,76,0,inf
9947,57,5,62,0,inf
9948,61,5,66,0,inf
9949,53,8,61,0,inf
9950,65,5,70,0,inf
9951,50,10,60,0,inf
9952,60,13,73,0,inf
9953,59,8,67,0,inf
9954,67,12,79,0,inf
9955,62,6,68,0,inf
9956,54,10,64,0,inf
9957,50,11,61,0,inf
9958,61,10,71,0,inf
9959,57,8,65,0,inf
9960,64,12,76,0,inf
9961,58,10,68,0,inf
9962,60,9,69,0,inf
9963,60,11,71,1,6.541668098732401
9964,66,10,76,0,inf
9965,53,6,59,0,inf
9966,59,6,65,0,inf
9967,56,10,66,0,inf
9968,57,10,67,0,inf
9969,56,12,68,0,inf
9970,60,9,69,0,inf
9971,63,10,73,0,inf
9972,50,13,63,0,inf
9973,59,8,67,0,inf
9974,65,11,76,0,inf
9975,62,6,68,0,inf
9976,57,12,69,0,inf
9977,50,7,57,0,inf
9978,50,5,55,0,inf
9979,51,7,58,0,inf
9980,59,10,69,0,inf
9981,50,5,55,0,inf
9982,59,8,67,0,inf
9983,51,7,58,0,inf
9984,62,6,68,0,inf
9985,56,7,63,0,inf
9986,56,7,63,0,inf
9987,52,8,60,0,inf
9988,57,11,68,0,inf
9989,54,10,64,0,inf
9990,51,12,63,1,7.991084087014855
9991,64,6,70,1,2.9865781074247906
9992,56,6,62,0,inf
9993,54,13,67,0,inf
9994,60,6,66,0,inf
9995,60,12,72,0,inf
9996,58,12,70,0,inf
9997,53,5,58,0,inf
9998,53,8,61,0,inf
9999,52,13,65,0,inf
10000,63,10,73,0,inf
10001,52,10,62,0,inf
10002,65,6,71,0,inf
10003,66,8,74,0,inf
10004,50,13,63,0,inf
10005,66,10,76,0,inf
10006,52,7,59,0,inf
10007,53,11,64,0,inf
10008,63,11,74,0,inf
10009,65,7,72,0,inf
10010,63,12,75,0,inf
10011,57,11,68,0,inf
10012,58,7,65,0,inf
10013,59,8,67,0,inf
10014,59,7,66,0,inf
10015,53,6,59,0,inf
10016,57,6,63,0,inf
10017,53,6,59,0,inf
10018,58,5,63,0,inf
10019,58,5,63,0,inf
10020,55,8,63,0,inf
10021,63,7,70,0,inf
10022,65,10,75,0,inf
10023,65,11,76,0,inf
10024,60,9,69,1,8.975255237549277
10025,52,12,64,0,inf
10026,56,13,69,1,4.84454073358215
10027,59,8,67,0,inf
10028,57,13,70,0,inf
10029,53,9,62,0,inf
10030,67,5,72,0,inf
10031,67,10,77,0,inf
10032,67,9,76,0,inf
10033,56,8,64,0,inf
10034,58,13,71,0,inf
10035,57,9,66,0,inf
10036,50,7,57,0,inf
10037,63,13,76,0,inf
10038,65,13,78,0,inf
10039,56,5,61,0,inf
10040,59,8,67,0,inf
10041,50,12,62,0,inf
10042,67,6,73,0,inf
10043,64,9,73,0,inf
10044,52,10,62,0,inf
10045,64,5,69,0,inf
10046,56,11,67,0,inf
10047,50,10,60,0,inf
10048,58,7,65,0,inf
10049,58,9,67,0,inf
10050,60,12,72,0,inf
10051,59,11,70,0,inf
10052,66,11,77,0,inf
10053,66,11,77,0,inf
10054,66,12,78,0,inf
10055,54,8,62,0,inf
10056,53,11,64,0,inf
10057,50,10,60,0,inf
10058,67,13,80,0,inf
10059,53,6,59,0,inf
10060,56,9,65,0,inf
10061,53,11,64,0,inf
10062,67,10,77,0,inf
10063,65,12,77,0,inf
10064,63,7,70,0,inf
10065,67,11,78,0,inf
10066,60,10,70,0,inf
10067,67,10,77,0,inf
10068,62,13,75,0,inf
10069,59,13,72,0,inf
10070,54,10,64,0,inf
10071,53,12,65,0,inf
10072,53,5,58,0,inf
10073,55,9,64,0,inf
10074,64,9,73,0,inf
10075,67,7,74,0,inf
10076,64,9,73,0,inf
10077,59,5,64,0,inf
10078,64,12,76,0,inf
10079,62,6,68,0,inf
10080,66,7,73,0,inf
10081,65,10,75,0,inf
10082,59,8,67,0,inf
10083,60,7,67,0,inf
10084,55,11,66,0,inf
10085,67,8,75,0,inf
10086,60,12,72,1,1.0101042929712136
10087,61,9,70,0,inf
10088,50,7,57,0,inf
10089,67,5,72,0,inf
10090,62,6,68,0,inf
10091,58,13,71,0,inf
10092,52,11,63,0,inf
10093,54,12,66,0,inf
10094,58,12,70,0,inf
10095,60,10,70,0,inf
10096,61,12,73,0,inf
10097,54,8,62,0,inf
10098,53,5,58,0,inf
10099,56,11,67,0,inf
10100,62,5,67,0,inf
10101,51,7,58,0,inf
10102,53,8,61,1,1.7976516500031607
10103,57,11,68,0,inf
10104,59,10,69,0,inf
10105,53,8,61,0,inf
10106,54,7,61,0,inf
10107,63,12,75,0,inf
10108,63,6,69,0,inf
10109,56,6,62,0,inf
10110,60,12,72,0,inf
10111,54,6,60,0,inf
10112,56,5,61,0,inf
10113,54,13,67,0,inf
10114,58,11,69,0,inf
10115,52,9,61,0,inf
10116,60,11,71,0,inf
10117,60,5,65,0,inf
10118,54,11,65,0,inf
10119,51,12,63,0,inf
10120,66,10,76,0,inf
10121,52,9,61,0,inf
10122,52,9,61,0,inf
10123,55,10,65,0,inf
10124,64,13,77,0,inf
10125,66,6,72,0,inf
10126,52,6,58,0,inf
10127,65,9,74,0,inf
10128,60,13,73,0,inf
10129,53,11,64,0,inf
10130,65,10,75,0,inf
10131,56,8,64,0,inf
10132,58,10,68,0,inf
10133,62,8,70,0,inf
10134,54,8,62,0,inf
10135,60,6,66,0,inf
10136,55,6,61,0,inf
10137,58,11,69,0,inf
10138,56,13,69,0,inf
10139,50,10,60,0,inf
10140,52,7,59,0,inf
10141,57,13,70,0,inf
10142,61,11,72,0,inf
10143,62,7,69,0,inf
10144,63,6,69,0,inf
10145,53,10,63,0,inf
10146,60,5,65,0,inf
10147,61,7,68,0,inf
10148,53,7,60,0,inf
10149,57,12,69,0,inf
10150,52,11,63,0,inf
10151,55,6,61,0,inf
10152,67,9,76,0,inf
10153,59,12,71,0,inf
10154,65,12,77,0,inf
10155,63,13,76,0,inf
10156,57,6,63,0,inf
10157,65,13,78,0,inf
10158,60,13,73,0,inf
10159,53,10,63,0,inf
10160,60,5,65,0,inf
10161,55,5,60,0,inf
10162,55,6,61,0,inf
10163,54,8,62,0,inf
10164,51,7,58,0,inf
10165,53,9,62,0,inf
10166,56,6,62,0,inf
10167,59,11,70,0,inf
10168,62,12,74,0,inf
10169,66,8,74,0,inf
10170,57,7,64,0,inf
10171,63,13,76,0,inf
10172,50,10,60,0,inf
10173,62,8,70,0,inf
10174,64,11,75,0,inf
10175,67,10,77,0,inf
10176,61,7,68,0,inf
10177,54,6,60,0,inf
10178,58,6,64,1,3.343023784235946
10179,57,10,67,0,inf
10180,60,6,66,0,inf
10181,57,10,67,0,inf
10182,53,8,61,0,inf
10183,50,8,58,0,inf
10184,51,10,61,0,inf
10185,59,9,68,0,inf
10186,66,11,77,0,inf
10187,61,13,74,0,inf
10188,58,9,67,0,inf
10189,57,7,64,0,inf
10190,55,8,63,0,inf
10191,62,11,73,0,inf
10192,58,8,66,0,inf
10193,61,10,71,0,inf
10194,57,6,63,0,inf
10195,67,13,80,0,inf
10196,60,11,71,0,inf
10197,61,10,71,0,inf
10198,53,8,61,0,inf
10199,56,8,64,0,inf
10200,52,10,62,0,inf
10201,53,8,61,0,inf
10202,61,11,72,0,inf
10203,52,7,59,0,inf
10204,59,6,65,0,inf
10205,61,5,66,0,inf
10206,58,5,63,0,inf
10207,54,7,61,0,inf
10208,54,12,66,0,inf
10209,65,7,72,0,inf
10210,63,11,74,0,inf
10211,61,7,68,0,inf
10212,58,13,71,0,inf
10213,50,8,58,0,inf
10214,53,13,66,0,inf
10215,54,9,63,0,inf
10216,65,11,76,0,inf
10217,66,7,73,0,inf
10218,62,13,75,0,inf
10219,53,9,62,0,inf
10220,57,5,62,0,inf
10221,55,11,66,0,inf
10222,59,13,72,1,8.382923292877223
10223,58,10,68,0,inf
10224,55,11,66,0,inf
10225,53,5,58,0,inf
10226,56,5,61,0,inf
10227,58,6,64,0,inf
10228,54,6,60,0,inf
10229,67,11,78,1,0.49026690894439184
10230,60,6,66,0,inf
10231,55,8,63,0,inf
10232,63,10,73,0,inf
10233,55,13,68,0,inf
10234,63,7,70,0,inf
10235,58,8,66,0,inf
10236,57,11,68,0,inf
10237,51,7,58,0,inf
10238,63,11,74,0,inf
10239,56,12,68,1,1.9057275632130057
10240,67,6,73,0,inf
10241,53,12,65,0,inf
10242,60,10,70,0,inf
10243,61,9,70,0,inf
10244,66,11,77,0,inf
10245,66,5,71,0,inf
10246,62,12,74,0,inf
10247,51,8,59,0,inf
10248,54,11,65,0,inf
10249,50,6,56,0,inf
10250,60,11,71,0,inf
10251,57,7,64,0,inf
10252,64,7,71,0,inf
10253,57,10,67,1,6.357372521005715
10254,64,13,77,0,inf
10255,57,10,67,0,inf
10256,54,8,62,0,inf
10257,63,12,75,0,inf
10258,58,5,63,0,inf
10259,63,7,70,0,inf
10260,51,7,58,0,inf
10261,67,10,77,0,inf
10262,55,9,64,0,inf
10263,51,13,64,0,inf
10264,64,10,74,0,inf
10265,52,7,59,0,inf
10266,60,6,66,0,inf
10267,61,8,69,0,inf
10268,63,9,72,0,inf
10269,57,10,67,0,inf
10270,67,13,80,0,inf
10271,58,11,69,0,inf
10272,59,6,65,0,inf
10273,51,5,56,0,inf
10274,60,12,72,0,inf
10275,59,13,72,0,inf
10276,61,5,66,0,inf
10277,60,13,73,0,inf
10278,57,5,62,0,inf
10279,52,5,57,0,inf
10280,53,8,61,0,inf
10281,59,9,68,0,inf
10282,53,13,66,0,inf
10283,63,6,69,0,inf
10284,64,10,74,0,inf
10285,53,7,60,0,inf
10286,63,11,74,0,inf
10287,58,5,63,0,inf
10288,56,5,61,0,inf
10289,61,6,67,0,inf
10290,60,8,68,0,inf
10291,61,7,68,0,inf
10292,55,8,63,0,inf
10293,62,12,74,0,inf
10294,59,12,71,0,inf
10295,56,9,65,0,inf
10296,62,12,74,0,inf
10297,63,11,74,0,inf
10298,62,8,70,0,inf
10299,67,13,80,1,3.833076302029184
10300,50,9,59,1,6.620785886467765
10301,61,5,66,0,inf
10302,60,8,68,0,inf
10303,50,7,57,0,inf
10304,52,10,62,0,inf
10305,54,10,64,1,5.234809428348228
10306,67,8,75,0,inf
10307,58,9,67,0,inf
10308,63,11,74,0,inf
10309,57,13,70,0,inf
10310,57,7,64,0,inf
10311,51,11,62,0,inf
10312,58,7,65,0,inf
10313,67,6,73,0,inf
10314,58,7,65,0,inf
10315,67,5,72,0,inf
10316,54,13,67,0,inf
10317,55,6,61,0,inf
10318,67,9,76,0,inf
10319,67,10,77,0,inf
10320,62,12,74,0,inf
10321,56,8,64,0,inf
10322,63,5,68,0,inf
10323,62,7,69,0,inf
10324,50,12,62,0,inf
10325,64,11,75,0,inf
10326,59,10,69,0,inf
10327,63,7,70,0,inf
10328,57,12,69,0,inf
10329,58,5,63,0,inf
10330,66,5,71,0,inf
10331,57,7,64,0,inf
10332,50,10,60,0,inf
10333,65,8,73,0,inf
10334,57,10,67,0,inf
10335,62,9,71,0,inf
10336,67,11,78,0,inf
10337,67,7,74,0,inf
10338,64,10,74,0,inf
10339,52,12,64,0,inf
10340,58,8,66,0,inf
10341,63,6,69,0,inf
10342,60,7,67,0,inf
10343,60,12,72,0,inf
10344,55,8,63,0,inf
10345,64,5,69,0,inf
10346,52,10,62,0,inf
10347,57,13,70,0,inf
10348,62,9,71,0,inf
10349,57,13,70,0,inf
10350,51,7,58,0,inf
10351,53,7,60,0,inf
10352,55,12,67,0,inf
10353,64,8,72,0,inf
10354,59,13,72,0,inf
10355,61,10,71,0,inf
10356,60,7,67,0,inf
10357,65,10,75,0,inf
10358,51,9,60,0,inf
10359,55,5,60,0,inf
10360,62,10,72,0,inf
10361,58,9,67,0,inf
10362,58,9,67,0,inf
10363,53,9,62,0,inf
10364,62,7,69,0,inf
10365,60,8,68,0,inf
10366,54,9,63,0,inf
10367,56,6,62,0,inf
10368,54,8,62,0,inf
10369,64,12,76,0,inf
10370,51,5,56,0,inf
10371,58,10,68,0,inf
10372,61,11,72,0,inf
10373,67,9,76,0,inf
10374,51,6,57,0,inf
10375,57,13,70,0,inf
10376,56,6,62,0,inf
10377,67,5,72,0,inf
10378,53,10,63,0,inf
10379,61,12,73,0,inf
10380,60,5,65,0,inf
10381,66,8,74,0,inf
10382,50,9,59,0,inf
10383,52,9,61,0,inf
10384,54,8,62,0,inf
10385,59,5,64,0,inf
10386,53,9,62,0,inf
10387,56,5,61,0,inf
10388,62,10,72,0,inf
10389,52,6,58,0,inf
10390,55,10,65,0,inf
10391,58,11,69,0,inf
10392,63,5,68,0,inf
10393,61,5,66,0,inf
10394,60,7,67,0,inf
10395,62,9,71,0,inf
10396,55,6,61,0,inf
10397,51,10,61,0,inf
10398,59,12,71,0,inf
10399,61,9,70,1,5.772238109426823
10400,53,11,64,0,inf
10401,63,6,69,0,inf
10402,57,5,62,0,inf
10403,59,6,65,0,inf
10404,60,10,70,0,inf
10405,58,7,65,0,inf
10406,50,8,58,0,inf
10407,53,5,58,0,inf
10408,64,12,76,0,inf
10409,67,12,79,0,inf
10410,58,8,66,0,inf
10411,58,11,69,0,inf
10412,53,8,61,0,inf
10413,63,13,76,0,inf
10414,54,7,61,0,inf
10415,59,10,69,0,inf
10416,64,10,74,0,inf
10417,61,10,71,0,inf
10418,51,12,63,0,inf
10419,60,7,67,0,inf
10420,66,5,71,0,inf
10421,64,12,76,0,inf
10422,59,8,67,0,inf
10423,61,6,67,1,1.6856217785194616
10424,60,12,72,0,inf
10425,58,6,64,0,inf
10426,64,10,74,0,inf
10427,65,12,77,0,inf
10428,63,11,74,0,inf
10429,60,12,72,0,inf
10430,58,9,67,0,inf
10431,60,11,71,0,inf
10432,58,9,67,0,inf
10433,60,6,66,0,inf
10434,60,11,71,0,inf
10435,56,10,66,0,inf
10436,58,6,64,0,inf
10437,59,5,64,0,inf
10438,57,7,64,0,inf
10439,67,7,74,0,inf
10440,55,9,64,0,inf
10441,56,10,66,0,inf
10442,65,13,78,0,inf
10443,64,9,73,0,inf
10444,58,9,67,0,inf
10445,52,11,63,0,inf
10446,54,13,67,0,inf
10447,51,10,61,0,inf
10448,65,5,70,0,inf
10449,51,13,64,0,inf
10450,57,9,66,0,inf
10451,61,7,68,0,inf
10452,51,11,62,0,inf
10453,52,5,57,0,inf
10454,62,10,72,0,inf
10455,53,7,60,0,inf
10456,60,13,73,0,inf
10457,60,5,65,0,inf
10458,65,13,78,0,inf
10459,50,10,60,0,inf
10460,53,6,59,0,inf
10461,67,5,72,0,inf
10462,55,10,65,0,inf
10463,67,8,75,0,inf
10464,50,11,61,0,inf
10465,63,7,70,0,inf
10466,55,5,60,0,inf
10467,58,13,71,0,inf
10468,50,10,60,0,inf
10469,52,13,65,0,inf
10470,54,5,59,0,inf
10471,55,6,61,0,inf
10472,51,7,58,0,inf
10473,57,10,67,0,inf
10474,66,9,75,0,inf
10475,65,6,71,0,inf
10476,52,13,65,0,inf
10477,51,5,56,0,inf
10478,53,8,61,0,inf
10479,66,7,73,0,inf
10480,67,7,74,0,inf
10481,63,10,73,1,6.968449818435374
10482,51,11,62,0,inf
10483,54,7,61,0,inf
10484,55,13,68,0,inf
10485,59,5,64,0,inf
10486,59,8,67,0,inf
10487,61,9,70,0,inf
10488,52,10,62,0,inf
10489,63,12,75,0,inf
10490,66,8,74,0,inf
10491,59,5,64,0,inf
10492,62,7,69,0,inf
10493,65,13,78,0,inf
10494,51,8,59,0,inf
10495,57,8,65,1,4.908304410761751
10496,52,6,58,1,0.7252092893488538
10497,53,13,66,0,inf
10498,67,9,76,0,inf
10499,63,13,76,1,2.4512589914810547
10500,63,9,72,1,6.176533085326966
10501,67,12,79,0,inf
10502,50,6,56,0,inf
10503,60,11,71,0,inf
10504,54,6,60,0,inf
10505,63,7,70,0,inf
10506,66,11,77,0,inf
10507,67,8,75,0,inf
10508,50,12,62,1,10.421266775204877
10509,55,8,63,0,inf
10510,64,8,72,0,inf
10511,55,5,60,0,inf
10512,52,8,60,0,inf
10513,54,11,65,0,inf
10514,55,10,65,0,inf
10515,56,7,63,0,inf
10516,58,10,68,1,9.727663167445641
10517,59,11,70,0,inf
10518,65,6,71,0,inf
10519,62,8,70,0,inf
10520,67,7,74,0,inf
10521,66,13,79,0,inf
10522,54,11,65,0,inf
10523,50,8,58,0,inf
10524,56,9,65,0,inf
10525,67,8,75,0,inf
10526,57,11,68,0,inf
10527,58,5,63,0,inf
10528,66,5,71,0,inf
10529,64,11,75,0,inf
10530,67,12,79,0,inf
10531,65,8,73,0,inf
10532,67,11,78,0,inf
10533,66,5,71,0,inf
10534,63,5,68,0,inf
10535,53,11,64,0,inf
10536,66,10,76,0,inf
10537,51,8,59,0,inf
10538,60,6,66,0,inf
10539,59,13,72,0,inf
10540,57,11,68,0,inf
10541,55,9,64,0,inf
10542,60,9,69,0,inf
10543,64,5,69,0,inf
10544,67,12,79,0,inf
10545,57,6,63,0,inf
10546,52,6,58,0,inf
10547,62,5,67,0,inf
10548,51,13,64,0,inf
10549,65,13,78,0,inf
10550,56,11,67,0,inf
10551,61,5,66,0,inf
10552,55,8,63,0,inf
10553,50,13,63,0,inf
10554,65,8,73,0,inf
10555,52,8,60,0,inf
10556,63,9,72,0,inf
10557,60,7,67,0,inf
10558,54,10,64,0,inf
10559,60,5,65,0,inf
10560,55,9,64,0,inf
10561,53,10,63,0,inf
10562,56,12,68,1,8.491842122556662
10563,62,10,72,0,inf
10564,60,6,66,0,inf
10565,51,9,60,0,inf
10566,67,11,78,0,inf
10567,61,12,73,1,1.9552572971372228
10568,65,5,70,0,inf
10569,63,6,69,1,4.862269203773479
10570,51,10,61,0,inf
10571,64,12,76,0,inf
10572,62,9,71,0,inf
10573,60,8,68,0,inf
10574,63,7,70,0,inf
10575,67,5,72,0,inf
10576,60,13,73,0,inf
10577,63,8,71,0,inf
10578,50,11,61,0,inf
10579,50,13,63,0,inf
10580,62,8,70,0,inf
10581,67,11,78,0,inf
10582,55,9,64,0,inf
10583,65,12,77,0,inf
10584,56,5,61,0,inf
10585,57,11,68,0,inf
10586,62,12,74,0,inf
10587,57,11,68,0,inf
10588,57,7,64,0,inf
10589,62,5,67,0,inf
10590,60,5,65,0,inf
10591,55,10,65,0,inf
10592,67,10,77,0,inf
10593,63,8,71,0,inf
10594,58,13,71,0,inf
10595,58,13,71,0,inf
10596,61,6,67,0,inf
10597,59,7,66,1,2.3748995472468692
10598,56,5,61,0,inf
10599,66,10,76,1,6.937469235004826
10600,62,10,72,0,inf
10601,52,11,63,0,inf
10602,57,10,67,0,inf
10603,54,8,62,0,inf
10604,67,5,72,0,inf
10605,64,10,74,0,inf
10606,60,5,65,1,4.216623152053074
10607,67,10,77,0,inf
10608,60,5,65,0,inf
10609,50,8,58,0,inf
10610,59,8,67,0,inf
10611,57,6,63,0,inf
10612,51,7,58,0,inf
10613,55,6,61,0,inf
10614,65,10,75,0,inf
10615,64,10,74,0,inf
10616,55,12,67,0,inf
10617,56,7,63,0,inf
10618,64,5,69,0,inf
10619,58,6,64,0,inf
10620,62,7,69,0,inf
10621,50,10,60,0,inf
10622,66,8,74,0,inf
10623,50,9,59,0,inf
10624,65,5,70,0,inf
10625,51,11,62,0,inf
10626,62,12,74,0,inf
10627,64,10,74,0,inf
10628,60,10,70,0,inf
10629,64,8,72,0,inf
10630,57,6,63,0,inf
10631,63,7,70,0,inf
10632,51,6,57,0,inf
10633,51,7,58,0,inf
10634,63,8,71,0,inf
10635,51,9,60,0,inf
10636,66,6,72,0,inf
10637,64,12,76,0,inf
10638,60,7,67,0,inf
10639,51,7,58,0,inf
10640,62,8,70,0,inf
10641,66,9,75,0,inf
10642,62,6,68,0,inf
10643,55,11,66,1,10.620494688510036
10644,58,8,66,0,inf
10645,52,5,57,0,inf
10646,55,13,68,0,inf
10647,55,13,68,0,inf
10648,60,7,67,0,inf
10649,56,10,66,0,inf
10650,60,6,66,0,inf
10651,58,13,71,0,inf
10652,55,5,60,0,inf
10653,62,5,67,0,inf
10654,54,11,65,0,inf
10655,52,11,63,0,inf
10656,67,11,78,0,inf
10657,66,13,79,0,inf
10658,60,6,66,0,inf
10659,57,9,66,0,inf
10660,53,7,60,0,inf
10661,60,8,68,0,inf
10662,53,7,60,0,inf
10663,54,7,61,0,inf
10664,57,13,70,0,inf
10665,60,8,68,0,inf
10666,63,13,76,0,inf
10667,63,9,72,0,inf
10668,51,11,62,0,inf
10669,67,5,72,0,inf
10670,64,13,77,0,inf
10671,53,12,65,0,inf
10672,50,5,55,0,inf
10673,58,10,68,0,inf
10674,65,8,73,0,inf
10675,53,12,65,0,inf
10676,53,5,58,0,inf
10677,51,5,56,0,inf
10678,56,11,67,0,inf
10679,50,13,63,0,inf
10680,63,5,68,0,inf
10681,63,12,75,0,inf
10682,63,6,69,0,inf
10683,53,6,59,0,inf
10684,54,9,63,0,inf
10685,52,11,63,0,inf
10686,57,9,66,0,inf
10687,65,7,72,0,inf
10688,60,7,67,0,inf
10689,58,9,67,0,inf
10690,59,8,67,0,inf
10691,50,8,58,0,inf
10692,51,13,64,0,inf
10693,61,9,70,0,inf
10694,64,11,75,0,inf
10695,53,8,61,0,inf
10696,59,12,71,1,6.341343628783889
10697,52,6,58,0,inf
10698,54,11,65,0,inf
10699,60,11,71,0,inf
10700,64,10,74,0,inf
10701,54,12,66,0,inf
10702,63,9,72,0,inf
10703,66,13,79,0,inf
10704,50,7,57,0,inf
10705,66,5,71,0,inf
10706,52,9,61,0,inf
10707,50,5,55,0,inf
10708,66,8,74,0,inf
10709,59,10,69,0,inf
10710,54,12,66,0,inf
10711,65,6,71,0,inf
10712,65,8,73,0,inf
10713,52,6,58,0,inf
10714,58,7,65,0,inf
10715,64,13,77,0,inf
10716,66,9,75,0,inf
10717,65,9,74,0,inf
10718,66,12,78,0,inf
10719,55,10,65,0,inf
10720,66,8,74,0,inf
10721,54,12,66,0,inf
10722,66,12,78,0,inf
10723,52,5,57,0,inf
10724,57,13,70,0,inf
10725,57,7,64,0,inf
10726,66,7,73,0,inf
10727,56,13,69,0,inf
10728,53,13,66,0,inf
10729,62,9,71,0,inf
10730,67,11,78,0,inf
10731,62,11,73,0,inf
10732,63,9,72,0,inf
10733,64,11,75,0,inf
10734,58,5,63,0,inf
10735,66,11,77,0,inf
10736,51,5,56,0,inf
10737,50,6,56,0,inf
10738,63,12,75,0,inf
10739,50,13,63,0,inf
10740,67,12,79,0,inf
10741,67,11,78,0,inf
10742,66,13,79,0,inf
10743,65,13,78,0,inf
10744,64,5,69,0,inf
10745,56,11,67,0,inf
10746,57,6,63,0,inf
10747,51,10,61,0,inf
10748,63,8,71,0,inf
10749,56,7,63,1,2.377645735915273
10750,59,6,65,0,inf
10751,56,6,62,0,inf
10752,65,8,73,0,inf
10753,66,7,73,0,inf
10754,53,8,61,0,inf
10755,53,7,60,0,inf
10756,61,9,70,0,inf
10757,51,6,57,0,inf
10758,53,8,61,0,inf
10759,60,12,72,0,inf
10760,62,8,70,0,inf
10761,59,10,69,0,inf
10762,63,13,76,0,inf
10763,66,12,78,0,inf
10764,66,12,78,0,inf
10765,54,7,61,0,inf
10766,64,9,73,0,inf
10767,50,7,57,0,inf
10768,52,7,59,0,inf
10769,57,11,68,0,inf
10770,67,9,76,0,inf
10771,53,9,62,0,inf
10772,61,8,69,0,inf
10773,61,7,68,0,inf
10774,52,5,57,0,inf
10775,60,5,65,0,inf
10776,63,10,73,0,inf
10777,57,5,62,0,inf
10778,64,9,73,0,inf
10779,62,12,74,0,inf
10780,57,5,62,0,inf
10781,66,7,73,0,inf
10782,63,6,69,0,inf
10783,51,9,60,0,inf
10784,57,11,68,0,inf
10785,63,7,70,0,inf
10786,60,10,70,0,inf
10787,60,11,71,0,inf
10788,65,5,70,0,inf
10789,65,11,76,0,inf
10790,65,5,70,0,inf
10791,55,12,67,0,inf
10792,67,6,73,0,inf
10793,57,10,67,0,inf
10794,55,10,65,0,inf
10795,58,7,65,0,inf
10796,62,7,69,0,inf
10797,55,10,65,0,inf
10798,58,12,70,0,inf
10799,51,10,61,0,inf
10800,57,7,64,1,5.390774357390185
10801,54,6,60,0,inf
10802,57,11,68,0,inf
10803,65,13,78,0,inf
10804,59,9,68,0,inf
10805,53,9,62,0,inf
10806,52,10,62,0,inf
10807,58,10,68,0,inf
10808,50,11,61,0,inf
10809,60,12,72,0,inf
10810,56,10,66,0,inf
10811,65,11,76,0,inf
10812,57,11,68,0,inf
10813,64,12,76,0,inf
10814,51,6,57,0,inf
10815,50,9,59,0,inf
10816,59,11,70,0,inf
10817,65,6,71,0,inf
10818,57,9,66,0,inf
10819,62,12,74,1,8.424993972992752
10820,58,13,71,0,inf
10821,53,6,59,0,inf
10822,59,9,68,0,inf
10823,63,10,73,0,inf
10824,52,6,58,0,inf
10825,58,13,71,0,inf
10826,65,9,74,1,2.7874722022322374
10827,64,10,74,0,inf
10828,51,11,62,0,inf
10829,59,8,67,0,inf
10830,64,8,72,0,inf
10831,60,10,70,0,inf
10832,57,8,65,0,inf
10833,52,5,57,0,inf
10834,50,12,62,0,inf
10835,55,5,60,0,inf
10836,65,11,76,0,inf
10837,66,12,78,0,inf
10838,66,10,76,1,7.049987868684383
10839,66,7,73,0,inf
10840,64,5,69,0,inf
10841,58,10,68,0,inf
10842,59,6,65,0,inf
10843,56,6,62,0,inf
10844,61,9,70,0,inf
10845,53,5,58,0,inf
10846,59,12,71,0,inf
10847,56,13,69,0,inf
10848,57,12,69,0,inf
10849,61,8,69,1,6.20666559662881
10850,51,12,63,0,inf
10851,62,5,67,0,inf
10852,51,6,57,0,inf
10853,53,10,63,0,inf
10854,61,8,69,0,inf
10855,52,9,61,0,inf
10856,61,7,68,0,inf
10857,65,13,78,0,inf
10858,56,9,65,0,inf
10859,56,12,68,0,inf
10860,59,5,64,0,inf
10861,65,8,73,0,inf
10862,62,13,75,0,inf
10863,66,9,75,0,inf
10864,57,12,69,0,inf
10865,58,7,65,0,inf
10866,58,7,65,0,inf
10867,50,8,58,0,inf
10868,66,10,76,0,inf
10869,63,10,73,0,inf
10870,58,9,67,0,inf
10871,54,8,62,0,inf
10872,55,6,61,0,inf
10873,62,12,74,1,10.262938516494785
10874,50,10,60,0,inf
10875,54,11,65,0,inf
10876,65,11,76,0,inf
10877,67,7,74,0,inf
10878,65,9,74,0,inf
10879,58,11,69,0,inf
10880,62,10,72,0,inf
10881,66,6,72,0,inf
10882,52,12,64,0,inf
10883,53,5,58,0,inf
10884,51,5,56,0,inf
10885,59,5,64,0,inf
10886,66,8,74,0,inf
10887,65,8,73,0,inf
10888,58,9,67,0,inf
10889,65,12,77,0,inf
10890,62,8,70,0,inf
10891,57,5,62,0,inf
10892,54,6,60,0,inf
10893,54,12,66,0,inf
10894,55,5,60,0,inf
10895,56,7,63,0,inf
10896,56,11,67,0,inf
10897,53,9,62,0,inf
10898,66,10,76,0,inf
10899,63,9,72,0,inf
10900,63,9,72,0,inf
10901,51,12,63,0,inf
10902,55,6,61,0,inf
10903,50,8,58,0,inf
10904,65,11,76,0,inf
10905,57,12,69,0,inf
10906,57,11,68,0,inf
10907,52,12,64,0,inf
10908,54,5,59,0,inf
10909,52,6,58,0,inf
10910,57,13,70,0,inf
10911,63,8,71,0,inf
10912,62,9,71,0,inf
10913,56,6,62,0,inf
10914,51,7,58,0,inf
10915,61,13,74,0,inf
10916,67,6,73,0,inf
10917,64,10,74,0,inf
10918,62,10,72,0,inf
10919,67,11,78,0,inf
10920,67,11,78,0,inf
10921,53,11,64,1,7.92385583890804
10922,55,11,66,0,inf
10923,52,6,58,0,inf
10924,61,8,69,0,inf
10925,64,6,70,0,inf
10926,56,7,63,0,inf
10927,60,12,72,0,inf
10928,64,9,73,0,inf
10929,63,12,75,0,inf
10930,67,12,79,0,inf
10931,57,13,70,0,inf
10932,56,9,65,0,inf
10933,59,9,68,0,inf
10934,59,9,68,0,inf
10935,50,6,56,0,inf
10936,63,9,72,0,inf
10937,59,9,68,0,inf
10938,67,13,80,0,inf
10939,65,9,74,0,inf
10940,55,11,66,0,inf
10941,61,8,69,0,inf
10942,58,7,65,0,inf
10943,59,9,68,0,inf
10944,57,5,62,0,inf
10945,64,9,73,0,inf
10946,60,7,67,0,inf
10947,65,9,74,0,inf
10948,64,10,74,1,6.321425678044633
10949,57,12,69,0,inf
10950,66,9,75,0,inf
10951,55,5,60,0,inf
10952,58,5,63,0,inf
10953,50,8,58,0,inf
10954,64,11,75,0,inf
10955,61,5,66,0,inf
10956,66,5,71,0,inf
10957,52,11,63,0,inf
10958,52,5,57,0,inf
10959,56,5,61,0,inf
10960,58,6,64,0,inf
10961,53,7,60,0,inf
10962,64,5,69,0,inf
10963,66,6,72,0,inf
10964,52,11,63,0,inf
10965,57,5,62,0,inf
10966,65,12,77,0,inf
10967,52,8,60,0,inf
10968,57,10,67,0,inf
10969,51,11,62,0,inf
10970,62,13,75,0,inf
10971,55,7,62,0,inf
10972,56,8,64,0,inf
10973,57,10,67,0,inf
10974,65,5,70,0,inf
10975,53,12,65,0,inf
10976,50,11,61,0,inf
10977,60,13,73,0,inf
10978,56,6,62,0,inf
10979,57,6,63,0,inf
10980,53,13,66,0,inf
10981,59,9,68,0,inf
10982,52,7,59,0,inf
10983,56,12,68,0,inf
10984,50,13,63,0,inf
10985,51,11,62,0,inf
10986,52,7,59,0,inf
10987,65,12,77,0,inf
10988,57,6,63,0,inf
10989,53,10,63,0,inf
10990,62,9,71,0,inf
10991,52,8,60,0,inf
10992,64,9,73,0,inf
10993,67,13,80,0,inf
10994,63,5,68,0,inf
10995,62,5,67,0,inf
10996,63,8,71,0,inf
10997,52,12,64,0,inf
10998,65,10,75,0,inf
10999,55,9,64,0,inf
11000,59,7,66,1,1.9195619226785965
11001,52,7,59,0,inf
11002,50,10,60,0,inf
11003,66,11,77,0,inf
11004,61,6,67,0,inf
11005,62,12,74,0,inf
11006,57,10,67,0,inf
11007,64,6,70,0,inf
11008,50,13,63,0,inf
11009,50,11,61,1,5.614774285882973
11010,54,6,60,0,inf
11011,52,6,58,0,inf
11012,61,11,72,0,inf
11013,66,6,72,0,inf
11014,54,9,63,0,inf
11015,63,8,71,0,inf
11016,59,7,66,0,inf
11017,61,11,72,0,inf
11018,55,10,65,0,inf
11019,52,9,61,0,inf
11020,58,9,67,0,inf
11021,62,9,71,0,inf
11022,67,5,72,0,inf
11023,55,8,63,0,inf
11024,51,13,64,0,inf
11025,52,6,58,0,inf
11026,62,7,69,0,inf
11027,58,7,65,0,inf
11028,60,6,66,0,inf
11029,54,13,67,0,inf
11030,64,9,73,1,5.21588601936638
11031,62,5,67,0,inf
11032,56,8,64,0,inf
11033,53,12,65,0,inf
11034,53,10,63,0,inf
11035,52,7,59,0,inf
11036,51,9,60,0,inf
11037,60,10,70,0,inf
11038,59,10,69,0,inf
11039,58,8,66,0,inf
11040,66,12,78,0,inf
11041,56,5,61,0,inf
11042,60,8,68,0,inf
11043,52,5,57,0,inf
11044,51,7,58,0,inf
11045,64,7,71,0,inf
11046,56,7,63,0,inf
11047,64,13,77,0,inf
11048,52,8,60,0,inf
11049,63,8,71,0,inf
11050,59,5,64,0,inf
11051,64,10,74,0,inf
11052,59,9,68,0,inf
11053,52,7,59,0,inf
11054,61,13,74,0,inf
11055,57,7,64,0,inf
11056,66,13,79,0,inf
11057,56,7,63,0,inf
11058,67,6,73,0,inf
11059,54,9,63,0,inf
11060,67,13,80,0,inf
11061,54,8,62,0,inf
11062,67,7,74,0,inf
11063,66,6,72,0,inf
11064,67,11,78,0,inf
11065,58,6,64,0,inf
11066,55,12,67,0,inf
11067,55,10,65,1,8.203183450968545
11068,65,13,78,0,inf
11069,53,12,65,0,inf
11070,63,7,70,0,inf
11071,50,6,56,0,inf
11072,56,8,64,0,inf
11073,53,10,63,0,inf
11074,57,13,70,0,inf
11075,59,11,70,0,inf
11076,51,8,59,0,inf
11077,63,8,71,0,inf
11078,64,5,69,0,inf
11079,64,9,73,0,inf
11080,58,13,71,0,inf
11081,52,9,61,0,inf
11082,63,9,72,0,inf
11083,62,13,75,0,inf
11084,64,10,74,0,inf
11085,55,10,65,0,inf
11086,57,11,68,0,inf
11087,52,11,63,0,inf
11088,64,12,76,0,inf
11089,58,6,64,0,inf
11090,50,11,61,0,inf
11091,52,12,64,0,inf
11092,54,8,62,0,inf
11093,65,8,73,0,inf
11094,56,11,67,0,inf
11095,65,8,73,0,inf
11096,56,6,62,0,inf
11097,60,12,72,0,inf
11098,66,6,72,0,inf
11099,51,6,57,0,inf
11100,64,7,71,0,inf
11101,63,5,68,0,inf
11102,54,9,63,0,inf
11103,55,7,62,0,inf
11104,61,11,72,0,inf
11105,52,8,60,0,inf
11106,59,9,68,1,5.342471813245837
11107,67,11,78,0,inf
11108,64,10,74,0,inf
11109,51,8,59,0,inf
11110,51,8,59,0,inf
11111,65,13,78,0,inf
11112,59,12,71,0,inf
11113,62,9,71,0,inf
11114,64,8,72,0,inf
11115,57,5,62,0,inf
11116,54,13,67,0,inf
11117,67,8,75,0,inf
11118,58,12,70,0,inf
11119,59,12,71,0,inf
11120,51,8,59,0,inf
11121,64,5,69,0,inf
11122,57,8,65,0,inf
11123,50,7,57,0,inf
11124,67,11,78,0,inf
11125,64,12,76,0,inf
11126,63,12,75,0,inf
11127,61,12,73,0,inf
11128,58,6,64,0,inf
11129,50,8,58,0,inf
11130,64,7,71,0,inf
11131,59,9,68,0,inf
11132,50,5,55,0,inf
11133,58,6,64,0,inf
11134,61,7,68,0,inf
11135,66,9,75,0,inf
11136,67,6,73,0,inf
11137,61,6,67,0,inf
11138,65,6,71,0,inf
11139,53,10,63,0,inf
11140,63,9,72,0,inf
11141,64,5,69,0,inf
11142,58,8,66,0,inf
11143,57,8,65,0,inf
11144,67,11,78,0,inf
11145,58,9,67,0,inf
11146,56,8,64,0,inf
11147,63,6,69,0,inf
11148,66,13,79,0,inf
11149,52,12,64,0,inf
11150,67,8,75,0,inf
11151,63,10,73,0,inf
11152,66,10,76,0,inf
11153,65,13,78,0,inf
11154,51,9,60,0,inf
11155,61,5,66,0,inf
11156,51,12,63,0,inf
11157,58,12,70,0,inf
11158,65,11,76,0,inf
11159,65,7,72,0,inf
11160,65,12,77,0,inf
11161,56,11,67,0,inf
11162,67,12,79,0,inf
11163,57,8,65,0,inf
11164,54,9,63,0,inf
11165,66,9,75,0,inf
11166,67,7,74,0,inf
11167,60,10,70,0,inf
11168,54,13,67,0,inf
11169,64,9,73,0,inf
11170,64,10,74,0,inf
11171,63,6,69,0,inf
11172,60,10,70,0,inf
11173,66,8,74,0,inf
11174,50,7,57,0,inf
11175,58,6,64,0,inf
11176,66,8,74,0,inf
11177,60,8,68,0,inf
11178,54,12,66,1,5.905590161075338
11179,59,8,67,0,inf
11180,60,5,65,0,inf
11181,56,8,64,0,inf
11182,57,6,63,0,inf
11183,52,5,57,0,inf
11184,51,11,62,0,inf
11185,56,8,64,0,inf
11186,62,8,70,0,inf
11187,55,9,64,0,inf
11188,56,8,64,0,inf
11189,59,11,70,0,inf
11190,51,11,62,0,inf
11191,61,10,71,0,inf
11192,56,10,66,1,5.145999965096813
11193,57,5,62,0,inf
11194,60,9,69,0,inf
11195,64,13,77,0,inf
11196,66,9,75,0,inf
11197,53,8,61,0,inf
11198,53,7,60,0,inf
11199,60,9,69,0,inf
11200,59,8,67,0,inf
11201,66,8,74,0,inf
11202,63,5,68,0,inf
11203,54,9,63,0,inf
11204,59,9,68,0,inf
11205,61,6,67,0,inf
11206,55,7,62,0,inf
11207,51,7,58,0,inf
11208,50,9,59,0,inf
11209,54,9,63,0,inf
11210,56,5,61,0,inf
11211,63,13,76,0,inf
11212,58,11,69,0,inf
11213,62,11,73,0,inf
11214,50,6,56,0,inf
11215,56,10,66,0,inf
11216,55,12,67,0,inf
11217,52,9,61,0,inf
11218,50,8,58,0,inf
11219,59,12,71,0,inf
11220,54,7,61,0,inf
11221,50,5,55,0,inf
11222,56,12,68,0,inf
11223,61,13,74,0,inf
11224,64,11,75,0,inf
11225,51,11,62,0,inf
11226,63,11,74,0,inf
11227,50,5,55,0,inf
11228,54,6,60,0,inf
11229,54,6,60,0,inf
11230,65,10,75,0,inf
11231,64,13,77,0,inf
11232,52,12,64,0,inf
11233,51,10,61,0,inf
11234,51,8,59,0,inf
11235,52,9,61,0,inf
11236,59,12,71,0,inf
11237,66,10,76,0,inf
11238,66,10,76,0,inf
11239,64,7,71,0,inf
11240,61,8,69,0,inf
11241,55,13,68,0,inf
11242,56,9,65,0,inf
11243,60,13,73,0,inf
11244,58,13,71,0,inf
11245,52,9,61,0,inf
11246,62,7,69,1,0.891179779917465
11247,56,12,68,0,inf
11248,64,6,70,0,inf
11249,66,12,78,0,inf
11250,54,13,67,0,inf
11251,64,5,69,0,inf
11252,52,12,64,0,inf
11253,59,11,70,1,9.143845313953335
11254,52,13,65,0,inf
11255,59,6,65,0,inf
11256,64,11,75,0,inf
11257,54,13,67,0,inf
11258,64,7,71,0,inf
11259,53,7,60,0,inf
11260,64,6,70,0,inf
11261,62,11,73,0,inf
11262,61,10,71,0,inf
11263,65,11,76,0,inf
11264,60,12,72,0,inf
11265,67,13,80,0,inf
11266,50,6,56,0,inf
11267,52,6,58,0,inf
11268,55,8,63,0,inf
11269,59,5,64,0,inf
11270,66,12,78,0,inf
11271,66,5,71,0,inf
11272,67,6,73,0,inf
11273,59,9,68,0,inf
11274,62,10,72,0,inf
11275,64,6,70,0,inf
11276,51,5,56,0,inf
11277,60,8,68,0,inf
11278,51,8,59,0,inf
11279,50,10,60,0,inf
11280,57,13,70,0,inf
11281,56,11,67,0,inf
11282,55,6,61,0,inf
11283,65,8,73,0,inf
11284,51,12,63,1,3.1594999199677503
11285,52,11,63,0,inf
11286,52,12,64,0,inf
11287,59,8,67,0,inf
11288,55,5,60,0,inf
11289,52,9,61,0,inf
11290,64,7,71,0,inf
11291,60,12,72,0,inf
11292,54,5,59,0,inf
11293,51,12,63,0,inf
11294,65,5,70,0,inf
11295,65,6,71,0,inf
11296,59,13,72,0,inf
11297,65,11,76,0,inf
11298,51,11,62,1,3.6774539481368365
11299,64,6,70,0,inf
11300,59,13,72,0,inf
11301,60,13,73,1,11.848802019816887
11302,66,6,72,0,inf
11303,57,5,62,0,inf
11304,64,11,75,0,inf
11305,59,5,64,0,inf
11306,63,6,69,0,inf
11307,65,9,74,0,inf
11308,65,11,76,0,inf
11309,53,8,61,0,inf
11310,67,13,80,0,inf
11311,57,9,66,0,inf
11312,59,6,65,0,inf
11313,65,11,76,0,inf
11314,51,10,61,0,inf
11315,59,13,72,0,inf
11316,60,8,68,0,inf
11317,53,9,62,0,inf
11318,62,8,70,0,inf
11319,66,8,74,0,inf
11320,65,8,73,0,inf
11321,59,7,66,0,inf
11322,54,7,61,0,inf
11323,60,6,66,0,inf
11324,59,5,64,0,inf
11325,63,6,69,0,inf
11326,51,12,63,0,inf
11327,60,13,73,0,inf
11328,52,8,60,0,inf
11329,58,12,70,0,inf
11330,57,12,69,0,inf
11331,55,9,64,0,inf
11332,67,5,72,0,inf
11333,57,11,68,0,inf
11334,51,5,56,0,inf
11335,52,10,62,0,inf
11336,62,6,68,0,inf
11337,50,6,56,0,inf
11338,62,8,70,0,inf
11339,65,9,74,0,inf
11340,62,6,68,0,inf
11341,66,10,76,0,inf
11342,55,7,62,0,inf
11343,51,6,57,0,inf
11344,62,10,72,0,inf
11345,62,12,74,0,inf
11346,66,13,79,0,inf
11347,64,13,77,1,3.6289391165329334
11348,59,13,72,0,inf
11349,57,7,64,0,inf
11350,55,5,60,0,inf
11351,60,11,71,0,inf
11352,60,8,68,0,inf
11353,50,5,55,0,inf
11354,60,8,68,0,inf
11355,60,11,71,0,inf
11356,58,7,65,0,inf
11357,59,7,66,0,inf
11358,55,8,63,0,inf
11359,51,5,56,0,inf
11360,54,5,59,0,inf
11361,60,13,73,0,inf
11362,53,8,61,0,inf
11363,64,9,73,0,inf
11364,56,5,61,0,inf
11365,52,9,61,0,inf
11366,54,9,63,0,inf
11367,62,13,75,0,inf
11368,62,11,73,0,inf
11369,54,7,61,0,inf
11370,62,11,73,0,inf
11371,62,7,69,0,inf
11372,60,6,66,0,inf
11373,53,7,60,1,5.021143441426538
11374,50,9,59,0,inf
11375,50,9,59,0,inf
11376,53,10,63,0,inf
11377,65,13,78,0,inf
11378,65,8,73,0,inf
11379,60,7,67,0,inf
11380,58,8,66,0,inf
11381,58,8,66,0,inf
11382,62,8,70,0,inf
11383,52,13,65,0,inf
11384,57,8,65,0,inf
11385,66,10,76,0,inf
11386,52,13,65,0,inf
11387,60,7,67,0,inf
11388,51,5,56,0,inf
11389,50,12,62,0,inf
11390,54,12,66,0,inf
11391,55,5,60,0,inf
11392,55,13,68,1,10.979805483122945
11393,64,5,69,0,inf
11394,60,10,70,0,inf
11395,54,7,61,0,inf
11396,52,12,64,0,inf
11397,58,10,68,0,inf
11398,67,6,73,0,inf
11399,65,11,76,0,inf
11400,65,6,71,0,inf
11401,57,6,63,0,inf
11402,51,10,61,0,inf
11403,63,13,76,0,inf
11404,59,10,69,0,inf
11405,66,5,71,0,inf
11406,67,5,72,0,inf
11407,60,6,66,0,inf
11408,66,12,78,1,1.5116963950691513
11409,58,9,67,0,inf
11410,60,12,72,0,inf
11411,65,10,75,0,inf
11412,53,13,66,0,inf
11413,58,13,71,1,9.59362243654921
11414,63,5,68,0,inf
11415,52,9,61,0,inf
11416,65,10,75,0,inf
11417,66,13,79,0,inf
11418,56,11,67,0,inf
11419,52,8,60,0,inf
11420,54,5,59,0,inf
11421,61,8,69,0,inf
11422,55,5,60,0,inf
11423,54,7,61,0,inf
11424,66,13,79,0,inf
11425,51,9,60,0,inf
11426,54,9,63,0,inf
11427,58,12,70,0,inf
11428,62,8,70,0,inf
11429,63,13,76,0,inf
11430,57,11,68,1,10.617765849272317
11431,57,11,68,0,inf
11432,65,8,73,0,inf
11433,53,12,65,0,inf
11434,58,12,70,0,inf
11435,62,6,68,0,inf
11436,54,6,60,0,inf
11437,66,13,79,0,inf
11438,56,10,66,0,inf
11439,50,11,61,0,inf
11440,55,9,64,0,inf
11441,51,7,58,0,inf
11442,53,5,58,0,inf
11443,54,12,66,0,inf
11444,63,6,69,0,inf
11445,55,9,64,0,inf
11446,53,12,65,0,inf
11447,67,9,76,0,inf
11448,59,10,69,0,inf
11449,50,10,60,0,inf
11450,64,9,73,0,inf
11451,59,12,71,0,inf
11452,66,8,74,0,inf
11453,62,5,67,0,inf
11454,66,7,73,0,inf
11455,59,9,68,0,inf
11456,55,11,66,0,inf
11457,65,5,70,0,inf
11458,52,10,62,0,inf
11459,67,10,77,0,inf
11460,52,10,62,0,inf
11461,56,13,69,0,inf
11462,53,13,66,0,inf
11463,54,5,59,0,inf
11464,60,11,71,0,inf
11465,55,7,62,0,inf
11466,54,13,67,0,inf
11467,56,12,68,0,inf
11468,63,7,70,0,inf
11469,56,11,67,0,inf
11470,64,5,69,0,inf
11471,61,8,69,0,inf
11472,66,13,79,0,inf
11473,60,8,68,0,inf
11474,62,9,71,0,inf
11475,53,5,58,0,inf
11476,62,5,67,0,inf
11477,61,10,71,0,inf
11478,56,9,65,0,inf
11479,67,10,77,0,inf
11480,56,11,67,0,inf
11481,56,9,65,0,inf
11482,63,6,69,0,inf
11483,62,12,74,0,inf
11484,57,13,70,0,inf
11485,61,10,71,0,inf
11486,61,9,70,0,inf
11487,63,12,75,1,6.7038017287815705
11488,53,12,65,0,inf
11489,52,8,60,0,inf
11490,59,13,72,0,inf
11491,52,9,61,0,inf
11492,57,10,67,0,inf
11493,61,11,72,0,inf
11494,59,8,67,0,inf
11495,55,7,62,1,3.8606871224511963
11496,51,6,57,0,inf
11497,55,13,68,0,inf
11498,55,7,62,0,inf
11499,64,9,73,0,inf
11500,56,12,68,0,inf
11501,65,7,72,0,inf
11502,63,9,72,0,inf
11503,56,9,65,0,inf
11504,50,10,60,0,inf
11505,50,7,57,0,inf
11506,51,11,62,0,inf
11507,57,13,70,0,inf
11508,57,12,69,0,inf
11509,64,8,72,0,inf
11510,58,8,66,0,inf
11511,51,7,58,0,inf
11512,67,7,74,0,inf
11513,63,6,69,0,inf
11514,53,12,65,0,inf
11515,55,12,67,0,inf
11516,57,12,69,0,inf
11517,50,6,56,0,inf
11518,63,13,76,0,inf
11519,66,7,73,0,inf
11520,53,8,61,0,inf
11521,52,5,57,0,inf
11522,58,6,64,0,inf
11523,67,13,80,0,inf
11524,61,12,73,0,inf
11525,52,6,58,0,inf
11526,56,7,63,0,inf
11527,57,10,67,0,inf
11528,55,9,64,0,inf
11529,52,6,58,0,inf
11530,52,10,62,0,inf
11531,53,6,59,0,inf
11532,57,7,64,0,inf
11533,66,11,77,0,inf
11534,55,11,66,0,inf
11535,51,9,60,0,inf
11536,65,8,73,0,inf
11537,60,10,70,0,inf
11538,62,5,67,0,inf
11539,66,13,79,0,inf
11540,55,7,62,1,5.091538979433317
11541,57,9,66,0,inf
11542,50,11,61,0,inf
11543,67,6,73,0,inf
11544,50,10,60,0,inf
11545,60,6,66,0,inf
11546,52,7,59,0,inf
11547,55,6,61,0,inf
11548,55,11,66,0,inf
11549,51,6,57,0,inf
11550,66,10,76,0,inf
11551,53,10,63,0,inf
11552,50,5,55,0,inf
11553,66,7,73,0,inf
11554,57,5,62,0,inf
11555,66,7,73,0,inf
11556,54,8,62,0,inf
11557,53,7,60,0,inf
11558,59,11,70,0,inf
11559,61,8,69,0,inf
11560,60,10,70,0,inf
11561,66,9,75,0,inf
11562,61,9,70,0,inf
11563,55,8,63,0,inf
11564,52,8,60,0,inf
11565,59,13,72,0,inf
11566,63,5,68,0,inf
11567,54,10,64,0,inf
11568,52,9,61,0,inf
11569,53,6,59,0,inf
11570,52,10,62,0,inf
11571,59,5,64,0,inf
11572,54,12,66,1,1.331833215259131
11573,63,7,70,0,inf
11574,64,11,75,0,inf
11575,67,8,75,0,inf
11576,67,11,78,0,inf
11577,65,11,76,0,inf
11578,65,11,76,0,inf
11579,56,11,67,0,inf
11580,57,11,68,0,inf
11581,66,11,77,0,inf
11582,61,10,71,0,inf
11583,60,5,65,0,inf
11584,64,5,69,0,inf
11585,66,7,73,0,inf
11586,52,7,59,0,inf
11587,57,5,62,0,inf
11588,58,11,69,0,inf
11589,61,6,67,0,inf
11590,52,7,59,0,inf
11591,57,6,63,0,inf
11592,51,11,62,0,inf
11593,58,12,70,0,inf
11594,50,13,63,0,inf
11595,66,12,78,0,inf
11596,54,10,64,0,inf
11597,60,8,68,0,inf
11598,52,10,62,0,inf
11599,59,5,64,0,inf
11600,53,13,66,0,inf
11601,64,13,77,0,inf
11602,59,7,66,0,inf
11603,65,13,78,0,inf
11604,67,9,76,1,5.66228606615222
11605,61,9,70,0,inf
11606,50,5,55,0,inf
11607,63,10,73,0,inf
11608,55,10,65,0,inf
11609,53,12,65,0,inf
11610,65,9,74,0,inf
11611,65,10,75,0,inf
11612,56,10,66,0,inf
11613,60,7,67,0,inf
11614,55,13,68,0,inf
11615,58,6,64,0,inf
11616,51,7,58,0,inf
11617,67,10,77,0,inf
11618,66,7,73,0,inf
11619,63,12,75,0,inf
11620,59,7,66,0,inf
11621,57,5,62,0,inf
11622,55,6,61,0,inf
11623,63,10,73,0,inf
11624,66,5,71,0,inf
11625,67,11,78,0,inf
11626,64,7,71,0,inf
11627,59,9,68,0,inf
11628,54,6,60,0,inf
11629,63,11,74,0,inf
11630,51,11,62,0,inf
11631,65,7,72,0,inf
11632,56,7,63,0,inf
11633,57,8,65,0,inf
11634,66,12,78,0,inf
11635,58,10,68,0,inf
11636,52,13,65,1,6.287075928669175
11637,62,6,68,0,inf
11638,57,13,70,0,inf
11639,57,5,62,0,inf
11640,54,12,66,0,inf
11641,50,12,62,0,inf
11642,54,13,67,0,inf
11643,56,11,67,0,inf
11644,55,9,64,0,inf
11645,59,6,65,0,inf
11646,58,11,69,0,inf
11647,51,6,57,0,inf
11648,58,12,70,0,inf
11649,56,10,66,0,inf
11650,51,12,63,0,inf
11651,67,6,73,0,inf
11652,55,8,63,0,inf
11653,58,8,66,0,inf
11654,61,10,71,0,inf
11655,64,6,70,0,inf
11656,53,5,58,0,inf
11657,54,6,60,0,inf
11658,57,6,63,0,inf
11659,62,7,69,0,inf
11660,57,8,65,0,inf
11661,63,6,69,0,inf
11662,50,6,56,0,inf
11663,61,5,66,0,inf
11664,58,5,63,0,inf
11665,59,9,68,1,6.88406821566231
11666,62,7,69,0,inf
11667,53,12,65,0,inf
11668,61,12,73,0,inf
11669,63,10,73,0,inf
11670,58,9,67,1,1.8882678568521456
11671,52,13,65,0,inf
11672,51,7,58,0,inf
11673,53,13,66,0,inf
11674,54,7,61,0,inf
11675,61,6,67,0,inf
11676,64,12,76,0,inf
11677,63,7,70,0,inf
11678,56,7,63,0,inf
11679,50,10,60,1,0.9754725387553123
11680,60,5,65,0,inf
11681,65,7,72,0,inf
11682,50,13,63,0,inf
11683,61,6,67,0,inf
11684,50,7,57,0,inf
11685,50,11,61,0,inf
11686,51,9,60,0,inf
11687,64,5,69,0,inf
11688,64,10,74,0,inf
11689,50,8,58,0,inf
11690,55,5,60,0,inf
11691,55,5,60,0,inf
11692,53,8,61,0,inf
11693,60,12,72,0,inf
11694,55,8,63,0,inf
11695,58,8,66,0,inf
11696,64,12,76,0,inf
11697,50,6,56,0,inf
11698,59,11,70,0,inf
11699,54,10,64,0,inf
11700,59,8,67,0,inf
11701,62,12,74,0,inf
11702,62,11,73,0,inf
11703,51,6,57,0,inf
11704,66,10,76,0,inf
11705,57,12,69,0,inf
11706,54,9,63,0,inf
11707,60,13,73,1,10.19309964848243
11708,53,12,65,1,8.421294859585323
11709,67,6,73,0,inf
11710,62,9,71,0,inf
11711,61,10,71,0,inf
11712,63,6,69,0,inf
11713,61,10,71,0,inf
11714,62,13,75,0,inf
11715,66,9,75,0,inf
11716,50,6,56,0,inf
11717,55,9,64,0,inf
11718,60,9,69,0,inf
11719,58,10,68,0,inf
11720,59,9,68,0,inf
11721,53,12,65,0,inf
11722,56,7,63,0,inf
11723,56,6,62,0,inf
11724,57,6,63,0,inf
11725,61,13,74,0,inf
11726,54,6,60,0,inf
11727,61,13,74,0,inf
11728,52,12,64,0,inf
11729,67,8,75,0,inf
11730,52,11,63,0,inf
11731,51,8,59,0,inf
11732,61,13,74,0,inf
11733,54,7,61,0,inf
11734,63,9,72,0,inf
11735,54,12,66,0,inf
11736,53,11,64,0,inf
11737,54,11,65,0,inf
11738,56,11,67,0,inf
11739,56,6,62,0,inf
11740,59,13,72,1,9.126135318466694
11741,66,10,76,0,inf
11742,58,6,64,0,inf
11743,59,8,67,0,inf
11744,62,8,70,0,inf
11745,53,9,62,0,inf
11746,58,6,64,0,inf
11747,63,7,70,0,inf
11748,56,13,69,1,11.794860206442607
11749,59,6,65,0,inf
11750,59,10,69,0,inf
11751,67,9,76,0,inf
11752,63,12,75,0,inf
11753,58,12,70,0,inf
11754,67,8,75,0,inf
11755,65,10,75,0,inf
11756,64,8,72,0,inf
11757,57,10,67,0,inf
11758,66,7,73,0,inf
11759,58,11,69,0,inf
11760,50,13,63,0,inf
11761,52,5,57,0,inf
11762,66,12,78,0,inf
11763,65,6,71,0,inf
11764,50,5,55,0,inf
11765,60,7,67,0,inf
11766,50,10,60,0,inf
11767,56,11,67,0,inf
11768,59,6,65,0,inf
11769,56,8,64,1,0.3184992222369374
11770,66,13,79,0,inf
11771,67,7,74,0,inf
11772,57,13,70,0,inf
11773,58,9,67,0,inf
11774,58,7,65,0,inf
11775,52,9,61,0,inf
11776,58,8,66,0,inf
11777,66,7,73,0,inf
11778,60,6,66,0,inf
11779,57,8,65,0,inf
11780,51,7,58,0,inf
11781,56,10,66,0,inf
11782,52,9,61,0,inf
11783,59,13,72,0,inf
11784,61,13,74,0,inf
11785,54,11,65,0,inf
11786,56,5,61,0,inf
11787,62,13,75,0,inf
11788,64,10,74,0,inf
11789,62,9,71,0,inf
11790,54,11,65,0,inf
11791,58,13,71,0,inf
11792,65,10,75,0,inf
11793,60,13,73,0,inf
11794,60,13,73,0,inf
11795,50,11,61,0,inf
11796,63,10,73,0,inf
11797,66,12,78,0,inf
11798,60,8,68,0,inf
11799,50,9,59,0,inf
11800,51,11,62,1,10.268633755458765
11801,53,7,60,0,inf
11802,52,9,61,0,inf
11803,53,12,65,0,inf
11804,51,11,62,0,inf
11805,50,12,62,0,inf
11806,63,8,71,0,inf
11807,57,6,63,0,inf
11808,63,11,74,0,inf
11809,61,8,69,0,inf
11810,62,10,72,0,inf
11811,56,7,63,0,inf
11812,54,13,67,0,inf
11813,63,5,68,0,inf
11814,51,12,63,0,inf
11815,57,7,64,0,inf
11816,66,5,71,0,inf
11817,54,10,64,0,inf
11818,53,11,64,0,inf
11819,62,11,73,0,inf
11820,64,11,75,0,inf
11821,61,5,66,0,inf
11822,50,9,59,0,inf
11823,55,13,68,0,inf
11824,56,9,65,0,inf
11825,60,13,73,0,inf
11826,62,5,67,0,inf
11827,57,5,62,0,inf
11828,66,7,73,0,inf
11829,53,10,63,0,inf
11830,62,10,72,0,inf
11831,57,9,66,0,inf
11832,55,9,64,0,inf
11833,59,9,68,1,6.59488103929354
11834,57,12,69,0,inf
11835,56,10,66,0,inf
11836,51,9,60,0,inf
11837,62,9,71,0,inf
11838,63,8,71,0,inf
11839,53,6,59,0,inf
11840,65,8,73,0,inf
11841,53,10,63,0,inf
11842,62,11,73,0,inf
11843,52,7,59,0,inf
11844,62,8,70,0,inf
11845,54,13,67,0,inf
11846,64,7,71,1,6.262496924398519
11847,60,5,65,0,inf
11848,65,8,73,0,inf
11849,51,7,58,0,inf
11850,55,11,66,0,inf
11851,67,9,76,0,inf
11852,65,12,77,0,inf
11853,57,9,66,0,inf
11854,53,12,65,0,inf
11855,53,11,64,0,inf
11856,51,8,59,0,inf
11857,51,9,60,0,inf
11858,62,11,73,0,inf
11859,63,10,73,0,inf
11860,60,10,70,0,inf
11861,50,12,62,0,inf
11862,63,10,73,0,inf
11863,52,6,58,0,inf
11864,59,7,66,0,inf
11865,58,5,63,0,inf
11866,55,11,66,0,inf
11867,53,5,58,0,inf
11868,66,12,78,0,inf
11869,67,13,80,0,inf
11870,64,5,69,0,inf
11871,60,8,68,0,inf
11872,61,5,66,0,inf
11873,66,12,78,0,inf
11874,59,7,66,0,inf
11875,51,5,56,0,inf
11876,54,6,60,0,inf
11877,53,10,63,0,inf
11878,53,8,61,0,inf
11879,67,12,79,0,inf
11880,52,10,62,0,inf
11881,51,8,59,0,inf
11882,60,5,65,0,inf
11883,55,9,64,0,inf
11884,57,8,65,0,inf
11885,65,12,77,0,inf
11886,60,8,68,0,inf
11887,56,5,61,0,inf
11888,66,12,78,0,inf
11889,66,6,72,0,inf
11890,52,5,57,0,inf
11891,55,5,60,0,inf
11892,54,8,62,0,inf
11893,61,5,66,0,inf
11894,64,5,69,0,inf
11895,51,6,57,0,inf
11896,52,9,61,0,inf
11897,62,10,72,0,inf
11898,66,13,79,0,inf
11899,50,7,57,0,inf
11900,58,12,70,0,inf
11901,50,9,59,0,inf
11902,59,10,69,0,inf
11903,56,8,64,0,inf
11904,58,9,67,0,inf
11905,62,10,72,0,inf
11906,52,12,64,0,inf
11907,52,5,57,0,inf
11908,53,11,64,0,inf
11909,60,13,73,0,inf
11910,58,11,69,0,inf
11911,52,5,57,0,inf
11912,55,7,62,0,inf
11913,55,9,64,0,inf
11914,57,9,66,0,inf
11915,57,13,70,0,inf
11916,56,6,62,0,inf
11917,58,12,70,0,inf
11918,51,9,60,0,inf
11919,50,8,58,0,inf
11920,54,7,61,0,inf
11921,65,5,70,0,inf
11922,65,9,74,0,inf
11923,63,9,72,0,inf
11924,53,9,62,0,inf
11925,52,12,64,0,inf
11926,59,9,68,0,inf
11927,58,11,69,0,inf
11928,50,11,61,0,inf
11929,62,7,69,0,inf
11930,65,8,73,0,inf
11931,55,6,61,0,inf
11932,52,7,59,0,inf
11933,63,7,70,0,inf
11934,53,7,60,0,inf
11935,65,5,70,0,inf
11936,67,5,72,0,inf
11937,56,7,63,0,inf
11938,67,13,80,0,inf
11939,60,7,67,0,inf
11940,65,10,75,0,inf
11941,65,5,70,0,inf
11942,58,10,68,0,inf
11943,60,8,68,0,inf
11944,64,13,77,0,inf
11945,61,12,73,0,inf
11946,64,9,73,0,inf
11947,59,12,71,0,inf
11948,63,5,68,0,inf
11949,67,11,78,0,inf
11950,61,10,71,0,inf
11951,67,13,80,0,inf
11952,63,7,70,0,inf
11953,67,10,77,0,inf
11954,63,12,75,0,inf
11955,55,8,63,0,inf
11956,64,10,74,0,inf
11957,51,7,58,0,inf
11958,60,11,71,0,inf
11959,66,9,75,0,inf
11960,59,7,66,0,inf
11961,64,5,69,0,inf
11962,62,5,67,0,inf
11963,65,8,73,0,inf
11964,58,12,70,0,inf
11965,62,7,69,0,inf
11966,50,5,55,0,inf
11967,65,7,72,0,inf
11968,62,5,67,0,inf
11969,55,10,65,0,inf
11970,59,10,69,0,inf
11971,59,10,69,0,inf
11972,58,12,70,0,inf
11973,54,9,63,0,inf
11974,50,8,58,0,inf
11975,65,5,70,0,inf
11976,52,7,59,0,inf
11977,57,8,65,0,inf
11978,60,13,73,0,inf
11979,62,13,75,0,inf
11980,59,8,67,0,inf
11981,52,10,62,0,inf
11982,66,12,78,0,inf
11983,56,12,68,0,inf
11984,58,11,69,0,inf
11985,50,7,57,0,inf
11986,53,10,63,0,inf
11987,51,8,59,0,inf
11988,66,13,79,0,inf
11989,67,10,77,0,inf
11990,54,5,59,0,inf
11991,62,9,71,0,inf
11992,54,10,64,0,inf
11993,60,10,70,0,inf
11994,67,12,79,0,inf
11995,52,10,62,0,inf
11996,54,5,59,0,inf
11997,65,10,75,0,inf
11998,62,7,69,0,inf
11999,60,13,73,0,inf
12000,60,7,67,0,inf
12001,53,6,59,0,inf
12002,60,6,66,0,inf
12003,61,11,72,0,inf
12004,58,5,63,0,inf
12005,64,6,70,0,inf
12006,53,5,58,0,inf
12007,52,12,64,0,inf
12008,57,6,63,1,5.7904079669225865
12009,51,12,63,0,inf
12010,56,11,67,0,inf
12011,63,12,75,0,inf
12012,59,12,71,0,inf
12013,52,11,63,0,inf
12014,61,11,72,0,inf
12015,58,10,68,0,inf
12016,51,8,59,1,2.311767384268137
12017,57,7,64,0,inf
12018,58,12,70,0,inf
12019,62,10,72,0,inf
12020,67,11,78,0,inf
12021,64,13,77,0,inf
12022,64,12,76,0,inf
12023,53,5,58,0,inf
12024,56,8,64,0,inf
12025,50,13,63,0,inf
12026,59,8,67,0,inf
12027,64,6,70,0,inf
12028,62,7,69,0,inf
12029,60,10,70,0,inf
12030,66,13,79,0,inf
12031,67,8,75,0,inf
12032,66,9,75,0,inf
12033,64,5,69,0,inf
12034,55,13,68,0,inf
12035,62,13,75,0,inf
12036,57,5,62,0,inf
12037,58,12,70,0,inf
12038,67,12,79,0,inf
12039,54,9,63,0,inf
12040,62,7,69,0,inf
12041,50,11,61,0,inf
12042,59,5,64,0,inf
12043,53,8,61,0,inf
12044,50,9,59,0,inf
12045,63,10,73,0,inf
12046,56,13,69,0,inf
12047,56,7,63,0,inf
12048,64,13,77,0,inf
12049,66,8,74,0,inf
12050,51,6,57,0,inf
12051,60,9,69,0,inf
12052,62,13,75,0,inf
12053,64,12,76,0,inf
12054,55,5,60,0,inf
12055,54,6,60,0,inf
12056,58,6,64,0,inf
12057,63,5,68,0,inf
12058,67,9,76,0,inf
12059,61,6,67,1,3.660879867595611
12060,67,10,77,0,inf
12061,56,10,66,0,inf
12062,50,5,55,0,inf
12063,64,7,71,1,6.991172866180307
12064,53,13,66,0,inf
12065,59,9,68,0,inf
12066,64,7,71,0,inf
12067,51,9,60,0,inf
12068,50,8,58,0,inf
12069,61,8,69,1,1.7238928300247238
12070,64,11,75,0,inf
12071,67,5,72,0,inf
12072,55,9,64,1,1.0436425581360282
12073,60,10,70,0,inf
12074,63,12,75,0,inf
12075,64,13,77,0,inf
12076,61,13,74,0,inf
12077,59,11,70,0,inf
12078,52,10,62,0,inf
12079,55,6,61,0,inf
12080,58,12,70,0,inf
12081,52,9,61,0,inf
12082,51,5,56,0,inf
12083,56,12,68,0,inf
12084,61,11,72,0,inf
12085,59,9,68,0,inf
12086,63,12,75,0,inf
12087,55,8,63,0,inf
12088,59,7,66,0,inf
12089,63,5,68,0,inf
12090,66,10,76,0,inf
12091,56,13,69,0,inf
12092,54,6,60,0,inf
12093,61,13,74,0,inf
12094,54,9,63,0,inf
12095,57,5,62,0,inf
12096,55,12,67,0,inf
12097,58,5,63,0,inf
12098,62,8,70,0,inf
12099,63,5,68,0,inf
12100,61,9,70,0,inf
12101,51,7,58,0,inf
12102,50,11,61,0,inf
12103,54,11,65,1,3.255547975525637
12104,54,5,59,0,inf
12105,51,10,61,0,inf
12106,64,11,75,0,inf
12107,54,8,62,0,inf
12108,53,6,59,0,inf
12109,58,13,71,0,inf
12110,63,7,70,0,inf
12111,67,10,77,0,inf
12112,63,10,73,0,inf
12113,57,6,63,1,1.728573725721887
12114,52,11,63,0,inf
12115,65,9,74,0,inf
12116,67,11,78,0,inf
12117,58,7,65,0,inf
12118,61,5,66,0,inf
12119,63,11,74,0,inf
12120,60,12,72,0,inf
12121,52,10,62,0,inf
12122,51,6,57,0,inf
12123,66,12,78,0,inf
12124,60,7,67,0,inf
12125,50,8,58,0,inf
12126,56,12,68,0,inf
12127,54,10,64,0,inf
12128,67,8,75,0,inf
12129,60,6,66,0,inf
12130,53,10,63,1,9.85411669744284
12131,63,11,74,0,inf
12132,55,10,65,0,inf
12133,57,5,62,0,inf
12134,50,8,58,0,inf
12135,61,10,71,0,inf
12136,54,8,62,0,inf
12137,61,8,69,0,inf
12138,52,11,63,0,inf
12139,59,11,70,0,inf
12140,54,7,61,0,inf
12141,56,7,63,0,inf
12142,55,9,64,0,inf
12143,56,5,61,0,inf
12144,63,9,72,0,inf
12145,53,9,62,0,inf
12146,53,7,60,0,inf
12147,61,8,69,0,inf
12148,58,13,71,0,inf
12149,63,8,71,0,inf
12150,57,5,62,0,inf
12151,55,8,63,0,inf
12152,63,11,74,0,inf
12153,57,11,68,0,inf
12154,65,13,78,0,inf
12155,67,12,79,0,inf
12156,67,5,72,0,inf
12157,50,7,57,0,inf
12158,63,11,74,0,inf
12159,55,7,62,0,inf
12160,64,5,69,0,inf
12161,55,6,61,0,inf
12162,57,13,70,0,inf
12163,53,9,62,0,inf
12164,54,12,66,0,inf
12165,55,8,63,0,inf
12166,61,7,68,0,inf
12167,59,6,65,0,inf
12168,64,7,71,0,inf
12169,50,12,62,0,inf
12170,58,11,69,0,inf
12171,61,13,74,0,inf
12172,59,12,71,0,inf
12173,60,13,73,1,0.992526791749647
12174,63,13,76,0,inf
12175,59,6,65,0,inf
12176,62,7,69,0,inf
12177,58,10,68,0,inf
12178,60,9,69,0,inf
12179,54,7,61,0,inf
12180,65,6,71,0,inf
12181,63,10,73,0,inf
12182,60,5,65,0,inf
12183,52,8,60,0,inf
12184,67,11,78,0,inf
12185,51,8,59,0,inf
12186,52,5,57,0,inf
12187,64,13,77,0,inf
12188,57,5,62,0,inf
12189,50,11,61,0,inf
12190,61,5,66,0,inf
12191,60,9,69,0,inf
12192,58,6,64,0,inf
12193,65,12,77,0,inf
12194,54,10,64,0,inf
12195,66,12,78,0,inf
12196,50,11,61,0,inf
12197,61,7,68,0,inf
12198,52,11,63,0,inf
12199,51,13,64,0,inf
12200,67,12,79,0,inf
12201,63,12,75,0,inf
12202,50,13,63,0,inf
12203,62,10,72,0,inf
12204,53,9,62,0,inf
12205,61,13,74,0,inf
12206,57,13,70,0,inf
12207,60,9,69,0,inf
12208,60,13,73,0,inf
12209,65,7,72,0,inf
12210,64,13,77,0,inf
12211,57,11,68,0,inf
12212,50,9,59,0,inf
12213,67,8,75,0,inf
12214,64,10,74,0,inf
12215,57,13,70,0,inf
12216,60,9,69,0,inf
12217,66,8,74,0,inf
12218,62,6,68,0,inf
12219,59,13,72,0,inf
12220,58,11,69,0,inf
12221,65,6,71,0,inf
12222,53,11,64,0,inf
12223,64,11,75,0,inf
12224,57,7,64,0,inf
12225,52,7,59,0,inf
12226,61,9,70,0,inf
12227,50,6,56,0,inf
12228,53,8,61,0,inf
12229,55,12,67,0,inf
12230,55,12,67,0,inf
12231,54,8,62,0,inf
12232,66,7,73,0,inf
12233,63,12,75,0,inf
12234,55,13,68,1,10.567684919606634
12235,67,7,74,0,inf
12236,59,9,68,0,inf
12237,66,9,75,0,inf
12238,52,5,57,0,inf
12239,66,10,76,0,inf
12240,55,9,64,0,inf
12241,53,5,58,0,inf
12242,64,8,72,0,inf
12243,54,11,65,0,inf
12244,52,8,60,0,inf
12245,57,8,65,0,inf
12246,67,13,80,0,inf
12247,61,5,66,0,inf
12248,66,7,73,0,inf
12249,51,11,62,0,inf
12250,65,11,76,0,inf
12251,62,12,74,0,inf
12252,66,5,71,0,inf
12253,57,10,67,0,inf
12254,55,10,65,0,inf
12255,59,13,72,0,inf
12256,55,12,67,0,inf
12257,63,11,74,0,inf
12258,50,6,56,0,inf
12259,61,10,71,0,inf
12260,52,6,58,0,inf
12261,58,13,71,0,inf
12262,57,9,66,0,inf
12263,58,9,67,0,inf
12264,57,5,62,0,inf
12265,67,8,75,0,inf
12266,53,5,58,0,inf
12267,55,12,67,0,inf
12268,62,7,69,0,inf
12269,56,9,65,0,inf
12270,64,7,71,0,inf
12271,61,13,74,0,inf
12272,54,13,67,0,inf
12273,67,10,77,0,inf
12274,59,8,67,0,inf
12275,59,7,66,0,inf
12276,54,10,64,0,inf
12277,66,5,71,0,inf
12278,52,7,59,0,inf
12279,52,10,62,0,inf
12280,52,7,59,0,inf
12281,55,12,67,0,inf
12282,50,5,55,0,inf
12283,52,5,57,0,inf
12284,52,7,59,0,inf
12285,58,7,65,0,inf
12286,58,9,67,0,inf
12287,54,5,59,0,inf
12288,59,5,64,0,inf
12289,66,7,73,0,inf
12290,51,12,63,0,inf
12291,60,7,67,0,inf
12292,50,7,57,0,inf
12293,66,8,74,0,inf
12294,65,10,75,0,inf
12295,63,5,68,0,inf
12296,54,5,59,0,inf
12297,66,5,71,0,inf
12298,65,13,78,1,12.830558948258272
12299,53,9,62,0,inf
12300,63,7,70,0,inf
12301,59,5,64,0,inf
12302,58,11,69,0,inf
12303,65,13,78,0,inf
12304,67,8,75,0,inf
12305,63,9,72,0,inf
12306,64,7,71,0,inf
12307,61,9,70,0,inf
12308,62,10,72,0,inf
12309,58,9,67,0,inf
12310,55,9,64,0,inf
12311,50,8,58,0,inf
12312,54,11,65,0,inf
12313,64,11,75,0,inf
12314,65,6,71,0,inf
12315,60,13,73,0,inf
12316,51,9,60,0,inf
12317,60,8,68,0,inf
12318,55,10,65,0,inf
12319,66,8,74,0,inf
12320,55,8,63,0,inf
12321,66,8,74,0,inf
12322,66,10,76,0,inf
12323,56,5,61,1,0.3383833628610162
12324,55,6,61,0,inf
12325,54,9,63,0,inf
12326,55,8,63,0,inf
12327,51,13,64,0,inf
12328,58,13,71,0,inf
12329,50,5,55,0,inf
12330,57,6,63,0,inf
12331,60,6,66,0,inf
12332,56,6,62,0,inf
12333,54,11,65,0,inf
12334,50,11,61,0,inf
12335,61,9,70,0,inf
12336,62,8,70,1,1.1486463281063806
12337,52,5,57,0,inf
12338,61,9,70,0,inf
12339,67,8,75,0,inf
12340,58,9,67,0,inf
12341,60,9,69,0,inf
12342,62,9,71,0,inf
12343,54,9,63,0,inf
12344,58,12,70,0,inf
12345,50,6,56,0,inf
12346,59,10,69,0,inf
12347,51,13,64,0,inf
12348,51,7,58,0,inf
12349,59,9,68,0,inf
12350,58,13,71,0,inf
12351,60,12,72,0,inf
12352,56,9,65,0,inf
12353,53,8,61,0,inf
12354,65,7,72,0,inf
12355,58,5,63,0,inf
12356,58,9,67,0,inf
12357,56,11,67,0,inf
12358,65,7,72,0,inf
12359,61,9,70,0,inf
12360,58,8,66,0,inf
12361,67,11,78,0,inf
12362,56,10,66,0,inf
12363,61,12,73,0,inf
12364,54,6,60,0,inf
12365,52,9,61,0,inf
12366,66,5,71,0,inf
12367,50,13,63,0,inf
12368,62,12,74,0,inf
12369,57,11,68,0,inf
12370,51,13,64,0,inf
12371,50,8,58,0,inf
12372,53,8,61,0,inf
12373,57,11,68,0,inf
12374,53,7,60,0,inf
12375,64,13,77,0,inf
12376,63,11,74,0,inf
12377,65,9,74,0,inf
12378,61,10,71,0,inf
12379,66,6,72,0,inf
12380,63,5,68,0,inf
12381,67,6,73,0,inf
12382,51,12,63,0,inf
12383,53,7,60,0,inf
12384,65,6,71,0,inf
12385,57,13,70,0,inf
12386,67,10,77,0,inf
12387,61,8,69,0,inf
12388,64,13,77,0,inf
12389,55,5,60,0,inf
12390,57,7,64,0,inf
12391,51,5,56,0,inf
12392,50,12,62,0,inf
12393,52,5,57,0,inf
12394,53,8,61,0,inf
12395,63,10,73,0,inf
12396,50,10,60,0,inf
12397,66,7,73,0,inf
12398,60,9,69,0,inf
12399,63,11,74,0,inf
12400,56,11,67,0,inf
12401,56,6,62,0,inf
12402,66,8,74,1,5.260087144240472
12403,66,7,73,0,inf
12404,59,6,65,0,inf
12405,56,6,62,0,inf
12406,62,9,71,0,inf
12407,50,10,60,1,2.510009652480001
12408,60,12,72,0,inf
12409,65,7,72,0,inf
12410,64,10,74,0,inf
12411,54,5,59,0,inf
12412,57,5,62,0,inf
12413,50,13,63,0,inf
12414,62,9,71,0,inf
12415,53,5,58,0,inf
12416,59,13,72,0,inf
12417,65,8,73,0,inf
12418,63,10,73,0,inf
12419,57,12,69,0,inf
12420,66,9,75,0,inf
12421,61,8,69,0,inf
12422,66,13,79,0,inf
12423,65,13,78,0,inf
12424,53,13,66,0,inf
12425,62,6,68,0,inf
12426,54,5,59,0,inf
12427,50,9,59,0,inf
12428,55,5,60,0,inf
12429,67,8,75,0,inf
12430,66,13,79,0,inf
12431,55,9,64,0,inf
12432,67,11,78,0,inf
12433,67,7,74,0,inf
12434,54,5,59,0,inf
12435,65,5,70,0,inf
12436,66,13,79,0,inf
12437,66,5,71,0,inf
12438,50,5,55,0,inf
12439,65,7,72,0,inf
12440,54,7,61,0,inf
12441,61,10,71,0,inf
12442,52,5,57,0,inf
12443,62,7,69,0,inf
12444,51,13,64,0,inf
12445,66,10,76,0,inf
12446,51,8,59,0,inf
12447,58,9,67,0,inf
12448,61,11,72,0,inf
12449,58,13,71,0,inf
12450,63,9,72,0,inf
12451,51,8,59,0,inf
12452,64,13,77,0,inf
12453,60,6,66,0,inf
12454,52,9,61,0,inf
12455,53,10,63,0,inf
12456,64,5,69,0,inf
12457,51,8,59,0,inf
12458,51,12,63,0,inf
12459,66,9,75,0,inf
12460,57,7,64,0,inf
12461,58,7,65,0,inf
12462,57,12,69,0,inf
12463,53,12,65,0,inf
12464,53,12,65,0,inf
12465,62,12,74,0,inf
12466,57,12,69,1,11.255216796167488
12467,55,9,64,0,inf
12468,52,10,62,0,inf
12469,60,10,70,0,inf
12470,56,7,63,0,inf
12471,50,12,62,0,inf
12472,52,9,61,0,inf
12473,57,9,66,0,inf
12474,54,5,59,0,inf
12475,65,10,75,0,inf
12476,62,9,71,0,inf
12477,56,12,68,0,inf
12478,53,9,62,0,inf
12479,51,7,58,0,inf
12480,54,7,61,0,inf
12481,56,12,68,0,inf
12482,67,12,79,0,inf
12483,56,13,69,0,inf
12484,64,9,73,1,8.184360434237448
12485,52,5,57,0,inf
12486,65,5,70,0,inf
12487,56,12,68,0,inf
12488,62,13,75,0,inf
12489,62,12,74,0,inf
12490,58,7,65,0,inf
12491,61,9,70,0,inf
12492,55,6,61,0,inf
12493,54,6,60,0,inf
12494,50,9,59,0,inf
12495,53,10,63,0,inf
12496,52,8,60,0,inf
12497,58,7,65,0,inf
12498,50,11,61,0,inf
12499,52,8,60,0,inf
12500,66,9,75,0,inf
12501,66,7,73,1,3.1219288769472655
12502,60,6,66,0,inf
12503,65,8,73,0,inf
12504,63,12,75,0,inf
12505,59,7,66,0,inf
12506,67,11,78,0,inf
12507,55,11,66,0,inf
12508,66,10,76,0,inf
12509,53,6,59,0,inf
12510,60,10,70,0,inf
12511,53,8,61,0,inf
12512,61,9,70,0,inf
12513,62,13,75,0,inf
12514,56,5,61,0,inf
12515,61,12,73,0,inf
12516,63,12,75,0,inf
12517,55,13,68,0,inf
12518,59,7,66,0,inf
12519,59,7,66,0,inf
12520,63,12,75,0,inf
12521,59,10,69,0,inf
12522,57,13,70,0,inf
12523,67,11,78,0,inf
12524,66,6,72,0,inf
12525,65,5,70,0,inf
12526,63,7,70,0,inf
12527,51,8,59,0,inf
12528,59,8,67,0,inf
12529,57,11,68,0,inf
12530,66,8,74,0,inf
12531,54,9,63,0,inf
12532,62,12,74,0,inf
12533,64,5,69,0,inf
12534,53,11,64,0,inf
12535,64,6,70,0,inf
12536,51,11,62,0,inf
12537,65,7,72,0,inf
12538,59,8,67,0,inf
12539,61,8,69,0,inf
12540,53,10,63,0,inf
12541,52,11,63,0,inf
12542,65,7,72,0,inf
12543,67,7,74,0,inf
12544,58,6,64,0,inf
12545,50,12,62,0,inf
12546,65,11,76,0,inf
12547,55,8,63,0,inf
12548,65,9,74,1,8.737430395707705
12549,53,10,63,0,inf
12550,62,12,74,0,inf
12551,63,12,75,0,inf
12552,52,12,64,0,inf
12553,60,5,65,0,inf
12554,51,7,58,0,inf
12555,64,11,75,0,inf
12556,56,10,66,0,inf
12557,66,6,72,0,inf
12558,67,6,73,0,inf
12559,60,13,73,0,inf
12560,54,8,62,0,inf
12561,60,8,68,0,inf
12562,54,12,66,0,inf
12563,57,6,63,0,inf
12564,67,13,80,0,inf
12565,57,8,65,0,inf
12566,61,5,66,0,inf
12567,67,10,77,0,inf
12568,66,5,71,0,inf
12569,56,6,62,0,inf
12570,62,12,74,0,inf
12571,56,8,64,0,inf
12572,60,11,71,0,inf
12573,59,10,69,0,inf
12574,64,8,72,0,inf
12575,63,12,75,0,inf
12576,55,11,66,0,inf
12577,57,6,63,0,inf
12578,64,8,72,0,inf
12579,55,12,67,0,inf
12580,66,7,73,0,inf
12581,66,13,79,0,inf
12582,51,10,61,0,inf
12583,59,12,71,0,inf
12584,50,8,58,0,inf
12585,56,13,69,0,inf
12586,64,5,69,0,inf
12587,50,5,55,0,inf
12588,64,9,73,0,inf
12589,64,11,75,0,inf
12590,51,5,56,0,inf
12591,56,11,67,0,inf
12592,61,13,74,0,inf
12593,53,10,63,0,inf
12594,58,5,63,0,inf
12595,60,8,68,0,inf
12596,58,5,63,0,inf
12597,50,9,59,0,inf
12598,59,8,67,0,inf
12599,55,11,66,0,inf
12600,52,12,64,0,inf
12601,67,12,79,0,inf
12602,54,5,59,0,inf
12603,67,10,77,0,inf
12604,64,13,77,0,inf
12605,65,5,70,0,inf
12606,53,10,63,0,inf
12607,59,5,64,0,inf
12608,55,10,65,0,inf
12609,53,7,60,0,inf
12610,66,13,79,0,inf
12611,52,11,63,0,inf
12612,57,6,63,0,inf
12613,55,5,60,0,inf
12614,59,9,68,0,inf
12615,63,11,74,0,inf
12616,56,9,65,0,inf
12617,66,5,71,0,inf
12618,53,8,61,0,inf
12619,65,10,75,0,inf
12620,64,8,72,0,inf
12621,64,12,76,0,inf
12622,53,7,60,0,inf
12623,60,6,66,1,1.0981416851703045
12624,56,8,64,0,inf
12625,59,5,64,0,inf
12626,60,11,71,0,inf
12627,59,13,72,0,inf
12628,63,6,69,0,inf
12629,58,9,67,0,inf
12630,61,12,73,0,inf
12631,60,12,72,0,inf
12632,54,11,65,0,inf
12633,55,9,64,0,inf
12634,53,11,64,0,inf
12635,59,8,67,0,inf
12636,63,10,73,0,inf
12637,63,9,72,0,inf
12638,53,11,64,0,inf
12639,60,7,67,0,inf
12640,54,10,64,0,inf
12641,54,12,66,0,inf
12642,53,11,64,0,inf
12643,59,6,65,0,inf
12644,63,9,72,0,inf
12645,59,9,68,0,inf
12646,59,11,70,0,inf
12647,67,6,73,0,inf
12648,60,6,66,0,inf
12649,53,11,64,0,inf
12650,51,11,62,0,inf
12651,63,11,74,0,inf
12652,60,13,73,0,inf
12653,53,13,66,0,inf
12654,51,11,62,0,inf
12655,64,11,75,0,inf
12656,55,12,67,0,inf
12657,57,5,62,1,4.573885369222573
12658,51,10,61,0,inf
12659,63,7,70,0,inf
12660,51,5,56,0,inf
12661,57,11,68,0,inf
12662,60,5,65,0,inf
12663,66,8,74,0,inf
12664,60,9,69,0,inf
12665,57,11,68,0,inf
12666,62,10,72,0,inf
12667,59,12,71,0,inf
12668,50,9,59,0,inf
12669,64,11,75,0,inf
12670,65,8,73,0,inf
12671,52,6,58,0,inf
12672,52,10,62,0,inf
12673,62,10,72,0,inf
12674,59,9,68,1,1.1963345399220273
12675,57,11,68,0,inf
12676,66,11,77,0,inf
12677,52,12,64,0,inf
12678,64,12,76,0,inf
12679,62,12,74,0,inf
12680,60,8,68,0,inf
12681,52,9,61,0,inf
12682,50,12,62,0,inf
12683,54,13,67,0,inf
12684,50,9,59,0,inf
12685,59,6,65,0,inf
12686,58,10,68,0,inf
12687,59,8,67,0,inf
12688,65,13,78,0,inf
12689,60,11,71,0,inf
12690,54,11,65,0,inf
12691,62,9,71,0,inf
12692,62,5,67,0,inf
12693,58,5,63,0,inf
12694,60,7,67,0,inf
12695,50,8,58,0,inf
12696,56,5,61,0,inf
12697,61,7,68,0,inf
12698,66,11,77,0,inf
12699,67,10,77,0,inf
12700,57,5,62,0,inf
12701,65,8,73,0,inf
12702,63,10,73,1,2.677404242120474
12703,54,11,65,0,inf
12704,62,13,75,0,inf
12705,65,8,73,0,inf
12706,63,12,75,0,inf
12707,53,5,58,0,inf
12708,52,12,64,0,inf
12709,66,7,73,0,inf
12710,51,5,56,0,inf
12711,55,11,66,0,inf
12712,67,10,77,0,inf
12713,65,7,72,0,inf
12714,52,5,57,0,inf
12715,57,12,69,0,inf
12716,51,7,58,0,inf
12717,63,8,71,0,inf
12718,50,10,60,0,inf
12719,58,8,66,0,inf
12720,56,5,61,0,inf
12721,59,5,64,0,inf
12722,52,13,65,0,inf
12723,59,11,70,0,inf
12724,59,12,71,0,inf
12725,50,9,59,0,inf
12726,56,5,61,0,inf
12727,53,9,62,0,inf
12728,52,6,58,0,inf
12729,54,9,63,0,inf
12730,56,7,63,0,inf
12731,56,10,66,0,inf
12732,58,8,66,0,inf
12733,62,6,68,0,inf
12734,64,13,77,0,inf
12735,62,11,73,0,inf
12736,60,6,66,0,inf
12737,67,9,76,0,inf
12738,57,12,69,1,0.8478902564248045
12739,61,5,66,0,inf
12740,59,12,71,1,7.47678284022119
12741,66,12,78,1,5.97075805464938
12742,59,13,72,0,inf
12743,55,8,63,0,inf
12744,64,9,73,0,inf
12745,66,7,73,0,inf
12746,57,8,65,0,inf
12747,54,7,61,0,inf
12748,58,5,63,0,inf
12749,63,6,69,0,inf
12750,65,11,76,0,inf
12751,58,7,65,0,inf
12752,66,6,72,0,inf
12753,56,13,69,0,inf
12754,55,8,63,0,inf
12755,56,8,64,0,inf
12756,63,12,75,0,inf
12757,52,9,61,0,inf
12758,57,7,64,0,inf
12759,54,10,64,0,inf
12760,62,5,67,0,inf
12761,53,6,59,0,inf
12762,50,6,56,0,inf
12763,61,12,73,0,inf
12764,59,10,69,0,inf
12765,63,10,73,0,inf
12766,57,13,70,0,inf
12767,59,7,66,0,inf
12768,61,13,74,0,inf
12769,64,7,71,0,inf
12770,67,5,72,0,inf
12771,63,7,70,0,inf
12772,62,13,75,0,inf
12773,56,8,64,0,inf
12774,65,13,78,0,inf
12775,52,10,62,0,inf
12776,51,10,61,0,inf
12777,65,13,78,0,inf
12778,66,10,76,0,inf
12779,50,13,63,0,inf
12780,56,12,68,0,inf
12781,53,13,66,0,inf
12782,63,6,69,0,inf
12783,60,8,68,0,inf
12784,60,8,68,0,inf
12785,57,12,69,0,inf
12786,54,5,59,0,inf
12787,52,5,57,1,0.872463733497078
12788,57,13,70,0,inf
12789,60,7,67,0,inf
12790,52,10,62,0,inf
12791,57,8,65,0,inf
12792,65,10,75,0,inf
12793,54,9,63,0,inf
12794,60,10,70,0,inf
12795,58,12,70,0,inf
12796,64,13,77,1,11.616868073822758
12797,62,10,72,0,inf
12798,65,10,75,0,inf
12799,51,5,56,0,inf
12800,57,6,63,0,inf
12801,57,13,70,0,inf
12802,53,6,59,0,inf
12803,57,11,68,0,inf
12804,57,8,65,0,inf
12805,53,11,64,0,inf
12806,53,9,62,0,inf
12807,56,11,67,0,inf
12808,66,7,73,0,inf
12809,64,8,72,0,inf
12810,56,12,68,0,inf
12811,56,7,63,0,inf
12812,57,6,63,0,inf
12813,53,13,66,0,inf
12814,57,11,68,0,inf
12815,66,8,74,0,inf
12816,56,8,64,0,inf
12817,63,7,70,0,inf
12818,58,8,66,0,inf
12819,58,5,63,0,inf
12820,60,6,66,0,inf
12821,66,12,78,0,inf
12822,67,12,79,1,9.463355764450128
12823,50,5,55,0,inf
12824,60,10,70,0,inf
12825,65,12,77,0,inf
12826,63,12,75,0,inf
12827,65,8,73,0,inf
12828,53,11,64,0,inf
12829,52,10,62,0,inf
12830,61,7,68,0,inf
12831,61,11,72,0,inf
12832,56,5,61,0,inf
12833,56,13,69,0,inf
12834,50,8,58,0,inf
12835,65,12,77,0,inf
12836,63,13,76,1,3.086391240850972
12837,51,13,64,0,inf
12838,58,10,68,0,inf
12839,60,13,73,0,inf
12840,51,13,64,0,inf
12841,52,5,57,0,inf
12842,66,8,74,0,inf
12843,54,7,61,0,inf
12844,66,11,77,0,inf
12845,66,5,71,0,inf
12846,52,10,62,0,inf
12847,64,11,75,0,inf
12848,64,7,71,1,6.048299398436285
12849,57,10,67,0,inf
12850,67,5,72,0,inf
12851,51,13,64,0,inf
12852,64,9,73,0,inf
12853,61,10,71,0,inf
12854,60,5,65,0,inf
12855,63,11,74,0,inf
12856,65,5,70,0,inf
12857,67,8,75,0,inf
12858,52,6,58,0,inf
12859,59,8,67,0,inf
12860,67,5,72,0,inf
12861,66,12,78,0,inf
12862,56,5,61,0,inf
12863,59,9,68,0,inf
12864,58,11,69,0,inf
12865,64,13,77,0,inf
12866,58,11,69,0,inf
12867,57,11,68,0,inf
12868,53,7,60,0,inf
12869,58,13,71,0,inf
12870,62,10,72,0,inf
12871,58,7,65,0,inf
12872,62,6,68,0,inf
12873,58,10,68,0,inf
12874,58,6,64,0,inf
12875,61,11,72,1,8.37129633043044
12876,59,5,64,0,inf
12877,52,9,61,0,inf
12878,59,5,64,0,inf
12879,56,11,67,0,inf
12880,56,5,61,0,inf
12881,55,9,64,0,inf
12882,50,11,61,0,inf
12883,64,12,76,0,inf
12884,50,13,63,0,inf
12885,67,6,73,0,inf
12886,60,11,71,0,inf
12887,55,9,64,0,inf
12888,54,7,61,0,inf
12889,59,7,66,0,inf
12890,63,9,72,0,inf
12891,58,10,68,0,inf
12892,53,9,62,0,inf
12893,56,7,63,0,inf
12894,61,6,67,0,inf
12895,64,5,69,0,inf
12896,61,5,66,0,inf
12897,59,5,64,0,inf
12898,58,9,67,0,inf
12899,59,11,70,0,inf
12900,60,9,69,0,inf
12901,52,11,63,0,inf
12902,54,6,60,0,inf
12903,65,10,75,0,inf
12904,62,8,70,0,inf
12905,63,12,75,0,inf
12906,65,12,77,0,inf
12907,54,12,66,0,inf
12908,50,11,61,0,inf
12909,66,7,73,0,inf
12910,51,9,60,1,0.9010732725496027
12911,63,7,70,0,inf
12912,64,11,75,0,inf
12913,56,6,62,0,inf
12914,61,5,66,0,inf
12915,64,6,70,0,inf
12916,53,13,66,0,inf
12917,58,8,66,0,inf
12918,52,8,60,0,inf
12919,51,7,58,0,inf
12920,55,12,67,0,inf
12921,66,9,75,1,8.24447178742733
12922,53,8,61,0,inf
12923,58,11,69,0,inf
12924,53,13,66,0,inf
12925,62,5,67,0,inf
12926,56,12,68,0,inf
12927,56,11,67,0,inf
12928,56,6,62,0,inf
12929,56,5,61,0,inf
12930,50,9,59,0,inf
12931,54,11,65,0,inf
12932,59,10,69,0,inf
12933,53,6,59,0,inf
12934,63,6,69,0,inf
12935,50,7,57,0,inf
12936,52,5,57,0,inf
12937,56,8,64,0,inf
12938,57,6,63,0,inf
12939,51,12,63,0,inf
12940,61,12,73,0,inf
12941,50,7,57,0,inf
12942,62,12,74,0,inf
12943,55,12,67,0,inf
12944,67,10,77,0,inf
12945,53,12,65,0,inf
12946,54,9,63,0,inf
12947,50,7,57,0,inf
12948,53,7,60,0,inf
12949,58,10,68,0,inf
12950,66,13,79,0,inf
12951,64,12,76,0,inf
12952,65,11,76,0,inf
12953,56,6,62,1,0.6430050642274381
12954,57,7,64,0,inf
12955,59,8,67,0,inf
12956,62,8,70,0,inf
12957,58,9,67,0,inf
12958,50,10,60,0,inf
12959,53,7,60,0,inf
12960,59,13,72,0,inf
12961,58,12,70,0,inf
12962,55,8,63,0,inf
12963,62,12,74,0,inf
12964,66,10,76,0,inf
12965,51,9,60,0,inf
12966,53,13,66,0,inf
12967,56,13,69,0,inf
12968,51,11,62,0,inf
12969,64,13,77,0,inf
12970,63,12,75,0,inf
12971,50,6,56,0,inf
12972,67,6,73,0,inf
12973,65,9,74,0,inf
12974,57,9,66,0,inf
12975,50,8,58,0,inf
12976,62,11,73,0,inf
12977,56,6,62,0,inf
12978,64,13,77,1,7.853013246458133
12979,50,9,59,0,inf
12980,52,11,63,0,inf
12981,50,7,57,0,inf
12982,52,8,60,0,inf
12983,55,9,64,0,inf
12984,56,10,66,0,inf
12985,63,8,71,0,inf
12986,62,13,75,0,inf
12987,55,9,64,0,inf
12988,66,11,77,0,inf
12989,62,10,72,0,inf
12990,50,6,56,0,inf
12991,58,8,66,0,inf
12992,60,11,71,1,7.016058670940637
12993,67,11,78,0,inf
12994,62,12,74,0,inf
12995,57,10,67,0,inf
12996,50,11,61,0,inf
12997,53,13,66,0,inf
12998,52,13,65,0,inf
12999,62,9,71,0,inf
13000,58,9,67,0,inf
13001,66,9,75,0,inf
13002,59,12,71,0,inf
13003,50,11,61,0,inf
13004,50,9,59,0,inf
13005,64,5,69,0,inf
13006,61,9,70,0,inf
13007,67,6,73,0,inf
13008,56,12,68,0,inf
13009,51,8,59,0,inf
13010,67,8,75,0,inf
13011,59,8,67,0,inf
13012,57,10,67,0,inf
13013,67,8,75,0,inf
13014,67,6,73,0,inf
13015,63,8,71,0,inf
13016,60,12,72,0,inf
13017,55,12,67,0,inf
13018,53,10,63,0,inf
13019,53,8,61,0,inf
13020,51,6,57,0,inf
13021,62,7,69,0,inf
13022,50,5,55,0,inf
13023,58,13,71,0,inf
13024,52,12,64,0,inf
13025,52,6,58,0,inf
13026,51,6,57,0,inf
13027,50,11,61,0,inf
13028,51,7,58,0,inf
13029,60,8,68,0,inf
13030,67,9,76,0,inf
13031,66,8,74,0,inf
13032,64,11,75,0,inf
13033,65,7,72,0,inf
13034,63,8,71,0,inf
13035,57,12,69,0,inf
13036,62,6,68,0,inf
13037,56,12,68,0,inf
13038,58,10,68,0,inf
13039,63,9,72,0,inf
13040,52,5,57,1,0.2212095734672701
13041,57,11,68,0,inf
13042,65,12,77,0,inf
13043,53,10,63,0,inf
13044,64,13,77,0,inf
13045,55,13,68,0,inf
13046,55,13,68,0,inf
13047,62,8,70,0,inf
13048,50,6,56,0,inf
13049,57,9,66,1,5.972826415028919
13050,67,7,74,0,inf
13051,52,8,60,0,inf
13052,55,10,65,0,inf
13053,67,12,79,0,inf
13054,60,7,67,0,inf
13055,64,9,73,0,inf
13056,64,11,75,0,inf
13057,64,10,74,1,1.6448915983752528
13058,64,13,77,0,inf
13059,55,10,65,0,inf
13060,67,10,77,0,inf
13061,64,5,69,0,inf
13062,63,12,75,0,inf
13063,55,12,67,0,inf
13064,66,5,71,0,inf
13065,57,5,62,0,inf
13066,63,5,68,0,inf
13067,67,9,76,0,inf
13068,58,13,71,0,inf
13069,67,5,72,0,inf
13070,56,6,62,0,inf
13071,65,7,72,0,inf
13072,55,7,62,0,inf
13073,53,11,64,0,inf
13074,58,10,68,0,inf
13075,51,5,56,0,inf
13076,63,10,73,0,inf
13077,52,7,59,0,inf
13078,52,10,62,0,inf
13079,66,12,78,0,inf
13080,51,13,64,0,inf
13081,56,6,62,0,inf
13082,59,11,70,0,inf
13083,66,7,73,0,inf
13084,54,9,63,0,inf
13085,63,12,75,0,inf
13086,57,13,70,0,inf
13087,61,6,67,0,inf
13088,59,10,69,0,inf
13089,57,13,70,1,0.8586824313479724
13090,57,11,68,0,inf
13091,50,7,57,0,inf
13092,54,12,66,0,inf
13093,65,7,72,0,inf
13094,62,6,68,0,inf
13095,63,10,73,0,inf
13096,50,6,56,0,inf
13097,61,11,72,0,inf
13098,58,7,65,0,inf
13099,62,11,73,0,inf
13100,63,8,71,0,inf
13101,54,10,64,0,inf
13102,67,13,80,0,inf
13103,52,12,64,0,inf
13104,59,9,68,1,5.3917925480104
13105,51,9,60,0,inf
13106,67,5,72,0,inf
13107,65,13,78,0,inf
13108,57,11,68,0,inf
13109,66,8,74,0,inf
13110,67,7,74,0,inf
13111,50,6,56,0,inf
13112,55,13,68,0,inf
13113,58,6,64,0,inf
13114,66,10,76,0,inf
13115,61,6,67,0,inf
13116,63,11,74,0,inf
13117,52,6,58,0,inf
13118,58,10,68,0,inf
13119,51,13,64,0,inf
13120,55,10,65,0,inf
13121,61,6,67,0,inf
13122,66,10,76,0,inf
13123,50,9,59,0,inf
13124,62,12,74,1,3.4486039376282633
13125,58,7,65,0,inf
13126,52,9,61,0,inf
13127,53,13,66,0,inf
13128,67,11,78,0,inf
13129,51,7,58,0,inf
13130,66,10,76,0,inf
13131,53,8,61,0,inf
13132,56,12,68,0,inf
13133,64,10,74,0,inf
13134,63,12,75,1,7.8203772496041495
13135,53,13,66,0,inf
13136,55,7,62,0,inf
13137,61,11,72,0,inf
13138,55,11,66,0,inf
13139,50,5,55,0,inf
13140,63,11,74,0,inf
13141,62,10,72,0,inf
13142,66,7,73,0,inf
13143,65,13,78,0,inf
13144,50,10,60,0,inf
13145,62,9,71,0,inf
13146,60,6,66,0,inf
13147,51,12,63,0,inf
13148,66,7,73,0,inf
13149,54,6,60,0,inf
13150,63,9,72,0,inf
13151,65,12,77,0,inf
13152,55,8,63,0,inf
13153,65,9,74,0,inf
13154,61,11,72,0,inf
13155,57,10,67,0,inf
13156,61,8,69,0,inf
13157,67,12,79,0,inf
13158,59,7,66,0,inf
13159,61,13,74,0,inf
13160,64,12,76,0,inf
13161,63,10,73,0,inf
13162,50,6,56,0,inf
13163,61,9,70,1,4.222115926730567
13164,55,13,68,0,inf
13165,67,11,78,0,inf
13166,58,7,65,0,inf
13167,67,13,80,0,inf
13168,60,9,69,0,inf
13169,64,7,71,0,inf
13170,52,10,62,0,inf
13171,52,13,65,0,inf
13172,59,5,64,0,inf
13173,55,13,68,0,inf
13174,65,13,78,1,6.340532983559754
13175,57,8,65,0,inf
13176,65,11,76,0,inf
13177,55,11,66,0,inf
13178,56,13,69,0,inf
13179,52,11,63,0,inf
13180,54,10,64,0,inf
13181,59,9,68,0,inf
13182,67,5,72,0,inf
13183,54,7,61,0,inf
13184,66,11,77,0,inf
13185,60,6,66,0,inf
13186,65,10,75,0,inf
13187,53,6,59,0,inf
13188,56,7,63,0,inf
13189,59,12,71,0,inf
13190,51,9,60,0,inf
13191,50,9,59,0,inf
13192,64,5,69,0,inf
13193,62,11,73,0,inf
13194,59,8,67,0,inf
13195,54,6,60,0,inf
13196,61,6,67,0,inf
13197,62,6,68,0,inf
13198,61,7,68,0,inf
13199,52,13,65,0,inf
13200,64,10,74,0,inf
13201,53,8,61,0,inf
13202,52,13,65,0,inf
13203,62,5,67,0,inf
13204,57,13,70,0,inf
13205,52,11,63,0,inf
13206,52,6,58,0,inf
13207,55,6,61,0,inf
13208,52,5,57,0,inf
13209,50,9,59,0,inf
13210,63,11,74,0,inf
13211,50,9,59,0,inf
13212,65,5,70,0,inf
13213,54,12,66,0,inf
13214,66,7,73,0,inf
13215,58,9,67,0,inf
13216,62,6,68,0,inf
13217,64,8,72,0,inf
13218,53,12,65,0,inf
13219,63,5,68,0,inf
13220,50,7,57,0,inf
13221,66,13,79,0,inf
13222,59,6,65,0,inf
13223,54,9,63,0,inf
13224,54,6,60,0,inf
13225,65,11,76,0,inf
13226,55,12,67,0,inf
13227,55,7,62,0,inf
13228,63,9,72,0,inf
13229,50,11,61,0,inf
13230,65,12,77,0,inf
13231,55,6,61,0,inf
13232,59,7,66,0,inf
13233,62,12,74,0,inf
13234,61,6,67,0,inf
13235,63,8,71,0,inf
13236,58,12,70,0,inf
13237,53,10,63,0,inf
13238,55,5,60,0,inf
13239,50,9,59,0,inf
13240,57,10,67,0,inf
13241,65,12,77,0,inf
13242,54,6,60,0,inf
13243,62,9,71,0,inf
13244,53,11,64,0,inf
13245,64,8,72,0,inf
13246,63,10,73,0,inf
13247,63,10,73,1,3.086918381560153
13248,53,9,62,0,inf
13249,63,7,70,0,inf
13250,57,13,70,0,inf
13251,52,5,57,0,inf
13252,62,9,71,0,inf
13253,63,11,74,0,inf
13254,60,10,70,0,inf
13255,58,7,65,0,inf
13256,58,11,69,0,inf
13257,62,9,71,0,inf
13258,64,10,74,0,inf
13259,56,9,65,0,inf
13260,50,9,59,0,inf
13261,65,7,72,0,inf
13262,65,8,73,0,inf
13263,51,7,58,0,inf
13264,65,10,75,1,0.8087489549240274
13265,50,7,57,0,inf
13266,65,8,73,0,inf
13267,65,13,78,0,inf
13268,52,11,63,0,inf
13269,52,11,63,0,inf
13270,57,9,66,0,inf
13271,67,11,78,0,inf
13272,52,5,57,0,inf
13273,58,13,71,0,inf
13274,55,11,66,0,inf
13275,58,5,63,0,inf
13276,67,10,77,0,inf
13277,64,6,70,0,inf
13278,61,11,72,0,inf
13279,62,6,68,0,inf
13280,61,11,72,0,inf
13281,54,10,64,0,inf
13282,61,10,71,0,inf
13283,56,5,61,0,inf
13284,65,6,71,0,inf
13285,58,7,65,0,inf
13286,58,6,64,0,inf
13287,54,11,65,0,inf
13288,64,10,74,0,inf
13289,66,11,77,0,inf
13290,61,13,74,0,inf
13291,57,5,62,0,inf
13292,53,10,63,0,inf
13293,53,7,60,0,inf
13294,61,5,66,0,inf
13295,59,10,69,0,inf
13296,51,8,59,0,inf
13297,54,13,67,0,inf
13298,60,11,71,0,inf
13299,61,9,70,0,inf
13300,57,10,67,0,inf
13301,57,13,70,0,inf
13302,62,8,70,0,inf
13303,67,8,75,0,inf
13304,67,10,77,0,inf
13305,58,13,71,0,inf
13306,55,7,62,0,inf
13307,63,12,75,0,inf
13308,66,5,71,0,inf
13309,55,9,64,0,inf
13310,67,8,75,0,inf
13311,54,13,67,1,7.087974039948932
13312,57,7,64,0,inf
13313,60,9,69,0,inf
13314,62,12,74,0,inf
13315,63,5,68,0,inf
13316,60,11,71,0,inf
13317,54,13,67,0,inf
13318,55,11,66,0,inf
13319,63,7,70,0,inf
13320,60,9,69,0,inf
13321,63,11,74,0,inf
13322,61,7,68,0,inf
13323,52,10,62,0,inf
13324,59,12,71,0,inf
13325,63,6,69,0,inf
13326,64,7,71,0,inf
13327,52,6,58,0,inf
13328,61,10,71,0,inf
13329,59,9,68,1,7.993615486327144
13330,56,5,61,0,inf
13331,54,7,61,0,inf
13332,57,9,66,0,inf
13333,52,10,62,0,inf
13334,55,13,68,0,inf
13335,62,10,72,0,inf
13336,56,5,61,0,inf
13337,50,7,57,0,inf
13338,61,8,69,0,inf
13339,66,5,71,0,inf
13340,64,12,76,0,inf
13341,62,10,72,0,inf
13342,66,11,77,0,inf
13343,54,6,60,0,inf
13344,60,13,73,0,inf
13345,65,11,76,0,inf
13346,60,11,71,0,inf
13347,63,12,75,0,inf
13348,52,5,57,0,inf
13349,60,7,67,0,inf
13350,62,11,73,0,inf
13351,61,12,73,0,inf
13352,58,5,63,0,inf
13353,50,8,58,0,inf
13354,60,9,69,0,inf
13355,61,12,73,0,inf
13356,64,7,71,0,inf
13357,59,5,64,0,inf
13358,56,13,69,0,inf
13359,67,12,79,0,inf
13360,60,10,70,0,inf
13361,50,13,63,0,inf
13362,55,9,64,0,inf
13363,63,5,68,0,inf
13364,63,10,73,0,inf
13365,67,7,74,0,inf
13366,58,8,66,0,inf
13367,55,10,65,0,inf
13368,64,13,77,0,inf
13369,60,13,73,0,inf
13370,64,12,76,0,inf
13371,50,13,63,0,inf
13372,62,13,75,0,inf
13373,60,7,67,0,inf
13374,51,10,61,0,inf
13375,51,9,60,0,inf
13376,62,7,69,0,inf
13377,55,12,67,0,inf
13378,60,9,69,0,inf
13379,63,8,71,0,inf
13380,53,11,64,0,inf
13381,66,7,73,0,inf
13382,50,11,61,0,inf
13383,56,5,61,0,inf
13384,55,13,68,0,inf
13385,58,12,70,0,inf
13386,52,5,57,0,inf
13387,60,10,70,0,inf
13388,59,13,72,0,inf
13389,53,7,60,0,inf
13390,50,5,55,0,inf
13391,53,5,58,1,1.7621916427923097
13392,61,6,67,0,inf
13393,64,13,77,0,inf
13394,66,11,77,0,inf
13395,58,9,67,0,inf
13396,66,6,72,0,inf
13397,65,5,70,0,inf
13398,58,13,71,0,inf
13399,66,6,72,0,inf
13400,62,5,67,0,inf
13401,66,11,77,0,inf
13402,51,7,58,0,inf
13403,59,11,70,0,inf
13404,65,5,70,0,inf
13405,65,7,72,0,inf
13406,56,6,62,0,inf
13407,57,6,63,0,inf
13408,60,6,66,0,inf
13409,57,8,65,0,inf
13410,65,10,75,0,inf
13411,65,7,72,0,inf
13412,51,13,64,0,inf
13413,52,8,60,0,inf
13414,57,7,64,0,inf
13415,57,8,65,0,inf
13416,66,5,71,0,inf
13417,55,10,65,0,inf
13418,56,8,64,0,inf
13419,52,10,62,0,inf
13420,50,10,60,0,inf
13421,61,8,69,0,inf
13422,59,5,64,0,inf
13423,52,8,60,0,inf
13424,57,12,69,0,inf
13425,59,11,70,0,inf
13426,58,5,63,0,inf
13427,58,12,70,0,inf
13428,61,11,72,0,inf
13429,62,6,68,0,inf
13430,67,11,78,0,inf
13431,55,5,60,0,inf
13432,56,11,67,1,7.374595066804666
13433,55,12,67,0,inf
13434,57,7,64,0,inf
13435,54,10,64,0,inf
13436,58,12,70,0,inf
13437,52,8,60,0,inf
13438,54,5,59,0,inf
13439,63,5,68,1,3.0842619804805196
13440,60,6,66,0,inf
13441,60,12,72,0,inf
13442,56,6,62,0,inf
13443,62,5,67,0,inf
13444,53,10,63,0,inf
13445,56,6,62,0,inf
13446,61,11,72,0,inf
13447,56,10,66,0,inf
13448,63,10,73,0,inf
13449,50,11,61,0,inf
13450,51,9,60,0,inf
13451,60,10,70,0,inf
13452,62,5,67,0,inf
13453,55,10,65,0,inf
13454,59,12,71,0,inf
13455,55,8,63,0,inf
13456,55,8,63,0,inf
13457,52,6,58,0,inf
13458,50,7,57,0,inf
13459,67,6,73,0,inf
13460,59,12,71,0,inf
13461,51,8,59,0,inf
13462,64,13,77,1,8.955631189888734
13463,64,8,72,0,inf
13464,55,9,64,0,inf
13465,67,9,76,0,inf
13466,55,12,67,0,inf
13467,66,13,79,0,inf
13468,66,12,78,0,inf
13469,61,12,73,0,inf
13470,64,12,76,0,inf
13471,55,8,63,0,inf
13472,65,12,77,0,inf
13473,67,6,73,0,inf
13474,61,11,72,0,inf
13475,56,5,61,0,inf
13476,67,9,76,0,inf
13477,61,8,69,0,inf
13478,61,6,67,0,inf
13479,57,12,69,0,inf
13480,67,12,79,0,inf
13481,52,7,59,0,inf
13482,63,12,75,0,inf
13483,54,10,64,0,inf
13484,50,11,61,0,inf
13485,52,8,60,0,inf
13486,61,8,69,0,inf
13487,66,5,71,0,inf
13488,55,5,60,0,inf
13489,61,8,69,0,inf
13490,50,6,56,0,inf
13491,54,6,60,0,inf
13492,56,9,65,0,inf
13493,60,6,66,0,inf
13494,63,12,75,0,inf
13495,59,10,69,0,inf
13496,53,11,64,0,inf
13497,55,6,61,0,inf
13498,61,6,67,0,inf
13499,63,7,70,0,inf
13500,54,10,64,0,inf
13501,61,11,72,0,inf
13502,64,12,76,0,inf
13503,51,9,60,0,inf
13504,62,11,73,0,inf
13505,52,13,65,0,inf
13506,62,6,68,0,inf
13507,57,12,69,0,inf
13508,57,12,69,0,inf
13509,65,8,73,0,inf
13510,63,7,70,0,inf
13511,66,9,75,0,inf
13512,60,5,65,0,inf
13513,50,5,55,0,inf
13514,62,12,74,0,inf
13515,66,12,78,0,inf
13516,60,10,70,0,inf
13517,59,12,71,0,inf
13518,66,8,74,0,inf
13519,53,12,65,0,inf
13520,58,13,71,0,inf
13521,52,8,60,0,inf
13522,66,9,75,0,inf
13523,63,10,73,0,inf
13524,55,12,67,0,inf
13525,54,8,62,0,inf
13526,58,11,69,0,inf
13527,61,9,70,0,inf
13528,57,11,68,0,inf
13529,58,12,70,0,inf
13530,64,7,71,0,inf
13531,64,9,73,0,inf
13532,58,13,71,0,inf
13533,55,10,65,0,inf
13534,61,10,71,0,inf
13535,63,5,68,0,inf
13536,53,6,59,0,inf
13537,52,9,61,0,inf
13538,61,7,68,0,inf
13539,57,5,62,0,inf
13540,54,9,63,0,inf
13541,55,12,67,0,inf
13542,65,9,74,0,inf
13543,60,11,71,0,inf
13544,50,5,55,0,inf
13545,53,6,59,0,inf
13546,55,12,67,0,inf
13547,60,5,65,0,inf
13548,56,8,64,0,inf
13549,66,8,74,0,inf
13550,50,11,61,0,inf
13551,55,7,62,0,inf
13552,60,12,72,1,3.8700967298005367
13553,64,6,70,0,inf
13554,61,11,72,0,inf
13555,51,9,60,0,inf
13556,61,8,69,0,inf
13557,59,7,66,0,inf
13558,51,7,58,0,inf
13559,59,10,69,0,inf
13560,66,9,75,0,inf
13561,60,12,72,0,inf
13562,62,6,68,0,inf
13563,62,13,75,0,inf
13564,54,11,65,0,inf
13565,65,13,78,0,inf
13566,67,13,80,0,inf
13567,66,11,77,0,inf
13568,66,13,79,0,inf
13569,65,6,71,0,inf
13570,67,9,76,0,inf
13571,64,8,72,0,inf
13572,65,7,72,0,inf
13573,63,12,75,0,inf
13574,57,12,69,0,inf
13575,66,7,73,0,inf
13576,66,5,71,0,inf
13577,53,6,59,0,inf
13578,55,10,65,0,inf
13579,50,6,56,0,inf
13580,63,8,71,0,inf
13581,66,5,71,0,inf
13582,50,10,60,0,inf
13583,65,8,73,0,inf
13584,53,7,60,0,inf
13585,67,8,75,0,inf
13586,56,11,67,0,inf
13587,55,6,61,0,inf
13588,60,11,71,0,inf
13589,58,13,71,0,inf
13590,53,13,66,0,inf
13591,61,7,68,0,inf
13592,52,13,65,0,inf
13593,59,13,72,0,inf
13594,62,7,69,0,inf
13595,50,11,61,0,inf
13596,65,12,77,0,inf
13597,58,6,64,0,inf
13598,52,8,60,0,inf
13599,55,8,63,1,6.307317887735827
13600,59,5,64,0,inf
13601,54,10,64,0,inf
13602,59,8,67,0,inf
13603,58,6,64,0,inf
13604,53,6,59,0,inf
13605,57,9,66,0,inf
13606,51,9,60,0,inf
13607,58,6,64,0,inf
13608,54,7,61,0,inf
13609,64,7,71,0,inf
13610,58,11,69,0,inf
13611,60,9,69,0,inf
13612,55,9,64,0,inf
13613,63,6,69,0,inf
13614,64,8,72,0,inf
13615,50,11,61,0,inf
13616,66,10,76,0,inf
13617,50,7,57,0,inf
13618,51,6,57,0,inf
13619,56,11,67,0,inf
13620,55,13,68,0,inf
13621,62,8,70,0,inf
13622,62,5,67,0,inf
13623,60,5,65,0,inf
13624,62,12,74,0,inf
13625,53,9,62,0,inf
13626,55,5,60,0,inf
13627,57,13,70,0,inf
13628,65,7,72,0,inf
13629,67,12,79,1,3.3096466450307247
13630,58,9,67,0,inf
13631,50,13,63,0,inf
13632,62,7,69,0,inf
13633,57,12,69,0,inf
13634,53,11,64,0,inf
13635,58,8,66,0,inf
13636,55,7,62,0,inf
13637,58,7,65,0,inf
13638,65,11,76,0,inf
13639,60,10,70,0,inf
13640,62,10,72,0,inf
13641,57,7,64,0,inf
13642,57,11,68,0,inf
13643,65,5,70,0,inf
13644,60,13,73,0,inf
13645,57,11,68,0,inf
13646,67,12,79,1,3.2440656402890653
13647,54,5,59,0,inf
13648,67,12,79,1,11.79429899157833
13649,67,6,73,0,inf
13650,64,8,72,0,inf
13651,61,10,71,0,inf
13652,54,10,64,0,inf
13653,63,9,72,0,inf
13654,50,9,59,0,inf
13655,58,9,67,0,inf
13656,59,11,70,0,inf
13657,63,7,70,0,inf
13658,62,12,74,0,inf
13659,53,9,62,0,inf
13660,51,8,59,0,inf
13661,53,10,63,0,inf
13662,50,9,59,0,inf
13663,55,12,67,0,inf
13664,52,8,60,0,inf
13665,64,9,73,0,inf
13666,60,8,68,0,inf
13667,57,12,69,0,inf
13668,57,5,62,0,inf
13669,52,5,57,0,inf
13670,52,11,63,0,inf
13671,53,8,61,0,inf
13672,64,11,75,0,inf
13673,57,5,62,0,inf
13674,52,10,62,0,inf
13675,67,11,78,0,inf
13676,67,11,78,0,inf
13677,53,11,64,0,inf
13678,50,9,59,0,inf
13679,64,9,73,0,inf
13680,59,13,72,0,inf
13681,62,12,74,0,inf
13682,58,8,66,0,inf
13683,65,11,76,0,inf
13684,67,11,78,0,inf
13685,61,8,69,0,inf
13686,67,12,79,0,inf
13687,65,13,78,0,inf
13688,65,5,70,0,inf
13689,60,6,66,0,inf
13690,67,10,77,0,inf
13691,50,10,60,0,inf
13692,53,5,58,0,inf
13693,61,6,67,0,inf
13694,57,11,68,0,inf
13695,56,12,68,0,inf
13696,56,10,66,0,inf
13697,52,9,61,0,inf
13698,55,10,65,0,inf
13699,51,13,64,0,inf
13700,61,12,73,0,inf
13701,56,11,67,0,inf
13702,51,13,64,0,inf
13703,54,6,60,0,inf
13704,53,12,65,0,inf
13705,61,5,66,0,inf
13706,60,10,70,0,inf
13707,52,6,58,0,inf
13708,50,9,59,0,inf
13709,61,9,70,0,inf
13710,65,10,75,0,inf
13711,50,9,59,0,inf
13712,50,6,56,0,inf
13713,53,12,65,0,inf
13714,67,8,75,0,inf
13715,56,7,63,0,inf
13716,66,13,79,0,inf
13717,65,12,77,0,inf
13718,61,8,69,0,inf
13719,65,9,74,0,inf
13720,52,11,63,0,inf
13721,51,5,56,0,inf
13722,63,5,68,0,inf
13723,55,11,66,0,inf
13724,52,9,61,0,inf
13725,54,6,60,0,inf
13726,67,10,77,0,inf
13727,57,6,63,0,inf
13728,64,12,76,0,inf
13729,56,8,64,0,inf
13730,59,5,64,1,0.2707022507948693
13731,51,13,64,0,inf
13732,62,9,71,0,inf
13733,50,11,61,0,inf
13734,54,6,60,0,inf
13735,59,7,66,0,inf
13736,66,11,77,0,inf
13737,55,10,65,0,inf
13738,52,10,62,0,inf
13739,60,5,65,0,inf
13740,55,9,64,0,inf
13741,64,13,77,0,inf
13742,58,13,71,0,inf
13743,50,12,62,0,inf
13744,66,11,77,0,inf
13745,52,9,61,0,inf
13746,51,13,64,0,inf
13747,66,8,74,0,inf
13748,60,7,67,0,inf
13749,59,11,70,0,inf
13750,59,13,72,0,inf
13751,59,8,67,0,inf
13752,60,5,65,0,inf
13753,58,10,68,0,inf
13754,54,6,60,0,inf
13755,65,10,75,0,inf
13756,50,9,59,0,inf
13757,55,13,68,0,inf
13758,59,11,70,0,inf
13759,55,9,64,0,inf
13760,55,11,66,0,inf
13761,58,13,71,0,inf
13762,66,12,78,0,inf
13763,50,10,60,0,inf
13764,62,9,71,0,inf
13765,62,5,67,0,inf
13766,56,11,67,0,inf
13767,56,8,64,0,inf
13768,62,6,68,0,inf
13769,53,9,62,0,inf
13770,54,11,65,0,inf
13771,64,5,69,0,inf
13772,58,13,71,0,inf
13773,64,13,77,0,inf
13774,66,7,73,0,inf
13775,65,5,70,0,inf
13776,65,9,74,0,inf
13777,63,9,72,0,inf
13778,50,12,62,0,inf
13779,53,9,62,0,inf
13780,58,10,68,0,inf
13781,67,9,76,0,inf
13782,65,9,74,0,inf
13783,64,13,77,0,inf
13784,60,7,67,0,inf
13785,53,7,60,0,inf
13786,57,8,65,0,inf
13787,64,5,69,0,inf
13788,52,10,62,0,inf
13789,61,10,71,0,inf
13790,65,8,73,0,inf
13791,57,6,63,0,inf
13792,57,10,67,0,inf
13793,51,6,57,0,inf
13794,53,8,61,0,inf
13795,64,13,77,0,inf
13796,58,11,69,0,inf
13797,52,11,63,0,inf
13798,55,8,63,0,inf
13799,54,12,66,0,inf
13800,54,11,65,0,inf
13801,55,13,68,0,inf
13802,53,7,60,0,inf
13803,59,6,65,0,inf
13804,54,10,64,0,inf
13805,67,10,77,0,inf
13806,63,9,72,0,inf
13807,52,13,65,0,inf
13808,60,12,72,0,inf
13809,56,6,62,0,inf
13810,59,6,65,0,inf
13811,62,10,72,0,inf
13812,66,6,72,0,inf
13813,62,6,68,0,inf
13814,66,13,79,0,inf
13815,57,5,62,0,inf
13816,64,5,69,0,inf
13817,53,11,64,0,inf
13818,52,12,64,0,inf
13819,67,8,75,0,inf
13820,59,10,69,0,inf
13821,53,10,63,0,inf
13822,53,8,61,0,inf
13823,54,13,67,0,inf
13824,50,9,59,0,inf
13825,50,12,62,0,inf
13826,67,11,78,0,inf
13827,55,5,60,0,inf
13828,67,8,75,0,inf
13829,55,8,63,0,inf
13830,64,5,69,0,inf
13831,67,11,78,0,inf
13832,63,5,68,0,inf
13833,50,8,58,0,inf
13834,50,9,59,0,inf
13835,60,6,66,0,inf
13836,56,8,64,0,inf
13837,55,13,68,0,inf
13838,67,12,79,0,inf
13839,58,11,69,0,inf
13840,62,7,69,0,inf
13841,58,12,70,0,inf
13842,64,5,69,0,inf
13843,52,7,59,0,inf
13844,55,5,60,0,inf
13845,50,9,59,0,inf
13846,57,8,65,0,inf
13847,64,8,72,0,inf
13848,59,13,72,0,inf
13849,57,8,65,0,inf
13850,57,5,62,0,inf
13851,62,12,74,0,inf
13852,53,9,62,0,inf
13853,63,13,76,1,10.328546840554552
13854,67,8,75,0,inf
13855,60,13,73,0,inf
13856,59,13,72,0,inf
13857,64,7,71,0,inf
13858,50,11,61,0,inf
13859,63,11,74,0,inf
13860,53,13,66,0,inf
13861,62,11,73,0,inf
13862,66,6,72,0,inf
13863,60,7,67,0,inf
13864,54,11,65,0,inf
13865,60,12,72,0,inf
13866,53,10,63,0,inf
13867,66,5,71,0,inf
13868,54,7,61,0,inf
13869,55,6,61,0,inf
13870,54,8,62,0,inf
13871,59,10,69,0,inf
13872,50,8,58,0,inf
13873,56,6,62,1,3.1315691726432178
13874,53,8,61,0,inf
13875,58,6,64,1,2.0883593314636713
13876,51,5,56,0,inf
13877,65,11,76,0,inf
13878,56,7,63,1,4.140731503014507
13879,59,8,67,0,inf
13880,53,13,66,0,inf
13881,53,10,63,0,inf
13882,53,9,62,1,3.184350596789237
13883,59,12,71,1,2.0768190726673623
13884,52,7,59,0,inf
13885,54,7,61,0,inf
13886,64,11,75,0,inf
13887,65,12,77,0,inf
13888,67,12,79,0,inf
13889,61,12,73,0,inf
13890,52,9,61,0,inf
13891,60,12,72,0,inf
13892,57,10,67,0,inf
13893,50,11,61,1,8.866147275126629
13894,53,5,58,0,inf
13895,67,12,79,0,inf
13896,54,13,67,0,inf
13897,61,7,68,0,inf
13898,59,11,70,0,inf
13899,67,6,73,0,inf
13900,61,7,68,0,inf
13901,60,9,69,0,inf
13902,64,13,77,0,inf
13903,66,13,79,0,inf
13904,66,9,75,0,inf
13905,52,5,57,0,inf
13906,66,7,73,0,inf
13907,63,8,71,0,inf
13908,56,13,69,0,inf
13909,54,8,62,0,inf
13910,63,11,74,0,inf
13911,67,10,77,0,inf
13912,56,12,68,0,inf
13913,65,10,75,0,inf
13914,64,9,73,0,inf
13915,62,10,72,0,inf
13916,57,12,69,0,inf
13917,64,9,73,0,inf
13918,56,13,69,0,inf
13919,52,10,62,0,inf
13920,59,11,70,0,inf
13921,57,13,70,0,inf
13922,67,7,74,0,inf
13923,67,10,77,0,inf
13924,55,9,64,0,inf
13925,55,11,66,0,inf
13926,63,13,76,0,inf
13927,63,12,75,0,inf
13928,56,10,66,0,inf
13929,64,13,77,0,inf
13930,61,13,74,0,inf
13931,53,9,62,0,inf
13932,59,12,71,0,inf
13933,67,11,78,0,inf
13934,53,10,63,0,inf
13935,52,6,58,0,inf
13936,59,6,65,0,inf
13937,64,13,77,0,inf
13938,61,5,66,0,inf
13939,62,5,67,0,inf
13940,55,9,64,0,inf
13941,63,10,73,0,inf
13942,66,12,78,0,inf
13943,58,6,64,0,inf
13944,56,6,62,0,inf
13945,51,13,64,0,inf
13946,65,13,78,0,inf
13947,63,7,70,0,inf
13948,67,9,76,0,inf
13949,62,13,75,0,inf
13950,53,7,60,0,inf
13951,50,10,60,0,inf
13952,61,5,66,0,inf
13953,62,9,71,0,inf
13954,59,6,65,0,inf
13955,62,11,73,0,inf
13956,65,9,74,0,inf
13957,62,7,69,0,inf
13958,53,12,65,0,inf
13959,54,8,62,0,inf
13960,61,11,72,0,inf
13961,63,9,72,0,inf
13962,60,9,69,0,inf
13963,56,5,61,0,inf
13964,53,12,65,0,inf
13965,51,11,62,0,inf
13966,55,13,68,0,inf
13967,60,11,71,0,inf
13968,67,10,77,0,inf
13969,55,12,67,0,inf
13970,59,8,67,1,7.8811140880169575
13971,67,5,72,0,inf
13972,52,5,57,0,inf
13973,51,7,58,0,inf
13974,63,6,69,0,inf
13975,52,9,61,0,inf
13976,51,9,60,0,inf
13977,66,11,77,0,inf
13978,56,11,67,0,inf
13979,53,6,59,0,inf
13980,56,13,69,0,inf
13981,54,9,63,0,inf
13982,55,5,60,0,inf
13983,64,10,74,0,inf
13984,64,12,76,0,inf
13985,60,10,70,0,inf
13986,63,7,70,0,inf
13987,53,8,61,0,inf
13988,57,11,68,0,inf
13989,53,11,64,0,inf
13990,61,10,71,0,inf
13991,63,6,69,0,inf
13992,50,10,60,0,inf
13993,66,9,75,0,inf
13994,60,5,65,0,inf
13995,50,8,58,0,inf
13996,56,10,66,0,inf
13997,61,5,66,0,inf
13998,66,8,74,0,inf
13999,51,6,57,1,5.619404375733701
14000,55,11,66,0,inf
14001,63,11,74,1,7.624816562987192
14002,52,8,60,0,inf
14003,66,11,77,0,inf
14004,59,9,68,0,inf
14005,51,7,58,0,inf
14006,58,9,67,0,inf
14007,61,8,69,0,inf
14008,55,11,66,0,inf
14009,61,8,69,0,inf
14010,64,10,74,0,inf
14011,50,8,58,0,inf
14012,54,11,65,0,inf
14013,53,7,60,0,inf
14014,60,12,72,0,inf
14015,64,11,75,0,inf
14016,64,8,72,0,inf
14017,65,11,76,1,3.768548749958768
14018,64,11,75,0,inf
14019,59,9,68,0,inf
14020,51,13,64,0,inf
14021,65,13,78,0,inf
14022,66,10,76,0,inf
14023,61,13,74,0,inf
14024,63,11,74,0,inf
14025,54,5,59,0,inf
14026,58,5,63,0,inf
14027,59,13,72,0,inf
14028,60,12,72,0,inf
14029,66,13,79,0,inf
14030,62,12,74,0,inf
14031,55,7,62,0,inf
14032,52,8,60,0,inf
14033,58,8,66,0,inf
14034,54,6,60,0,inf
14035,61,11,72,0,inf
14036,67,12,79,0,inf
14037,53,12,65,0,inf
14038,50,9,59,0,inf
14039,63,8,71,0,inf
14040,57,9,66,0,inf
14041,57,13,70,0,inf
14042,63,13,76,1,6.412141004320105
14043,66,8,74,0,inf
14044,64,6,70,0,inf
14045,59,7,66,0,inf
14046,66,6,72,0,inf
14047,54,7,61,0,inf
14048,52,13,65,0,inf
14049,52,9,61,0,inf
14050,52,6,58,0,inf
14051,55,8,63,0,inf
14052,65,12,77,0,inf
14053,66,7,73,0,inf
14054,61,10,71,0,inf
14055,58,9,67,0,inf
14056,66,8,74,0,inf
14057,61,13,74,0,inf
14058,61,11,72,0,inf
14059,50,13,63,0,inf
14060,61,9,70,0,inf
14061,58,8,66,0,inf
14062,55,9,64,0,inf
14063,59,9,68,0,inf
14064,50,13,63,0,inf
14065,61,13,74,0,inf
14066,66,6,72,0,inf
14067,67,8,75,0,inf
14068,61,8,69,0,inf
14069,58,13,71,0,inf
14070,50,5,55,0,inf
14071,60,11,71,0,inf
14072,65,10,75,0,inf
14073,59,8,67,0,inf
14074,64,6,70,0,inf
14075,53,10,63,0,inf
14076,52,8,60,0,inf
14077,67,11,78,0,inf
14078,63,8,71,0,inf
14079,57,8,65,0,inf
14080,64,6,70,0,inf
14081,61,7,68,0,inf
14082,51,13,64,0,inf
14083,67,13,80,0,inf
14084,62,13,75,0,inf
14085,52,8,60,0,inf
14086,51,10,61,0,inf
14087,57,11,68,0,inf
14088,61,9,70,0,inf
14089,57,7,64,0,inf
14090,62,12,74,0,inf
14091,63,9,72,0,inf
14092,56,6,62,0,inf
14093,60,13,73,0,inf
14094,64,8,72,0,inf
14095,55,10,65,0,inf
14096,59,12,71,0,inf
14097,63,8,71,0,inf
14098,65,6,71,0,inf
14099,58,9,67,0,inf
14100,56,8,64,0,inf
14101,66,13,79,1,10.662766945842534
14102,67,5,72,0,inf
14103,61,7,68,0,inf
14104,56,11,67,0,inf
14105,62,5,67,0,inf
14106,64,12,76,1,4.489481414408559
14107,53,10,63,0,inf
14108,66,10,76,0,inf
14109,60,7,67,0,inf
14110,64,9,73,0,inf
14111,58,10,68,0,inf
14112,66,13,79,0,inf
14113,67,13,80,0,inf
14114,61,13,74,0,inf
14115,54,10,64,0,inf
14116,65,8,73,0,inf
14117,61,5,66,0,inf
14118,56,12,68,0,inf
14119,52,6,58,0,inf
14120,50,10,60,0,inf
14121,66,5,71,0,inf
14122,66,13,79,1,8.05770538553864
14123,55,11,66,0,inf
14124,64,8,72,0,inf
14125,51,10,61,0,inf
14126,63,11,74,0,inf
14127,57,5,62,0,inf
14128,50,5,55,0,inf
14129,62,12,74,0,inf
14130,51,11,62,0,inf
14131,57,9,66,0,inf
14132,56,9,65,0,inf
14133,66,11,77,0,inf
14134,61,10,71,0,inf
14135,59,7,66,0,inf
14136,50,12,62,0,inf
14137,63,5,68,0,inf
14138,63,5,68,0,inf
14139,67,6,73,0,inf
14140,53,13,66,0,inf
14141,53,8,61,0,inf
14142,67,11,78,0,inf
14143,67,8,75,0,inf
14144,51,13,64,0,inf
14145,62,10,72,0,inf
14146,61,11,72,1,7.629981777828959
14147,55,9,64,0,inf
14148,58,9,67,0,inf
14149,51,11,62,0,inf
14150,60,13,73,0,inf
14151,61,10,71,0,inf
14152,67,12,79,0,inf
14153,51,13,64,0,inf
14154,67,7,74,0,inf
14155,62,9,71,0,inf
14156,56,6,62,0,inf
14157,53,13,66,0,inf
14158,63,6,69,0,inf
14159,63,12,75,0,inf
14160,66,8,74,0,inf
14161,67,11,78,0,inf
14162,53,10,63,0,inf
14163,52,9,61,0,inf
14164,62,5,67,0,inf
14165,63,6,69,0,inf
14166,56,5,61,0,inf
14167,66,9,75,0,inf
14168,66,6,72,0,inf
14169,59,8,67,0,inf
14170,55,13,68,0,inf
14171,58,10,68,0,inf
14172,58,10,68,0,inf
14173,67,13,80,0,inf
14174,67,10,77,0,inf
14175,53,13,66,0,inf
14176,58,6,64,0,inf
14177,60,8,68,0,inf
14178,61,5,66,0,inf
14179,61,13,74,0,inf
14180,57,12,69,0,inf
14181,51,7,58,0,inf
14182,65,13,78,0,inf
14183,58,7,65,0,inf
14184,57,12,69,0,inf
14185,56,5,61,0,inf
14186,66,6,72,1,0.4174584242190491
14187,67,8,75,0,inf
14188,60,6,66,0,inf
14189,53,6,59,0,inf
14190,67,13,80,0,inf
14191,63,10,73,0,inf
14192,57,8,65,0,inf
14193,53,10,63,0,inf
14194,59,5,64,0,inf
14195,60,13,73,0,inf
14196,65,9,74,0,inf
14197,59,11,70,0,inf
14198,51,6,57,0,inf
14199,61,10,71,0,inf
14200,58,6,64,1,5.317909553684274
14201,51,9,60,1,8.270793672374488
14202,65,12,77,0,inf
14203,50,9,59,0,inf
14204,59,13,72,0,inf
14205,59,7,66,0,inf
14206,53,5,58,0,inf
14207,66,9,75,0,inf
14208,62,5,67,0,inf
14209,65,13,78,0,inf
14210,52,10,62,0,inf
14211,60,10,70,0,inf
14212,63,12,75,0,inf
14213,58,8,66,0,inf
14214,65,12,77,1,8.764080024331435
14215,66,12,78,0,inf
14216,59,6,65,0,inf
14217,55,9,64,0,inf
14218,50,6,56,0,inf
14219,57,5,62,0,inf
14220,59,7,66,0,inf
14221,64,9,73,0,inf
14222,60,12,72,0,inf
14223,62,11,73,0,inf
14224,50,5,55,0,inf
14225,63,7,70,0,inf
14226,62,8,70,0,inf
14227,61,11,72,0,inf
14228,60,5,65,0,inf
14229,59,6,65,0,inf
14230,62,5,67,0,inf
14231,56,8,64,0,inf
14232,55,7,62,0,inf
14233,56,7,63,0,inf
14234,67,10,77,0,inf
14235,64,11,75,0,inf
14236,65,10,75,0,inf
14237,64,12,76,1,6.624164548697934
14238,51,8,59,0,inf
14239,51,10,61,0,inf
14240,63,6,69,0,inf
14241,57,13,70,1,8.39854926409366
14242,52,12,64,0,inf
14243,64,12,76,0,inf
14244,60,8,68,0,inf
14245,58,7,65,0,inf
14246,55,7,62,0,inf
14247,59,8,67,0,inf
14248,55,13,68,0,inf
14249,62,8,70,0,inf
14250,55,11,66,0,inf
14251,61,13,74,0,inf
14252,50,9,59,1,2.423590229798222
14253,54,7,61,1,4.796247966093482
14254,57,11,68,0,inf
14255,65,9,74,0,inf
14256,66,5,71,0,inf
14257,58,11,69,0,inf
14258,55,12,67,0,inf
14259,59,13,72,0,inf
14260,61,8,69,0,inf
14261,51,6,57,0,inf
14262,50,5,55,0,inf
14263,58,13,71,0,inf
14264,58,9,67,0,inf
14265,63,13,76,0,inf
14266,51,5,56,0,inf
14267,64,12,76,0,inf
14268,54,12,66,0,inf
14269,65,5,70,0,inf
14270,62,5,67,0,inf
14271,55,13,68,0,inf
14272,51,10,61,0,inf
14273,65,6,71,0,inf
14274,55,9,64,0,inf
14275,58,5,63,0,inf
14276,59,10,69,0,inf
14277,56,10,66,0,inf
14278,62,7,69,0,inf
14279,63,7,70,0,inf
14280,58,6,64,0,inf
14281,65,9,74,0,inf
14282,64,11,75,0,inf
14283,60,9,69,0,inf
14284,64,8,72,0,inf
14285,54,5,59,0,inf
14286,52,8,60,0,inf
14287,63,13,76,0,inf
14288,51,8,59,0,inf
14289,63,6,69,0,inf
14290,51,9,60,0,inf
14291,54,7,61,0,inf
14292,55,9,64,0,inf
14293,62,9,71,0,inf
14294,54,10,64,0,inf
14295,52,10,62,0,inf
14296,53,12,65,0,inf
14297,57,12,69,0,inf
14298,52,11,63,0,inf
14299,63,6,69,0,inf
14300,57,11,68,0,inf
14301,57,8,65,0,inf
14302,64,13,77,0,inf
14303,67,10,77,0,inf
14304,58,11,69,1,3.728874669284295
14305,55,9,64,0,inf
14306,58,7,65,0,inf
14307,59,11,70,0,inf
14308,50,5,55,0,inf
14309,61,11,72,0,inf
14310,51,10,61,0,inf
14311,63,6,69,0,inf
14312,57,12,69,0,inf
14313,52,10,62,0,inf
14314,52,13,65,0,inf
14315,64,9,73,0,inf
14316,58,13,71,0,inf
14317,52,6,58,0,inf
14318,59,5,64,0,inf
14319,65,7,72,0,inf
14320,52,12,64,0,inf
14321,65,6,71,0,inf
14322,59,10,69,0,inf
14323,57,5,62,0,inf
14324,61,7,68,0,inf
14325,53,9,62,0,inf
14326,57,7,64,0,inf
14327,64,5,69,0,inf
14328,64,10,74,0,inf
14329,52,10,62,0,inf
14330,66,5,71,0,inf
14331,56,10,66,0,inf
14332,62,5,67,0,inf
14333,56,12,68,0,inf
14334,67,7,74,0,inf
14335,60,6,66,0,inf
14336,51,10,61,0,inf
14337,65,13,78,0,inf
14338,52,12,64,0,inf
14339,61,12,73,0,inf
14340,58,8,66,0,inf
14341,61,7,68,0,inf
14342,62,6,68,0,inf
14343,66,7,73,0,inf
14344,54,7,61,0,inf
14345,57,9,66,0,inf
14346,65,12,77,0,inf
14347,59,13,72,0,inf
14348,60,6,66,0,inf
14349,56,5,61,0,inf
14350,58,10,68,0,inf
14351,58,10,68,0,inf
14352,66,5,71,0,inf
14353,63,11,74,0,inf
14354,62,7,69,0,inf
14355,62,12,74,0,inf
14356,63,6,69,0,inf
14357,67,11,78,0,inf
14358,62,13,75,0,inf
14359,52,10,62,0,inf
14360,51,7,58,0,inf
14361,56,13,69,0,inf
14362,63,9,72,0,inf
14363,65,7,72,0,inf
14364,53,12,65,0,inf
14365,67,12,79,0,inf
14366,50,7,57,0,inf
14367,58,9,67,0,inf
14368,60,10,70,0,inf
14369,62,8,70,0,inf
14370,58,6,64,0,inf
14371,66,12,78,0,inf
14372,54,10,64,0,inf
14373,64,6,70,0,inf
14374,53,9,62,0,inf
14375,56,6,62,0,inf
14376,57,6,63,0,inf
14377,58,11,69,0,inf
14378,53,5,58,0,inf
14379,60,9,69,1,2.130063261742528
14380,61,11,72,0,inf
14381,57,6,63,0,inf
14382,65,12,77,0,inf
14383,52,5,57,0,inf
14384,61,8,69,0,inf
14385,56,11,67,0,inf
14386,57,11,68,1,6.2147684660490725
14387,59,9,68,0,inf
14388,52,5,57,0,inf
14389,54,12,66,0,inf
14390,62,7,69,0,inf
14391,59,5,64,0,inf
14392,57,5,62,0,inf
14393,56,6,62,0,inf
14394,53,12,65,0,inf
14395,50,5,55,0,inf
14396,61,5,66,0,inf
14397,64,8,72,0,inf
14398,51,13,64,0,inf
14399,67,8,75,1,3.7434874992880793
14400,61,8,69,0,inf
14401,60,11,71,0,inf
14402,58,10,68,0,inf
14403,52,13,65,0,inf
14404,54,6,60,0,inf
14405,56,7,63,0,inf
14406,53,11,64,0,inf
14407,58,5,63,0,inf
14408,59,9,68,0,inf
14409,66,6,72,1,5.754847220651357
14410,66,10,76,0,inf
14411,64,7,71,0,inf
14412,58,12,70,0,inf
14413,50,9,59,0,inf
14414,63,12,75,0,inf
14415,58,9,67,0,inf
14416,59,11,70,0,inf
14417,51,11,62,0,inf
14418,64,7,71,0,inf
14419,50,5,55,1,4.684834608314603
14420,54,7,61,0,inf
14421,66,13,79,0,inf
14422,53,11,64,0,inf
14423,64,12,76,0,inf
14424,52,6,58,0,inf
14425,64,7,71,0,inf
14426,60,9,69,0,inf
14427,62,11,73,0,inf
14428,67,11,78,0,inf
14429,64,7,71,0,inf
14430,52,6,58,0,inf
14431,50,12,62,0,inf
14432,62,6,68,0,inf
14433,59,5,64,0,inf
14434,66,5,71,0,inf
14435,63,6,69,0,inf
14436,56,12,68,0,inf
14437,60,13,73,0,inf
14438,65,8,73,0,inf
14439,55,8,63,0,inf
14440,53,6,59,0,inf
14441,54,9,63,0,inf
14442,60,13,73,0,inf
14443,61,7,68,0,inf
14444,63,7,70,0,inf
14445,55,5,60,0,inf
14446,59,11,70,0,inf
14447,55,12,67,1,1.1865731229756875
14448,60,10,70,0,inf
14449,56,7,63,0,inf
14450,51,5,56,0,inf
14451,65,12,77,0,inf
14452,60,11,71,0,inf
14453,59,8,67,0,inf
14454,57,7,64,0,inf
14455,50,10,60,0,inf
14456,67,5,72,0,inf
14457,61,12,73,0,inf
14458,67,7,74,0,inf
14459,66,6,72,0,inf
14460,67,11,78,0,inf
14461,64,5,69,0,inf
14462,57,12,69,0,inf
14463,64,5,69,0,inf
14464,53,5,58,0,inf
14465,63,11,74,1,8.600838924924389
14466,54,10,64,0,inf
14467,65,13,78,0,inf
14468,54,11,65,0,inf
14469,60,13,73,0,inf
14470,60,6,66,0,inf
14471,67,9,76,0,inf
14472,64,5,69,0,inf
14473,50,11,61,0,inf
14474,60,8,68,0,inf
14475,63,5,68,0,inf
14476,65,8,73,0,inf
14477,64,7,71,0,inf
14478,65,5,70,0,inf
14479,54,11,65,0,inf
14480,64,8,72,0,inf
14481,62,13,75,0,inf
14482,50,6,56,0,inf
14483,51,11,62,0,inf
14484,57,11,68,0,inf
14485,52,5,57,0,inf
14486,56,12,68,0,inf
14487,50,11,61,0,inf
14488,50,8,58,0,inf
14489,55,6,61,0,inf
14490,63,6,69,0,inf
14491,65,10,75,1,4.705089420082217
14492,65,11,76,0,inf
14493,57,13,70,0,inf
14494,58,7,65,0,inf
14495,67,9,76,0,inf
14496,53,12,65,0,inf
14497,59,11,70,0,inf
14498,57,12,69,0,inf
14499,66,11,77,0,inf
14500,66,8,74,0,inf
14501,61,6,67,0,inf
14502,62,10,72,0,inf
14503,50,13,63,0,inf
14504,64,5,69,0,inf
14505,50,8,58,0,inf
14506,50,8,58,0,inf
14507,58,7,65,0,inf
14508,59,13,72,0,inf
14509,67,5,72,0,inf
14510,59,11,70,0,inf
14511,51,10,61,0,inf
14512,58,7,65,0,inf
14513,67,6,73,0,inf
14514,65,10,75,0,inf
14515,66,9,75,0,inf
14516,57,5,62,0,inf
14517,62,12,74,0,inf
14518,62,11,73,0,inf
14519,51,5,56,0,inf
14520,60,13,73,0,inf
14521,52,8,60,0,inf
14522,63,8,71,0,inf
14523,65,5,70,1,4.104085365683147
14524,57,11,68,0,inf
14525,64,5,69,0,inf
14526,66,7,73,0,inf
14527,62,6,68,0,inf
14528,50,13,63,0,inf
14529,64,9,73,0,inf
14530,62,8,70,0,inf
14531,50,7,57,0,inf
14532,56,10,66,0,inf
14533,61,12,73,0,inf
14534,52,5,57,0,inf
14535,66,6,72,0,inf
14536,55,13,68,0,inf
14537,65,11,76,0,inf
14538,55,5,60,0,inf
14539,59,8,67,0,inf
14540,62,12,74,0,inf
14541,63,6,69,0,inf
14542,62,8,70,0,inf
14543,67,12,79,0,inf
14544,51,11,62,0,inf
14545,50,13,63,0,inf
14546,57,8,65,0,inf
14547,66,11,77,0,inf
14548,64,10,74,0,inf
14549,58,7,65,0,inf
14550,56,11,67,0,inf
14551,67,5,72,0,inf
14552,61,12,73,0,inf
14553,58,6,64,0,inf
14554,53,10,63,0,inf
14555,62,12,74,0,inf
14556,60,8,68,0,inf
14557,55,12,67,0,inf
14558,57,6,63,0,inf
14559,63,7,70,0,inf
14560,55,5,60,0,inf
14561,55,11,66,0,inf
14562,62,13,75,0,inf
14563,66,8,74,0,inf
14564,51,8,59,0,inf
14565,53,6,59,0,inf
14566,58,8,66,0,inf
14567,56,7,63,0,inf
14568,50,13,63,0,inf
14569,54,13,67,0,inf
14570,61,11,72,0,inf
14571,55,5,60,0,inf
14572,54,7,61,0,inf
14573,66,11,77,0,inf
14574,67,7,74,0,inf
14575,51,9,60,0,inf
14576,55,5,60,0,inf
14577,64,8,72,0,inf
14578,53,9,62,0,inf
14579,63,12,75,0,inf
14580,67,10,77,0,inf
14581,67,8,75,0,inf
14582,65,6,71,0,inf
14583,65,13,78,1,1.7888854973711261
14584,65,7,72,0,inf
14585,65,12,77,0,inf
14586,63,8,71,0,inf
14587,65,11,76,0,inf
14588,54,5,59,0,inf
14589,58,12,70,0,inf
14590,60,11,71,0,inf
14591,63,11,74,0,inf
14592,50,5,55,0,inf
14593,59,10,69,0,inf
14594,59,12,71,0,inf
14595,51,12,63,0,inf
14596,53,10,63,0,inf
14597,61,8,69,0,inf
14598,53,5,58,0,inf
14599,56,5,61,0,inf
14600,56,10,66,1,1.5302861312818763
14601,55,7,62,1,5.002531849655156
14602,51,7,58,0,inf
14603,62,5,67,0,inf
14604,59,5,64,0,inf
14605,50,10,60,0,inf
14606,67,11,78,0,inf
14607,64,11,75,0,inf
14608,59,10,69,0,inf
14609,50,5,55,0,inf
14610,59,9,68,0,inf
14611,54,13,67,0,inf
14612,59,13,72,0,inf
14613,54,10,64,0,inf
14614,60,9,69,0,inf
14615,60,10,70,0,inf
14616,65,7,72,0,inf
14617,58,13,71,0,inf
14618,60,9,69,0,inf
14619,54,12,66,0,inf
14620,61,6,67,0,inf
14621,51,10,61,0,inf
14622,56,12,68,0,inf
14623,64,5,69,0,inf
14624,58,6,64,0,inf
14625,65,7,72,0,inf
14626,57,12,69,0,inf
14627,58,12,70,0,inf
14628,54,6,60,0,inf
14629,58,13,71,0,inf
14630,60,6,66,0,inf
14631,51,5,56,0,inf
14632,55,8,63,0,inf
14633,60,10,70,0,inf
14634,51,8,59,0,inf
14635,50,13,63,0,inf
14636,63,12,75,0,inf
14637,57,10,67,0,inf
14638,58,6,64,0,inf
14639,56,5,61,0,inf
14640,53,8,61,0,inf
14641,62,7,69,0,inf
14642,52,6,58,0,inf
14643,58,10,68,0,inf
14644,65,13,78,0,inf
14645,58,5,63,0,inf
14646,66,6,72,0,inf
14647,62,9,71,0,inf
14648,61,7,68,0,inf
14649,62,6,68,0,inf
14650,58,5,63,0,inf
14651,57,12,69,0,inf
14652,54,10,64,0,inf
14653,50,13,63,0,inf
14654,64,9,73,0,inf
14655,54,11,65,0,inf
14656,67,6,73,0,inf
14657,58,13,71,0,inf
14658,64,10,74,0,inf
14659,62,10,72,0,inf
14660,50,8,58,0,inf
14661,56,7,63,0,inf
14662,59,6,65,0,inf
14663,56,5,61,0,inf
14664,54,6,60,0,inf
14665,51,5,56,0,inf
14666,56,11,67,0,inf
14667,53,11,64,0,inf
14668,62,7,69,0,inf
14669,59,6,65,1,1.523358089616579
14670,56,10,66,0,inf
14671,57,11,68,0,inf
14672,55,9,64,0,inf
14673,56,12,68,0,inf
14674,57,10,67,0,inf
14675,65,8,73,0,inf
14676,64,7,71,1,6.5325568126018965
14677,53,5,58,0,inf
14678,58,8,66,0,inf
14679,55,7,62,0,inf
14680,55,5,60,1,1.6693883260967013
14681,51,8,59,0,inf
14682,64,11,75,1,0.001195999317502583
14683,54,5,59,0,inf
14684,58,6,64,0,inf
14685,61,13,74,1,10.598178792602937
14686,54,11,65,0,inf
14687,56,10,66,0,inf
14688,64,5,69,0,inf
14689,58,13,71,0,inf
14690,51,7,58,0,inf
14691,51,12,63,0,inf
14692,53,9,62,0,inf
14693,66,6,72,0,inf
14694,65,13,78,0,inf
14695,54,6,60,0,inf
14696,65,9,74,0,inf
14697,61,5,66,0,inf
14698,52,13,65,0,inf
14699,58,11,69,0,inf
14700,55,10,65,0,inf
14701,65,9,74,0,inf
14702,56,9,65,0,inf
14703,61,10,71,0,inf
14704,66,6,72,0,inf
14705,50,11,61,0,inf
14706,53,11,64,0,inf
14707,61,13,74,0,inf
14708,50,8,58,0,inf
14709,62,12,74,0,inf
14710,66,12,78,0,inf
14711,55,8,63,0,inf
14712,66,8,74,0,inf
14713,61,9,70,0,inf
14714,66,9,75,0,inf
14715,61,10,71,0,inf
14716,65,5,70,0,inf
14717,52,6,58,0,inf
14718,63,12,75,0,inf
14719,58,7,65,0,inf
14720,62,9,71,0,inf
14721,53,5,58,0,inf
14722,62,5,67,0,inf
14723,60,5,65,0,inf
14724,67,7,74,0,inf
14725,63,8,71,0,inf
14726,57,7,64,0,inf
14727,63,11,74,0,inf
14728,63,9,72,0,inf
14729,67,5,72,0,inf
14730,52,13,65,0,inf
14731,63,10,73,0,inf
14732,57,10,67,1,2.6668640831751134
14733,61,9,70,0,inf
14734,51,10,61,0,inf
14735,54,5,59,0,inf
14736,52,10,62,0,inf
14737,56,6,62,0,inf
14738,67,5,72,0,inf
14739,65,11,76,0,inf
14740,52,8,60,0,inf
14741,62,12,74,0,inf
14742,54,5,59,0,inf
14743,63,13,76,0,inf
14744,60,12,72,0,inf
14745,55,13,68,0,inf
14746,64,6,70,0,inf
14747,60,6,66,0,inf
14748,63,13,76,0,inf
14749,58,10,68,0,inf
14750,58,13,71,0,inf
14751,52,12,64,0,inf
14752,59,9,68,0,inf
14753,57,6,63,0,inf
14754,58,7,65,0,inf
14755,63,7,70,0,inf
14756,65,6,71,0,inf
14757,53,7,60,0,inf
14758,54,5,59,0,inf
14759,56,7,63,0,inf
14760,57,7,64,0,inf
14761,61,12,73,0,inf
14762,58,13,71,0,inf
14763,64,12,76,0,inf
14764,50,12,62,0,inf
14765,55,5,60,0,inf
14766,65,12,77,0,inf
14767,51,8,59,0,inf
14768,56,9,65,0,inf
14769,61,8,69,0,inf
14770,55,7,62,0,inf
14771,60,11,71,0,inf
14772,50,12,62,0,inf
14773,61,9,70,0,inf
14774,52,7,59,0,inf
14775,54,7,61,0,inf
14776,55,5,60,0,inf
14777,63,11,74,0,inf
14778,59,13,72,0,inf
14779,67,11,78,0,inf
14780,58,7,65,0,inf
14781,59,5,64,0,inf
14782,57,11,68,0,inf
14783,57,12,69,0,inf
14784,62,7,69,0,inf
14785,60,12,72,0,inf
14786,62,9,71,0,inf
14787,54,13,67,0,inf
14788,66,11,77,0,inf
14789,56,6,62,0,inf
14790,52,6,58,0,inf
14791,61,13,74,0,inf
14792,60,7,67,0,inf
14793,63,12,75,0,inf
14794,59,11,70,0,inf
14795,57,7,64,0,inf
14796,56,12,68,1,1.230551692060402
14797,51,6,57,0,inf
14798,50,12,62,0,inf
14799,63,9,72,0,inf
14800,63,7,70,0,inf
14801,64,6,70,0,inf
14802,58,8,66,0,inf
14803,53,8,61,0,inf
14804,56,5,61,0,inf
14805,67,12,79,0,inf
14806,66,6,72,0,inf
14807,62,12,74,0,inf
14808,53,9,62,0,inf
14809,56,5,61,0,inf
14810,66,7,73,0,inf
14811,65,8,73,0,inf
14812,54,13,67,0,inf
14813,57,8,65,0,inf
14814,66,7,73,0,inf
14815,67,12,79,0,inf
14816,65,10,75,0,inf
14817,60,6,66,0,inf
14818,59,11,70,0,inf
14819,60,9,69,0,inf
14820,51,8,59,0,inf
14821,50,5,55,0,inf
14822,60,10,70,0,inf
14823,55,8,63,0,inf
14824,59,5,64,0,inf
14825,51,7,58,0,inf
14826,54,10,64,0,inf
14827,57,6,63,0,inf
14828,50,8,58,0,inf
14829,58,5,63,0,inf
14830,65,11,76,0,inf
14831,60,9,69,0,inf
14832,58,12,70,0,inf
14833,57,7,64,0,inf
14834,65,9,74,0,inf
14835,59,11,70,0,inf
14836,61,12,73,1,9.031062171107834
14837,54,8,62,0,inf
14838,63,9,72,0,inf
14839,54,12,66,0,inf
14840,62,8,70,0,inf
14841,65,5,70,0,inf
14842,55,13,68,0,inf
14843,59,8,67,0,inf
14844,57,10,67,0,inf
14845,59,12,71,0,inf
14846,53,5,58,0,inf
14847,65,7,72,0,inf
14848,56,6,62,0,inf
14849,53,12,65,0,inf
14850,56,9,65,0,inf
14851,53,11,64,0,inf
14852,64,5,69,0,inf
14853,61,12,73,1,3.2833764512417787
14854,65,9,74,0,inf
14855,55,12,67,0,inf
14856,54,13,67,0,inf
14857,57,11,68,0,inf
14858,58,6,64,0,inf
14859,54,7,61,0,inf
14860,53,8,61,0,inf
14861,61,12,73,0,inf
14862,64,5,69,0,inf
14863,61,5,66,0,inf
14864,65,10,75,0,inf
14865,63,8,71,0,inf
14866,63,7,70,0,inf
14867,62,6,68,0,inf
14868,60,12,72,0,inf
14869,56,13,69,0,inf
14870,59,13,72,0,inf
14871,57,7,64,0,inf
14872,59,13,72,0,inf
14873,64,12,76,0,inf
14874,65,6,71,0,inf
14875,56,12,68,0,inf
14876,63,11,74,0,inf
14877,62,6,68,0,inf
14878,57,8,65,0,inf
14879,64,10,74,0,inf
14880,55,5,60,0,inf
14881,65,8,73,0,inf
14882,57,5,62,0,inf
14883,58,10,68,0,inf
14884,50,13,63,0,inf
14885,67,12,79,0,inf
14886,61,10,71,0,inf
14887,62,11,73,0,inf
14888,52,8,60,0,inf
14889,65,9,74,0,inf
14890,66,5,71,0,inf
14891,50,10,60,0,inf
14892,57,5,62,0,inf
14893,66,8,74,0,inf
14894,65,10,75,0,inf
14895,60,7,67,0,inf
14896,53,6,59,0,inf
14897,60,9,69,0,inf
14898,55,8,63,0,inf
14899,54,5,59,0,inf
14900,65,12,77,0,inf
14901,67,5,72,0,inf
14902,57,8,65,0,inf
14903,50,13,63,0,inf
14904,64,9,73,0,inf
14905,60,8,68,0,inf
14906,66,8,74,0,inf
14907,63,6,69,0,inf
14908,55,8,63,0,inf
14909,64,10,74,1,6.198209651017805
14910,60,10,70,0,inf
14911,51,8,59,0,inf
14912,58,13,71,0,inf
14913,54,9,63,0,inf
14914,64,12,76,0,inf
14915,58,13,71,0,inf
14916,57,11,68,0,inf
14917,64,12,76,0,inf
14918,60,5,65,0,inf
14919,50,12,62,0,inf
14920,61,7,68,0,inf
14921,67,12,79,0,inf
14922,59,10,69,0,inf
14923,53,12,65,0,inf
14924,64,10,74,0,inf
14925,53,11,64,0,inf
14926,66,9,75,0,inf
14927,60,8,68,0,inf
14928,66,10,76,0,inf
14929,64,10,74,0,inf
14930,59,11,70,0,inf
14931,66,11,77,0,inf
14932,61,7,68,0,inf
14933,58,12,70,0,inf
14934,51,13,64,0,inf
14935,62,9,71,0,inf
14936,56,9,65,0,inf
14937,54,5,59,0,inf
14938,56,12,68,0,inf
14939,60,12,72,0,inf
14940,63,8,71,0,inf
14941,65,13,78,0,inf
14942,56,5,61,0,inf
14943,56,13,69,0,inf
14944,65,13,78,0,inf
14945,65,6,71,0,inf
14946,66,11,77,0,inf
14947,50,5,55,0,inf
14948,56,5,61,0,inf
14949,57,13,70,0,inf
14950,59,5,64,0,inf
14951,65,6,71,0,inf
14952,62,12,74,0,inf
14953,66,7,73,0,inf
14954,53,9,62,0,inf
14955,56,13,69,0,inf
14956,63,11,74,0,inf
14957,63,12,75,1,4.6806692914123005
14958,52,13,65,0,inf
14959,62,8,70,0,inf
14960,58,10,68,0,inf
14961,54,13,67,0,inf
14962,65,13,78,0,inf
14963,50,12,62,0,inf
14964,61,6,67,0,inf
14965,53,10,63,0,inf
14966,61,9,70,0,inf
14967,52,13,65,0,inf
14968,66,8,74,0,inf
14969,64,11,75,1,1.7889581790265794
14970,53,6,59,0,inf
14971,54,8,62,0,inf
14972,51,13,64,0,inf
14973,65,11,76,0,inf
14974,66,13,79,0,inf
14975,60,5,65,0,inf
14976,56,10,66,0,inf
14977,63,6,69,0,inf
14978,66,11,77,0,inf
14979,60,13,73,0,inf
14980,62,9,71,0,inf
14981,55,12,67,0,inf
14982,54,6,60,0,inf
14983,50,9,59,0,inf
14984,51,10,61,0,inf
14985,65,12,77,1,4.26301279694097
14986,58,8,66,0,inf
14987,60,7,67,0,inf
14988,62,7,69,0,inf
14989,54,6,60,0,inf
14990,67,11,78,0,inf
14991,61,6,67,0,inf
14992,66,12,78,0,inf
14993,51,9,60,0,inf
14994,55,13,68,0,inf
14995,56,8,64,0,inf
14996,57,11,68,0,inf
14997,64,6,70,0,inf
14998,52,7,59,0,inf
14999,63,10,73,1,3.296826164066161
15000,67,9,76,0,inf
15001,58,9,67,0,inf
15002,54,9,63,0,inf
15003,66,11,77,0,inf
15004,60,12,72,0,inf
15005,65,9,74,0,inf
15006,51,8,59,0,inf
15007,61,5,66,0,inf
15008,54,11,65,0,inf
15009,57,11,68,0,inf
15010,53,13,66,0,inf
15011,56,6,62,0,inf
15012,59,8,67,0,inf
15013,66,8,74,0,inf
15014,58,7,65,0,inf
15015,59,6,65,0,inf
15016,56,7,63,0,inf
15017,56,11,67,0,inf
15018,66,10,76,0,inf
15019,61,10,71,0,inf
15020,56,5,61,0,inf
15021,65,10,75,0,inf
15022,50,6,56,0,inf
15023,52,8,60,0,inf
15024,63,13,76,1,2.3834526280757586
15025,56,12,68,0,inf
15026,57,10,67,0,inf
15027,61,13,74,0,inf
15028,66,13,79,0,inf
15029,53,10,63,0,inf
15030,52,8,60,0,inf
15031,67,7,74,0,inf
15032,58,9,67,0,inf
15033,61,11,72,0,inf
15034,52,12,64,0,inf
15035,59,6,65,0,inf
15036,56,8,64,0,inf
15037,52,9,61,0,inf
15038,65,10,75,0,inf
15039,67,10,77,0,inf
15040,55,7,62,0,inf
15041,58,10,68,1,7.207678742809534
15042,52,7,59,0,inf
15043,53,6,59,0,inf
15044,50,8,58,0,inf
15045,64,7,71,0,inf
15046,53,12,65,0,inf
15047,66,12,78,0,inf
15048,58,12,70,0,inf
15049,54,7,61,0,inf
15050,62,12,74,0,inf
15051,50,10,60,0,inf
15052,62,11,73,0,inf
15053,67,10,77,0,inf
15054,52,5,57,0,inf
15055,59,10,69,0,inf
15056,59,7,66,0,inf
15057,66,7,73,0,inf
15058,67,6,73,0,inf
15059,53,6,59,0,inf
15060,58,7,65,0,inf
15061,64,7,71,0,inf
15062,64,13,77,0,inf
15063,57,8,65,0,inf
15064,66,5,71,0,inf
15065,52,8,60,0,inf
15066,52,11,63,0,inf
15067,61,5,66,0,inf
15068,56,10,66,0,inf
15069,55,12,67,0,inf
15070,66,10,76,0,inf
15071,55,5,60,0,inf
15072,67,6,73,0,inf
15073,61,8,69,1,1.5973843153740006
15074,53,5,58,0,inf
15075,64,12,76,0,inf
15076,51,6,57,0,inf
15077,51,10,61,0,inf
15078,52,7,59,0,inf
15079,64,10,74,0,inf
15080,53,12,65,0,inf
15081,52,8,60,0,inf
15082,52,7,59,0,inf
15083,57,5,62,0,inf
15084,67,12,79,0,inf
15085,64,5,69,0,inf
15086,52,6,58,0,inf
15087,63,8,71,0,inf
15088,59,7,66,0,inf
15089,53,5,58,0,inf
15090,52,12,64,0,inf
15091,62,8,70,0,inf
15092,53,7,60,0,inf
15093,53,7,60,0,inf
15094,57,12,69,0,inf
15095,61,10,71,0,inf
15096,54,8,62,0,inf
15097,66,5,71,0,inf
15098,58,11,69,0,inf
15099,63,7,70,0,inf
15100,60,5,65,0,inf
15101,66,7,73,0,inf
15102,60,8,68,0,inf
15103,65,6,71,0,inf
15104,50,11,61,0,inf
15105,53,9,62,0,inf
15106,53,13,66,0,inf
15107,63,12,75,0,inf
15108,67,7,74,0,inf
15109,57,9,66,0,inf
15110,59,11,70,0,inf
15111,61,13,74,0,inf
15112,66,6,72,0,inf
15113,62,7,69,0,inf
15114,53,13,66,0,inf
15115,62,6,68,0,inf
15116,54,6,60,0,inf
15117,67,13,80,0,inf
15118,60,7,67,0,inf
15119,61,11,72,0,inf
15120,63,7,70,0,inf
15121,62,7,69,0,inf
15122,57,9,66,0,inf
15123,50,10,60,0,inf
15124,52,7,59,0,inf
15125,57,11,68,1,7.328062350271736
15126,62,5,67,0,inf
15127,51,8,59,0,inf
15128,58,12,70,0,inf
15129,58,6,64,0,inf
15130,58,10,68,0,inf
15131,62,5,67,0,inf
15132,55,7,62,0,inf
15133,63,10,73,0,inf
15134,67,13,80,0,inf
15135,67,11,78,0,inf
15136,55,13,68,0,inf
15137,64,10,74,0,inf
15138,60,11,71,0,inf
15139,66,8,74,0,inf
15140,62,8,70,0,inf
15141,65,8,73,0,inf
15142,51,10,61,0,inf
15143,64,9,73,0,inf
15144,51,13,64,0,inf
15145,60,12,72,0,inf
15146,50,9,59,0,inf
15147,52,8,60,0,inf
15148,58,9,67,0,inf
15149,55,9,64,0,inf
15150,55,8,63,0,inf
15151,55,7,62,0,inf
15152,52,11,63,0,inf
15153,54,8,62,0,inf
15154,62,11,73,0,inf
15155,65,12,77,0,inf
15156,58,13,71,0,inf
15157,64,9,73,0,inf
15158,63,11,74,0,inf
15159,52,10,62,0,inf
15160,56,13,69,0,inf
15161,61,6,67,0,inf
15162,66,6,72,0,inf
15163,52,11,63,0,inf
15164,61,13,74,0,inf
15165,58,10,68,0,inf
15166,52,5,57,0,inf
15167,53,5,58,0,inf
15168,67,12,79,0,inf
15169,67,6,73,0,inf
15170,67,11,78,0,inf
15171,57,5,62,0,inf
15172,50,5,55,0,inf
15173,60,12,72,0,inf
15174,56,12,68,0,inf
15175,61,12,73,0,inf
15176,60,5,65,0,inf
15177,57,7,64,0,inf
15178,64,12,76,0,inf
15179,52,8,60,0,inf
15180,57,5,62,0,inf
15181,65,6,71,0,inf
15182,58,8,66,0,inf
15183,58,5,63,0,inf
15184,52,11,63,0,inf
15185,52,10,62,0,inf
15186,60,11,71,0,inf
15187,63,11,74,0,inf
15188,52,6,58,0,inf
15189,65,13,78,0,inf
15190,67,11,78,0,inf
15191,66,8,74,0,inf
15192,55,8,63,0,inf
15193,52,9,61,0,inf
15194,52,10,62,0,inf
15195,66,5,71,0,inf
15196,55,8,63,0,inf
15197,64,13,77,0,inf
15198,61,13,74,0,inf
15199,58,8,66,0,inf
15200,50,5,55,0,inf
15201,58,10,68,0,inf
15202,64,5,69,0,inf
15203,61,10,71,0,inf
15204,67,7,74,0,inf
15205,53,5,58,0,inf
15206,55,10,65,0,inf
15207,57,11,68,0,inf
15208,63,8,71,0,inf
15209,59,13,72,0,inf
15210,67,10,77,0,inf
15211,50,6,56,0,inf
15212,58,12,70,0,inf
15213,61,7,68,0,inf
15214,66,7,73,0,inf
15215,56,11,67,0,inf
15216,55,13,68,0,inf
15217,55,10,65,0,inf
15218,64,6,70,0,inf
15219,62,10,72,0,inf
15220,52,9,61,0,inf
15221,56,6,62,0,inf
15222,54,13,67,0,inf
15223,56,10,66,0,inf
15224,57,8,65,0,inf
15225,51,7,58,0,inf
15226,66,13,79,0,inf
15227,60,13,73,0,inf
15228,63,9,72,0,inf
15229,53,12,65,0,inf
15230,67,10,77,0,inf
15231,50,9,59,0,inf
15232,55,8,63,0,inf
15233,56,10,66,0,inf
15234,59,6,65,0,inf
15235,58,8,66,0,inf
15236,59,9,68,1,5.429602681584171
15237,50,7,57,0,inf
15238,52,6,58,0,inf
15239,62,7,69,0,inf
15240,64,6,70,0,inf
15241,56,11,67,0,inf
15242,63,6,69,0,inf
15243,65,9,74,0,inf
15244,62,6,68,0,inf
15245,54,6,60,0,inf
15246,52,9,61,0,inf
15247,65,11,76,0,inf
15248,60,6,66,0,inf
15249,53,10,63,0,inf
15250,54,8,62,0,inf
15251,53,6,59,0,inf
15252,56,13,69,0,inf
15253,59,9,68,0,inf
15254,50,7,57,0,inf
15255,57,6,63,0,inf
15256,63,12,75,0,inf
15257,63,11,74,0,inf
15258,67,11,78,0,inf
15259,55,9,64,0,inf
15260,57,9,66,0,inf
15261,55,5,60,0,inf
15262,60,12,72,0,inf
15263,52,5,57,0,inf
15264,56,11,67,0,inf
15265,60,7,67,0,inf
15266,54,6,60,0,inf
15267,51,12,63,0,inf
15268,66,10,76,0,inf
15269,56,7,63,0,inf
15270,64,13,77,0,inf
15271,60,10,70,0,inf
15272,59,6,65,0,inf
15273,65,10,75,0,inf
15274,55,5,60,0,inf
15275,63,12,75,0,inf
15276,65,5,70,0,inf
15277,60,9,69,0,inf
15278,51,6,57,0,inf
15279,63,8,71,0,inf
15280,66,5,71,0,inf
15281,62,11,73,0,inf
15282,50,9,59,0,inf
15283,62,5,67,1,2.81816383688016
15284,56,8,64,0,inf
15285,63,12,75,0,inf
15286,64,11,75,0,inf
15287,54,10,64,0,inf
15288,66,9,75,0,inf
15289,61,9,70,0,inf
15290,62,10,72,0,inf
15291,51,12,63,0,inf
15292,56,9,65,0,inf
15293,65,9,74,0,inf
15294,64,6,70,0,inf
15295,67,5,72,0,inf
15296,62,6,68,0,inf
15297,62,9,71,0,inf
15298,67,12,79,0,inf
15299,57,11,68,0,inf
15300,67,7,74,1,2.7938856794854843
15301,67,5,72,0,inf
15302,67,11,78,0,inf
15303,54,12,66,0,inf
15304,66,13,79,0,inf
15305,55,13,68,0,inf
15306,67,5,72,0,inf
15307,58,8,66,0,inf
15308,59,8,67,0,inf
15309,58,10,68,0,inf
15310,63,11,74,0,inf
15311,55,5,60,0,inf
15312,52,6,58,0,inf
15313,55,11,66,0,inf
15314,65,11,76,0,inf
15315,55,11,66,0,inf
15316,65,5,70,0,inf
15317,55,13,68,0,inf
15318,62,5,67,0,inf
15319,58,5,63,0,inf
15320,66,12,78,0,inf
15321,53,13,66,0,inf
15322,50,7,57,0,inf
15323,64,6,70,0,inf
15324,64,13,77,0,inf
15325,54,12,66,0,inf
15326,55,7,62,0,inf
15327,57,5,62,0,inf
15328,65,13,78,0,inf
15329,60,9,69,0,inf
15330,61,11,72,0,inf
15331,62,13,75,0,inf
15332,52,8,60,0,inf
15333,57,8,65,0,inf
15334,59,13,72,0,inf
15335,63,6,69,0,inf
15336,52,12,64,0,inf
15337,66,7,73,0,inf
15338,60,7,67,0,inf
15339,62,13,75,0,inf
15340,53,5,58,0,inf
15341,65,11,76,0,inf
15342,52,7,59,1,5.95742459376406
15343,60,8,68,0,inf
15344,60,6,66,1,0.330686679096992
15345,60,7,67,0,inf
15346,50,11,61,0,inf
15347,64,6,70,0,inf
15348,59,5,64,0,inf
15349,53,11,64,0,inf
15350,56,8,64,0,inf
15351,61,10,71,0,inf
15352,67,5,72,0,inf
15353,67,6,73,0,inf
15354,54,8,62,0,inf
15355,59,12,71,0,inf
15356,56,10,66,0,inf
15357,63,8,71,0,inf
15358,66,6,72,0,inf
15359,67,6,73,0,inf
15360,63,6,69,0,inf
15361,57,12,69,1,8.759308681625967
15362,59,11,70,0,inf
15363,66,6,72,0,inf
15364,57,13,70,0,inf
15365,55,13,68,0,inf
15366,58,5,63,0,inf
15367,59,6,65,0,inf
15368,53,7,60,0,inf
15369,55,8,63,0,inf
15370,65,8,73,0,inf
15371,60,8,68,0,inf
15372,51,12,63,0,inf
15373,67,7,74,0,inf
15374,54,8,62,0,inf
15375,61,5,66,0,inf
15376,64,13,77,0,inf
15377,55,5,60,0,inf
15378,54,7,61,0,inf
15379,52,7,59,0,inf
15380,53,8,61,0,inf
15381,60,6,66,0,inf
15382,56,6,62,0,inf
15383,50,6,56,0,inf
15384,61,11,72,0,inf
15385,55,12,67,0,inf
15386,56,12,68,0,inf
15387,67,7,74,0,inf
15388,51,12,63,0,inf
15389,50,6,56,0,inf
15390,62,11,73,0,inf
15391,53,8,61,0,inf
15392,53,9,62,0,inf
15393,60,8,68,0,inf
15394,63,5,68,0,inf
15395,61,7,68,0,inf
15396,56,8,64,0,inf
15397,55,8,63,0,inf
15398,67,13,80,0,inf
15399,67,10,77,1,1.1017867695987178
15400,67,5,72,0,inf
15401,58,6,64,0,inf
15402,61,7,68,0,inf
15403,63,11,74,0,inf
15404,50,7,57,0,inf
15405,66,8,74,0,inf
15406,61,12,73,0,inf
15407,63,6,69,0,inf
15408,55,5,60,0,inf
15409,56,9,65,0,inf
15410,64,7,71,0,inf
15411,64,11,75,0,inf
15412,64,7,71,0,inf
15413,51,8,59,0,inf
15414,64,9,73,0,inf
15415,59,9,68,0,inf
15416,66,6,72,0,inf
15417,59,11,70,0,inf
15418,54,8,62,0,inf
15419,59,13,72,0,inf
15420,55,11,66,0,inf
15421,62,7,69,0,inf
15422,56,6,62,0,inf
15423,54,8,62,0,inf
15424,57,10,67,0,inf
15425,65,8,73,0,inf
15426,67,5,72,0,inf
15427,62,10,72,0,inf
15428,60,6,66,0,inf
15429,61,12,73,0,inf
15430,58,9,67,0,inf
15431,62,9,71,0,inf
15432,57,9,66,1,4.225527002100051
15433,58,12,70,0,inf
15434,52,6,58,0,inf
15435,51,13,64,1,10.644429384924457
15436,52,6,58,0,inf
15437,51,13,64,0,inf
15438,54,11,65,0,inf
15439,57,9,66,0,inf
15440,62,8,70,0,inf
15441,57,12,69,0,inf
15442,51,9,60,0,inf
15443,62,6,68,0,inf
15444,55,11,66,0,inf
15445,64,13,77,0,inf
15446,59,6,65,0,inf
15447,53,8,61,0,inf
15448,62,13,75,0,inf
15449,60,7,67,1,4.703283978756559
15450,55,6,61,0,inf
15451,54,7,61,0,inf
15452,60,11,71,0,inf
15453,57,11,68,0,inf
15454,52,13,65,0,inf
15455,67,8,75,0,inf
15456,53,5,58,0,inf
15457,64,10,74,0,inf
15458,64,5,69,0,inf
15459,50,10,60,0,inf
15460,61,11,72,0,inf
15461,65,6,71,0,inf
15462,57,11,68,0,inf
15463,60,10,70,0,inf
15464,56,6,62,0,inf
15465,64,13,77,0,inf
15466,52,10,62,0,inf
15467,66,13,79,0,inf
15468,62,10,72,0,inf
15469,66,5,71,0,inf
15470,64,13,77,0,inf
15471,66,9,75,0,inf
15472,60,9,69,0,inf
15473,58,13,71,0,inf
15474,62,12,74,0,inf
15475,66,7,73,0,inf
15476,52,7,59,0,inf
15477,64,12,76,0,inf
15478,62,13,75,0,inf
15479,64,7,71,0,inf
15480,56,11,67,0,inf
15481,53,13,66,0,inf
15482,59,11,70,0,inf
15483,58,13,71,0,inf
15484,63,12,75,0,inf
15485,59,12,71,0,inf
15486,55,8,63,0,inf
15487,50,8,58,0,inf
15488,63,7,70,1,4.916715068944697
15489,63,13,76,0,inf
15490,55,10,65,0,inf
15491,62,9,71,0,inf
15492,56,6,62,0,inf
15493,51,12,63,0,inf
15494,62,11,73,1,10.894586206874905
15495,53,8,61,0,inf
15496,67,6,73,0,inf
15497,66,9,75,0,inf
15498,55,7,62,0,inf
15499,53,12,65,0,inf
15500,54,12,66,0,inf
15501,50,6,56,0,inf
15502,67,11,78,0,inf
15503,59,11,70,0,inf
15504,52,7,59,0,inf
15505,56,7,63,0,inf
15506,57,9,66,0,inf
15507,67,10,77,0,inf
15508,57,6,63,0,inf
15509,54,8,62,0,inf
15510,53,13,66,0,inf
15511,58,9,67,0,inf
15512,61,12,73,0,inf
15513,66,10,76,0,inf
15514,59,5,64,0,inf
15515,62,10,72,0,inf
15516,62,10,72,1,4.887722738586376
15517,55,11,66,0,inf
15518,56,9,65,0,inf
15519,61,7,68,0,inf
15520,65,8,73,0,inf
15521,62,6,68,0,inf
15522,63,10,73,1,2.2037816024887604
15523,64,12,76,0,inf
15524,59,10,69,0,inf
15525,59,8,67,0,inf
15526,60,11,71,0,inf
15527,66,8,74,0,inf
15528,57,5,62,0,inf
15529,51,7,58,0,inf
15530,63,6,69,0,inf
15531,57,7,64,0,inf
15532,63,13,76,0,inf
15533,55,10,65,0,inf
15534,59,13,72,1,1.4804649402475292
15535,51,7,58,0,inf
15536,50,7,57,0,inf
15537,67,7,74,0,inf
15538,67,6,73,0,inf
15539,62,13,75,0,inf
15540,51,8,59,0,inf
15541,60,9,69,1,6.433113358223224
15542,55,8,63,0,inf
15543,64,12,76,0,inf
15544,56,13,69,0,inf
15545,56,5,61,0,inf
15546,52,6,58,0,inf
15547,52,11,63,1,1.5188637774003126
15548,64,7,71,0,inf
15549,59,5,64,0,inf
15550,55,11,66,0,inf
15551,55,10,65,0,inf
15552,63,6,69,0,inf
15553,54,13,67,1,9.406804803134818
15554,56,7,63,0,inf
15555,52,9,61,0,inf
15556,52,5,57,0,inf
15557,54,5,59,0,inf
15558,67,11,78,0,inf
15559,63,12,75,0,inf
15560,54,6,60,0,inf
15561,59,12,71,0,inf
15562,58,12,70,0,inf
15563,63,13,76,0,inf
15564,66,7,73,0,inf
15565,67,9,76,0,inf
15566,55,13,68,0,inf
15567,61,5,66,0,inf
15568,64,5,69,0,inf
15569,59,5,64,0,inf
15570,53,8,61,0,inf
15571,67,9,76,0,inf
15572,58,7,65,0,inf
15573,59,12,71,0,inf
15574,65,8,73,0,inf
15575,56,13,69,0,inf
15576,51,13,64,0,inf
15577,62,12,74,0,inf
15578,59,7,66,0,inf
15579,57,6,63,0,inf
15580,60,13,73,0,inf
15581,61,8,69,0,inf
15582,50,6,56,0,inf
15583,55,6,61,0,inf
15584,52,10,62,0,inf
15585,58,12,70,0,inf
15586,59,8,67,0,inf
15587,50,13,63,0,inf
15588,65,13,78,0,inf
15589,65,8,73,0,inf
15590,57,11,68,0,inf
15591,57,6,63,0,inf
15592,65,12,77,0,inf
15593,67,13,80,0,inf
15594,50,9,59,0,inf
15595,67,12,79,0,inf
15596,57,12,69,0,inf
15597,67,11,78,0,inf
15598,64,10,74,0,inf
15599,67,9,76,0,inf
15600,66,8,74,0,inf
15601,62,6,68,0,inf
15602,62,11,73,0,inf
15603,53,6,59,0,inf
15604,63,6,69,0,inf
15605,57,13,70,0,inf
15606,58,12,70,0,inf
15607,63,5,68,0,inf
15608,61,7,68,0,inf
15609,56,12,68,0,inf
15610,56,10,66,0,inf
15611,51,8,59,0,inf
15612,61,8,69,1,3.4266784802371006
15613,50,10,60,0,inf
15614,54,7,61,0,inf
15615,57,12,69,0,inf
15616,64,7,71,0,inf
15617,55,11,66,0,inf
15618,65,7,72,0,inf
15619,67,5,72,0,inf
15620,51,11,62,0,inf
15621,63,5,68,0,inf
15622,54,12,66,0,inf
15623,59,5,64,0,inf
15624,53,7,60,0,inf
15625,59,9,68,0,inf
15626,61,12,73,0,inf
15627,60,10,70,0,inf
15628,56,12,68,0,inf
15629,63,10,73,0,inf
15630,66,11,77,0,inf
15631,55,13,68,0,inf
15632,53,6,59,0,inf
15633,53,5,58,0,inf
15634,55,11,66,0,inf
15635,59,6,65,0,inf
15636,66,7,73,0,inf
15637,59,11,70,0,inf
15638,63,5,68,0,inf
15639,52,6,58,0,inf
15640,63,12,75,0,inf
15641,60,9,69,0,inf
15642,55,7,62,0,inf
15643,55,6,61,0,inf
15644,51,10,61,0,inf
15645,60,8,68,1,4.970638912947948
15646,50,13,63,0,inf
15647,55,12,67,0,inf
15648,59,5,64,0,inf
15649,63,6,69,0,inf
15650,67,5,72,0,inf
15651,55,11,66,0,inf
15652,64,6,70,0,inf
15653,66,8,74,0,inf
15654,64,12,76,0,inf
15655,62,5,67,0,inf
15656,63,10,73,0,inf
15657,57,10,67,0,inf
15658,63,12,75,0,inf
15659,51,6,57,0,inf
15660,63,5,68,0,inf
15661,51,13,64,0,inf
15662,51,11,62,0,inf
15663,58,5,63,0,inf
15664,65,10,75,0,inf
15665,50,10,60,0,inf
15666,58,11,69,0,inf
15667,66,11,77,0,inf
15668,58,9,67,0,inf
15669,58,5,63,0,inf
15670,67,13,80,0,inf
15671,58,12,70,0,inf
15672,63,10,73,0,inf
15673,57,12,69,0,inf
15674,64,13,77,0,inf
15675,57,8,65,0,inf
15676,63,6,69,0,inf
15677,51,5,56,0,inf
15678,55,12,67,0,inf
15679,63,12,75,0,inf
15680,66,13,79,0,inf
15681,50,10,60,0,inf
15682,57,9,66,0,inf
15683,60,13,73,0,inf
15684,52,13,65,0,inf
15685,62,5,67,0,inf
15686,51,7,58,0,inf
15687,50,5,55,0,inf
15688,57,8,65,0,inf
15689,56,8,64,0,inf
15690,50,10,60,0,inf
15691,52,7,59,0,inf
15692,63,13,76,0,inf
15693,65,7,72,0,inf
15694,65,10,75,0,inf
15695,53,13,66,0,inf
15696,63,11,74,0,inf
15697,63,8,71,0,inf
15698,66,5,71,0,inf
15699,56,12,68,1,11.514257818862532
15700,64,8,72,0,inf
15701,57,11,68,0,inf
15702,59,9,68,0,inf
15703,62,13,75,0,inf
15704,65,12,77,0,inf
15705,56,7,63,0,inf
15706,59,13,72,0,inf
15707,60,8,68,0,inf
15708,59,13,72,0,inf
15709,65,7,72,0,inf
15710,51,6,57,0,inf
15711,64,5,69,0,inf
15712,67,6,73,0,inf
15713,57,5,62,0,inf
15714,54,9,63,0,inf
15715,65,11,76,0,inf
15716,57,11,68,0,inf
15717,52,12,64,0,inf
15718,66,12,78,0,inf
15719,53,12,65,0,inf
15720,66,9,75,0,inf
15721,56,9,65,0,inf
15722,56,5,61,0,inf
15723,61,5,66,0,inf
15724,58,12,70,0,inf
15725,60,12,72,0,inf
15726,51,6,57,0,inf
15727,66,7,73,0,inf
15728,50,10,60,0,inf
15729,54,11,65,0,inf
15730,66,12,78,0,inf
15731,57,10,67,0,inf
15732,63,6,69,0,inf
15733,52,10,62,0,inf
15734,54,8,62,1,2.2038369604909818
15735,67,12,79,0,inf
15736,57,13,70,0,inf
15737,58,11,69,0,inf
15738,50,8,58,0,inf
15739,61,10,71,0,inf
15740,60,8,68,0,inf
15741,66,6,72,0,inf
15742,56,9,65,0,inf
15743,59,11,70,0,inf
15744,57,11,68,0,inf
15745,53,5,58,1,3.4159076071825467
15746,62,13,75,0,inf
15747,62,7,69,0,inf
15748,66,7,73,0,inf
15749,62,7,69,0,inf
15750,54,13,67,0,inf
15751,57,9,66,0,inf
15752,59,8,67,0,inf
15753,55,9,64,0,inf
15754,59,12,71,0,inf
15755,59,13,72,0,inf
15756,58,10,68,0,inf
15757,54,8,62,0,inf
15758,62,5,67,0,inf
15759,52,9,61,0,inf
15760,59,10,69,0,inf
15761,60,12,72,0,inf
15762,62,10,72,0,inf
15763,51,13,64,0,inf
15764,51,6,57,0,inf
15765,51,11,62,0,inf
15766,65,13,78,0,inf
15767,51,6,57,0,inf
15768,55,7,62,0,inf
15769,56,8,64,0,inf
15770,54,5,59,0,inf
15771,64,5,69,0,inf
15772,60,11,71,0,inf
15773,56,6,62,0,inf
15774,63,10,73,0,inf
15775,53,11,64,0,inf
15776,62,8,70,0,inf
15777,51,8,59,0,inf
15778,66,12,78,0,inf
15779,58,6,64,0,inf
15780,54,5,59,1,3.5938819751421676
15781,59,9,68,0,inf
15782,53,13,66,0,inf
15783,62,5,67,0,inf
15784,65,12,77,0,inf
15785,67,6,73,0,inf
15786,50,12,62,1,1.0485269621587392
15787,52,12,64,0,inf
15788,51,11,62,0,inf
15789,65,12,77,0,inf
15790,51,6,57,0,inf
15791,50,12,62,0,inf
15792,52,8,60,0,inf
15793,65,8,73,0,inf
15794,63,5,68,0,inf
15795,58,13,71,0,inf
15796,61,5,66,0,inf
15797,65,12,77,1,4.055657966270104
15798,55,12,67,0,inf
15799,65,6,71,0,inf
15800,65,10,75,0,inf
15801,60,8,68,0,inf
15802,52,12,64,0,inf
15803,62,7,69,0,inf
15804,67,5,72,0,inf
15805,66,6,72,0,inf
15806,62,6,68,0,inf
15807,62,13,75,0,inf
15808,53,8,61,0,inf
15809,51,7,58,0,inf
15810,58,11,69,0,inf
15811,63,13,76,0,inf
15812,64,7,71,0,inf
15813,67,10,77,0,inf
15814,65,5,70,0,inf
15815,52,12,64,0,inf
15816,56,11,67,1,6.413499968731514
15817,59,13,72,0,inf
15818,66,9,75,0,inf
15819,52,5,57,0,inf
15820,50,9,59,0,inf
15821,61,7,68,0,inf
15822,50,7,57,0,inf
15823,54,10,64,1,3.165614044216987
15824,51,12,63,0,inf
15825,55,13,68,0,inf
15826,50,12,62,0,inf
15827,59,12,71,0,inf
15828,63,6,69,0,inf
15829,50,5,55,0,inf
15830,61,10,71,0,inf
15831,61,7,68,0,inf
15832,53,8,61,0,inf
15833,64,13,77,0,inf
15834,52,11,63,0,inf
15835,51,12,63,0,inf
15836,57,7,64,0,inf
15837,65,12,77,0,inf
15838,61,8,69,0,inf
15839,50,11,61,0,inf
15840,56,9,65,0,inf
15841,62,9,71,0,inf
15842,53,13,66,0,inf
15843,64,5,69,0,inf
15844,55,10,65,0,inf
15845,51,13,64,0,inf
15846,61,8,69,0,inf
15847,52,8,60,0,inf
15848,61,6,67,0,inf
15849,61,10,71,0,inf
15850,63,13,76,0,inf
15851,56,8,64,0,inf
15852,59,7,66,0,inf
15853,55,5,60,0,inf
15854,53,10,63,0,inf
15855,56,13,69,0,inf
15856,60,8,68,0,inf
15857,65,7,72,0,inf
15858,60,13,73,0,inf
15859,52,10,62,0,inf
15860,58,7,65,0,inf
15861,51,12,63,0,inf
15862,66,5,71,0,inf
15863,58,12,70,0,inf
15864,62,6,68,0,inf
15865,60,12,72,0,inf
15866,61,6,67,0,inf
15867,67,6,73,0,inf
15868,53,11,64,0,inf
15869,58,7,65,0,inf
15870,64,13,77,0,inf
15871,52,11,63,0,inf
15872,59,7,66,0,inf
15873,53,7,60,0,inf
15874,51,11,62,0,inf
15875,60,13,73,0,inf
15876,55,6,61,0,inf
15877,60,9,69,0,inf
15878,54,10,64,0,inf
15879,54,5,59,0,inf
15880,58,10,68,0,inf
15881,67,6,73,0,inf
15882,58,11,69,0,inf
15883,60,9,69,0,inf
15884,57,7,64,0,inf
15885,50,5,55,0,inf
15886,66,8,74,0,inf
15887,54,7,61,0,inf
15888,55,8,63,0,inf
15889,54,9,63,0,inf
15890,60,10,70,0,inf
15891,60,8,68,0,inf
15892,63,5,68,0,inf
15893,59,8,67,0,inf
15894,55,7,62,0,inf
15895,63,11,74,0,inf
15896,57,5,62,0,inf
15897,67,8,75,0,inf
15898,63,9,72,0,inf
15899,65,11,76,0,inf
15900,57,7,64,0,inf
15901,50,7,57,0,inf
15902,60,12,72,0,inf
15903,53,8,61,0,inf
15904,56,8,64,0,inf
15905,51,9,60,0,inf
15906,52,5,57,0,inf
15907,51,9,60,0,inf
15908,57,9,66,0,inf
15909,62,9,71,0,inf
15910,53,9,62,0,inf
15911,55,5,60,0,inf
15912,67,9,76,0,inf
15913,59,13,72,0,inf
15914,62,5,67,0,inf
15915,53,5,58,0,inf
15916,64,11,75,0,inf
15917,56,5,61,0,inf
15918,66,5,71,0,inf
15919,54,13,67,0,inf
15920,54,9,63,0,inf
15921,59,7,66,0,inf
15922,60,10,70,0,inf
15923,58,8,66,0,inf
15924,62,12,74,0,inf
15925,63,11,74,0,inf
15926,56,10,66,0,inf
15927,56,6,62,0,inf
15928,66,5,71,0,inf
15929,67,10,77,0,inf
15930,60,8,68,0,inf
15931,53,8,61,0,inf
15932,51,7,58,0,inf
15933,54,13,67,0,inf
15934,66,5,71,0,inf
15935,64,6,70,0,inf
15936,65,11,76,0,inf
15937,65,5,70,0,inf
15938,64,11,75,0,inf
15939,60,12,72,0,inf
15940,51,5,56,0,inf
15941,65,7,72,0,inf
15942,63,10,73,0,inf
15943,56,7,63,0,inf
15944,63,7,70,0,inf
15945,50,6,56,0,inf
15946,56,9,65,0,inf
15947,52,9,61,0,inf
15948,58,8,66,0,inf
15949,61,12,73,0,inf
15950,50,12,62,0,inf
15951,52,13,65,0,inf
15952,66,8,74,0,inf
15953,56,5,61,0,inf
15954,60,9,69,0,inf
15955,67,12,79,0,inf
15956,56,7,63,0,inf
15957,61,7,68,0,inf
15958,62,5,67,0,inf
15959,60,8,68,0,inf
15960,52,6,58,0,inf
15961,58,6,64,0,inf
15962,51,9,60,0,inf
15963,53,5,58,0,inf
15964,62,5,67,0,inf
15965,51,12,63,0,inf
15966,60,13,73,0,inf
15967,63,11,74,0,inf
15968,59,9,68,0,inf
15969,51,13,64,0,inf
15970,52,13,65,0,inf
15971,65,6,71,0,inf
15972,66,10,76,0,inf
15973,50,11,61,0,inf
15974,58,11,69,0,inf
15975,59,10,69,0,inf
15976,62,8,70,0,inf
15977,57,6,63,0,inf
15978,56,9,65,0,inf
15979,58,12,70,0,inf
15980,63,7,70,0,inf
15981,51,9,60,0,inf
15982,61,12,73,0,inf
15983,52,6,58,0,inf
15984,56,10,66,0,inf
15985,52,13,65,0,inf
15986,66,5,71,0,inf
15987,63,7,70,0,inf
15988,55,8,63,0,inf
15989,60,6,66,0,inf
15990,63,12,75,0,inf
15991,54,8,62,1,3.292501189815461
15992,64,6,70,0,inf
15993,51,7,58,0,inf
15994,62,7,69,0,inf
15995,61,10,71,0,inf
15996,59,13,72,0,inf
15997,60,5,65,0,inf
15998,58,11,69,0,inf
15999,67,5,72,0,inf
16000,54,9,63,0,inf
16001,51,8,59,0,inf
16002,62,7,69,0,inf
16003,60,7,67,0,inf
16004,58,7,65,0,inf
16005,60,6,66,0,inf
16006,53,11,64,0,inf
16007,51,7,58,0,inf
16008,54,5,59,0,inf
16009,63,7,70,0,inf
16010,65,10,75,0,inf
16011,58,6,64,0,inf
16012,56,5,61,0,inf
16013,60,10,70,0,inf
16014,57,11,68,0,inf
16015,62,8,70,0,inf
16016,58,7,65,0,inf
16017,56,11,67,0,inf
16018,50,13,63,0,inf
16019,62,6,68,0,inf
16020,53,12,65,0,inf
16021,58,7,65,0,inf
16022,52,9,61,0,inf
16023,61,5,66,0,inf
16024,56,7,63,0,inf
16025,62,12,74,1,0.5358947793043924
16026,52,6,58,0,inf
16027,53,10,63,0,inf
16028,56,11,67,0,inf
16029,59,11,70,0,inf
16030,53,6,59,0,inf
16031,64,11,75,0,inf
16032,67,13,80,0,inf
16033,58,5,63,0,inf
16034,56,11,67,0,inf
16035,56,13,69,0,inf
16036,54,5,59,0,inf
16037,58,10,68,0,inf
16038,50,5,55,0,inf
16039,58,5,63,0,inf
16040,52,7,59,0,inf
16041,53,8,61,0,inf
16042,50,13,63,0,inf
16043,51,6,57,0,inf
16044,55,10,65,0,inf
16045,64,12,76,0,inf
16046,54,12,66,0,inf
16047,59,7,66,0,inf
16048,55,9,64,0,inf
16049,51,11,62,0,inf
16050,60,12,72,0,inf
16051,53,10,63,0,inf
16052,50,10,60,0,inf
16053,65,12,77,0,inf
16054,63,6,69,0,inf
16055,56,12,68,1,1.8587548425426235
16056,65,13,78,0,inf
16057,59,7,66,0,inf
16058,67,5,72,0,inf
16059,54,8,62,0,inf
16060,63,9,72,1,2.674168712103196
16061,62,13,75,0,inf
16062,59,12,71,0,inf
16063,53,9,62,0,inf
16064,51,11,62,0,inf
16065,53,6,59,0,inf
16066,50,6,56,0,inf
16067,62,8,70,0,inf
16068,67,5,72,0,inf
16069,57,12,69,0,inf
16070,54,5,59,0,inf
16071,67,10,77,0,inf
16072,61,11,72,0,inf
16073,58,13,71,0,inf
16074,63,7,70,0,inf
16075,55,10,65,0,inf
16076,57,5,62,1,4.260725151171158
16077,58,6,64,0,inf
16078,56,5,61,0,inf
16079,51,10,61,0,inf
16080,59,6,65,0,inf
16081,60,10,70,0,inf
16082,66,7,73,0,inf
16083,60,5,65,0,inf
16084,51,13,64,0,inf
16085,66,12,78,0,inf
16086,63,9,72,0,inf
16087,62,12,74,0,inf
16088,57,7,64,0,inf
16089,61,9,70,0,inf
16090,50,12,62,0,inf
16091,50,8,58,0,inf
16092,63,8,71,0,inf
16093,54,10,64,0,inf
16094,65,10,75,0,inf
16095,55,11,66,0,inf
16096,65,10,75,0,inf
16097,51,12,63,0,inf
16098,62,9,71,0,inf
16099,65,5,70,0,inf
16100,53,11,64,0,inf
16101,59,9,68,0,inf
16102,62,11,73,0,inf
16103,66,5,71,0,inf
16104,63,9,72,0,inf
16105,57,12,69,0,inf
16106,57,11,68,0,inf
16107,63,8,71,0,inf
16108,63,7,70,0,inf
16109,66,7,73,0,inf
16110,57,9,66,0,inf
16111,60,10,70,0,inf
16112,63,7,70,0,inf
16113,62,7,69,0,inf
16114,56,10,66,0,inf
16115,53,13,66,0,inf
16116,50,11,61,0,inf
16117,59,9,68,0,inf
16118,67,5,72,0,inf
16119,56,11,67,0,inf
16120,66,7,73,0,inf
16121,53,13,66,0,inf
16122,60,11,71,0,inf
16123,50,12,62,0,inf
16124,60,6,66,0,inf
16125,61,5,66,0,inf
16126,59,10,69,0,inf
16127,56,8,64,0,inf
16128,54,9,63,0,inf
16129,67,7,74,0,inf
16130,54,12,66,0,inf
16131,52,6,58,1,2.6708341283724693
16132,61,10,71,0,inf
16133,64,13,77,0,inf
16134,50,7,57,0,inf
16135,65,6,71,0,inf
16136,52,8,60,0,inf
16137,64,10,74,0,inf
16138,55,5,60,0,inf
16139,53,6,59,0,inf
16140,59,10,69,0,inf
16141,62,8,70,0,inf
16142,65,6,71,0,inf
16143,62,5,67,0,inf
16144,65,8,73,0,inf
16145,52,12,64,0,inf
16146,51,9,60,1,7.929209292354578
16147,62,13,75,0,inf
16148,52,8,60,0,inf
16149,50,8,58,0,inf
16150,66,10,76,0,inf
16151,54,6,60,0,inf
16152,61,10,71,0,inf
16153,67,13,80,0,inf
16154,53,9,62,1,0.9434243124202908
16155,52,10,62,0,inf
16156,56,7,63,1,2.314010486482232
16157,53,13,66,0,inf
16158,66,9,75,0,inf
16159,53,6,59,0,inf
16160,64,8,72,0,inf
16161,50,9,59,0,inf
16162,60,13,73,0,inf
16163,57,5,62,0,inf
16164,62,10,72,0,inf
16165,64,12,76,0,inf
16166,56,5,61,0,inf
16167,63,6,69,0,inf
16168,64,6,70,0,inf
16169,65,11,76,0,inf
16170,56,10,66,0,inf
16171,51,9,60,0,inf
16172,59,8,67,0,inf
16173,51,9,60,0,inf
16174,65,9,74,0,inf
16175,55,12,67,0,inf
16176,52,5,57,0,inf
16177,51,13,64,0,inf
16178,60,9,69,0,inf
16179,51,7,58,0,inf
16180,60,5,65,0,inf
16181,64,9,73,0,inf
16182,52,7,59,0,inf
16183,56,7,63,0,inf
16184,63,10,73,0,inf
16185,56,11,67,0,inf
16186,60,6,66,0,inf
16187,59,7,66,0,inf
16188,60,11,71,0,inf
16189,56,13,69,0,inf
16190,67,13,80,1,10.255260113515192
16191,59,8,67,0,inf
16192,57,8,65,0,inf
16193,63,12,75,1,11.838284330895817
16194,56,5,61,0,inf
16195,66,9,75,0,inf
16196,60,12,72,0,inf
16197,60,12,72,1,4.944112315934191
16198,63,8,71,0,inf
16199,60,7,67,0,inf
16200,59,11,70,0,inf
16201,57,7,64,0,inf
16202,57,10,67,0,inf
16203,57,12,69,0,inf
16204,51,10,61,0,inf
16205,57,5,62,0,inf
16206,55,11,66,0,inf
16207,52,9,61,0,inf
16208,63,13,76,0,inf
16209,54,13,67,0,inf
16210,67,12,79,0,inf
16211,52,10,62,0,inf
16212,57,5,62,0,inf
16213,62,7,69,0,inf
16214,62,10,72,0,inf
16215,56,9,65,0,inf
16216,50,7,57,0,inf
16217,67,13,80,0,inf
16218,57,11,68,0,inf
16219,59,13,72,0,inf
16220,55,11,66,0,inf
16221,51,11,62,0,inf
16222,59,13,72,0,inf
16223,56,7,63,0,inf
16224,59,8,67,0,inf
16225,56,8,64,0,inf
16226,61,6,67,0,inf
16227,67,8,75,0,inf
16228,51,12,63,0,inf
16229,52,7,59,0,inf
16230,66,10,76,0,inf
16231,67,10,77,0,inf
16232,60,10,70,0,inf
16233,59,13,72,0,inf
16234,56,9,65,0,inf
16235,64,12,76,0,inf
16236,65,10,75,0,inf
16237,63,13,76,0,inf
16238,65,9,74,0,inf
16239,60,10,70,0,inf
16240,65,11,76,0,inf
16241,55,8,63,0,inf
16242,54,7,61,0,inf
16243,63,10,73,0,inf
16244,58,7,65,0,inf
16245,59,9,68,0,inf
16246,62,9,71,0,inf
16247,52,10,62,0,inf
16248,51,9,60,0,inf
16249,59,13,72,0,inf
16250,59,5,64,0,inf
16251,56,7,63,0,inf
16252,56,8,64,0,inf
16253,65,12,77,0,inf
16254,56,5,61,0,inf
16255,52,7,59,0,inf
16256,50,6,56,0,inf
16257,52,12,64,0,inf
16258,66,5,71,0,inf
16259,66,7,73,0,inf
16260,57,13,70,0,inf
16261,59,6,65,0,inf
16262,64,11,75,0,inf
16263,59,9,68,0,inf
16264,56,10,66,0,inf
16265,65,9,74,0,inf
16266,52,5,57,0,inf
16267,50,13,63,0,inf
16268,54,11,65,0,inf
16269,50,10,60,0,inf
16270,56,10,66,0,inf
16271,62,6,68,0,inf
16272,51,8,59,0,inf
16273,55,12,67,0,inf
16274,53,7,60,0,inf
16275,65,10,75,0,inf
16276,63,5,68,0,inf
16277,56,9,65,0,inf
16278,50,11,61,0,inf
16279,50,9,59,0,inf
16280,65,8,73,1,4.184758408236959
16281,50,8,58,0,inf
16282,50,5,55,0,inf
16283,60,10,70,0,inf
16284,54,12,66,0,inf
16285,64,10,74,0,inf
16286,64,5,69,0,inf
16287,60,9,69,0,inf
16288,50,5,55,0,inf
16289,64,11,75,0,inf
16290,61,5,66,0,inf
16291,57,9,66,0,inf
16292,63,12,75,0,inf
16293,67,6,73,0,inf
16294,52,11,63,0,inf
16295,51,10,61,0,inf
16296,66,9,75,0,inf
16297,64,12,76,0,inf
16298,63,7,70,0,inf
16299,57,6,63,0,inf
16300,52,8,60,0,inf
16301,51,6,57,0,inf
16302,51,5,56,0,inf
16303,53,8,61,0,inf
16304,66,11,77,0,inf
16305,56,13,69,0,inf
16306,60,7,67,0,inf
16307,59,11,70,0,inf
16308,56,8,64,0,inf
16309,63,11,74,0,inf
16310,59,9,68,0,inf
16311,55,7,62,0,inf
16312,58,13,71,0,inf
16313,52,11,63,0,inf
16314,64,8,72,0,inf
16315,53,11,64,0,inf
16316,67,12,79,0,inf
16317,56,7,63,0,inf
16318,61,9,70,0,inf
16319,61,7,68,0,inf
16320,61,12,73,0,inf
16321,56,11,67,0,inf
16322,51,5,56,0,inf
16323,60,5,65,0,inf
16324,62,13,75,0,inf
16325,53,13,66,0,inf
16326,62,13,75,0,inf
16327,65,5,70,0,inf
16328,59,10,69,0,inf
16329,64,10,74,0,inf
16330,53,7,60,0,inf
16331,61,9,70,0,inf
16332,63,8,71,1,5.075431011183625
16333,56,11,67,0,inf
16334,61,5,66,0,inf
16335,56,7,63,0,inf
16336,60,12,72,0,inf
16337,59,5,64,0,inf
16338,58,11,69,0,inf
16339,67,6,73,1,5.414561057541576
16340,57,11,68,0,inf
16341,66,10,76,0,inf
16342,58,9,67,0,inf
16343,54,5,59,0,inf
16344,57,5,62,0,inf
16345,62,9,71,0,inf
16346,51,12,63,0,inf
16347,57,11,68,0,inf
16348,50,6,56,0,inf
16349,65,10,75,0,inf
16350,62,9,71,0,inf
16351,50,10,60,0,inf
16352,58,6,64,0,inf
16353,58,12,70,0,inf
16354,53,11,64,0,inf
16355,55,13,68,0,inf
16356,53,8,61,0,inf
16357,61,9,70,0,inf
16358,66,10,76,0,inf
16359,51,10,61,0,inf
16360,55,10,65,0,inf
16361,56,8,64,0,inf
16362,51,10,61,0,inf
16363,50,13,63,1,5.535349123761144
16364,51,13,64,0,inf
16365,56,8,64,0,inf
16366,52,13,65,0,inf
16367,56,7,63,0,inf
16368,62,10,72,0,inf
16369,67,12,79,0,inf
16370,65,9,74,0,inf
16371,64,8,72,0,inf
16372,63,10,73,0,inf
16373,62,13,75,0,inf
16374,61,7,68,0,inf
16375,50,12,62,0,inf
16376,50,12,62,0,inf
16377,52,11,63,0,inf
16378,65,11,76,0,inf
16379,59,8,67,0,inf
16380,60,5,65,0,inf
16381,53,7,60,0,inf
16382,63,12,75,0,inf
16383,58,9,67,0,inf
16384,51,10,61,0,inf
16385,57,7,64,1,1.0470832407857387
16386,56,5,61,0,inf
16387,65,12,77,0,inf
16388,54,9,63,0,inf
16389,66,9,75,0,inf
16390,54,9,63,0,inf
16391,62,10,72,0,inf
16392,60,5,65,0,inf
16393,65,10,75,0,inf
16394,54,6,60,0,inf
16395,55,6,61,0,inf
16396,59,13,72,1,1.926558181205401
16397,57,5,62,0,inf
16398,57,9,66,0,inf
16399,64,5,69,0,inf
16400,64,12,76,0,inf
16401,58,5,63,1,0.8809201179326465
16402,51,6,57,0,inf
16403,65,10,75,0,inf
16404,55,5,60,0,inf
16405,62,8,70,0,inf
16406,60,10,70,1,8.761283702912323
16407,58,7,65,0,inf
16408,59,8,67,0,inf
16409,50,11,61,0,inf
16410,62,6,68,0,inf
16411,67,9,76,0,inf
16412,53,8,61,0,inf
16413,66,6,72,0,inf
16414,58,5,63,0,inf
16415,53,12,65,0,inf
16416,51,13,64,0,inf
16417,54,7,61,0,inf
16418,53,8,61,0,inf
16419,51,10,61,0,inf
16420,55,12,67,0,inf
16421,55,8,63,0,inf
16422,63,5,68,0,inf
16423,67,7,74,0,inf
16424,65,13,78,0,inf
16425,62,10,72,0,inf
16426,63,11,74,0,inf
16427,62,5,67,0,inf
16428,63,5,68,0,inf
16429,51,10,61,0,inf
16430,67,5,72,0,inf
16431,52,8,60,0,inf
16432,61,9,70,0,inf
16433,58,11,69,0,inf
16434,59,7,66,0,inf
16435,60,13,73,0,inf
16436,62,8,70,0,inf
16437,67,11,78,0,inf
16438,56,5,61,0,inf
16439,66,9,75,0,inf
16440,50,10,60,0,inf
16441,58,12,70,0,inf
16442,61,13,74,0,inf
16443,54,6,60,0,inf
16444,65,5,70,0,inf
16445,50,5,55,0,inf
16446,53,13,66,0,inf
16447,51,7,58,0,inf
16448,58,11,69,0,inf
16449,62,5,67,0,inf
16450,53,10,63,0,inf
16451,52,8,60,0,inf
16452,50,8,58,0,inf
16453,59,10,69,0,inf
16454,50,9,59,0,inf
16455,57,12,69,0,inf
16456,57,10,67,0,inf
16457,57,11,68,0,inf
16458,61,13,74,0,inf
16459,67,12,79,0,inf
16460,66,13,79,0,inf
16461,66,13,79,0,inf
16462,57,10,67,0,inf
16463,57,9,66,0,inf
16464,64,13,77,0,inf
16465,59,13,72,0,inf
16466,53,11,64,0,inf
16467,62,5,67,0,inf
16468,54,9,63,1,0.6182017618773941
16469,53,6,59,0,inf
16470,63,7,70,0,inf
16471,54,8,62,0,inf
16472,62,13,75,1,0.25620129867538566
16473,59,9,68,0,inf
16474,60,6,66,0,inf
16475,55,13,68,0,inf
16476,58,5,63,0,inf
16477,52,8,60,0,inf
16478,64,9,73,0,inf
16479,59,8,67,0,inf
16480,61,10,71,0,inf
16481,53,6,59,0,inf
16482,64,5,69,0,inf
16483,67,8,75,0,inf
16484,61,11,72,0,inf
16485,50,13,63,0,inf
16486,59,6,65,0,inf
16487,59,11,70,0,inf
16488,52,8,60,0,inf
16489,51,12,63,0,inf
16490,53,11,64,0,inf
16491,54,7,61,0,inf
16492,60,11,71,0,inf
16493,66,9,75,0,inf
16494,51,13,64,0,inf
16495,54,12,66,0,inf
16496,54,9,63,0,inf
16497,55,11,66,0,inf
16498,64,13,77,0,inf
16499,61,9,70,0,inf
16500,54,5,59,0,inf
16501,58,7,65,0,inf
16502,58,13,71,1,11.922444782248562
16503,55,6,61,0,inf
16504,63,12,75,0,inf
16505,64,12,76,0,inf
16506,67,12,79,1,9.512650043869314
16507,67,12,79,0,inf
16508,56,10,66,0,inf
16509,58,8,66,1,6.277867594519563
16510,63,7,70,0,inf
16511,54,5,59,0,inf
16512,57,10,67,0,inf
16513,56,7,63,0,inf
16514,64,8,72,0,inf
16515,63,6,69,0,inf
16516,55,7,62,0,inf
16517,66,12,78,0,inf
16518,63,12,75,0,inf
16519,61,6,67,0,inf
16520,57,13,70,0,inf
16521,55,12,67,0,inf
16522,56,12,68,0,inf
16523,57,10,67,0,inf
16524,66,7,73,0,inf
16525,65,11,76,0,inf
16526,64,10,74,0,inf
16527,57,8,65,0,inf
16528,52,13,65,0,inf
16529,61,7,68,0,inf
16530,58,7,65,0,inf
16531,55,8,63,0,inf
16532,57,7,64,0,inf
16533,57,12,69,0,inf
16534,50,5,55,0,inf
16535,63,8,71,0,inf
16536,56,12,68,0,inf
16537,61,12,73,0,inf
16538,55,9,64,0,inf
16539,61,5,66,0,inf
16540,52,8,60,0,inf
16541,65,7,72,0,inf
16542,67,8,75,0,inf
16543,60,11,71,0,inf
16544,52,10,62,0,inf
16545,66,7,73,0,inf
16546,55,7,62,0,inf
16547,67,6,73,0,inf
16548,59,13,72,0,inf
16549,63,13,76,0,inf
16550,56,11,67,0,inf
16551,59,9,68,0,inf
16552,60,11,71,0,inf
16553,58,7,65,0,inf
16554,59,5,64,0,inf
16555,66,10,76,0,inf
16556,60,8,68,0,inf
16557,62,12,74,0,inf
16558,58,11,69,0,inf
16559,67,6,73,0,inf
16560,50,9,59,0,inf
16561,53,9,62,0,inf
16562,52,9,61,0,inf
16563,52,10,62,0,inf
16564,65,10,75,0,inf
16565,53,8,61,0,inf
16566,53,5,58,0,inf
16567,63,5,68,0,inf
16568,59,6,65,0,inf
16569,64,5,69,0,inf
16570,51,12,63,0,inf
16571,58,9,67,0,inf
16572,58,10,68,0,inf
16573,58,11,69,0,inf
16574,58,11,69,0,inf
16575,66,13,79,1,6.004022351805659
16576,64,7,71,0,inf
16577,61,6,67,0,inf
16578,53,9,62,0,inf
16579,67,8,75,0,inf
16580,62,9,71,0,inf
16581,67,7,74,0,inf
16582,55,11,66,0,inf
16583,55,5,60,0,inf
16584,58,9,67,0,inf
16585,54,6,60,0,inf
16586,51,5,56,0,inf
16587,53,5,58,0,inf
16588,54,11,65,0,inf
16589,54,9,63,0,inf
16590,52,12,64,0,inf
16591,54,9,63,0,inf
16592,60,12,72,1,0.22060025793706473
16593,64,13,77,1,11.136891776782377
16594,62,11,73,0,inf
16595,59,13,72,0,inf
16596,54,6,60,0,inf
16597,58,7,65,0,inf
16598,65,6,71,0,inf
16599,52,13,65,0,inf
16600,52,11,63,1,5.180154462633382
16601,54,13,67,0,inf
16602,55,6,61,0,inf
16603,50,9,59,0,inf
16604,59,7,66,0,inf
16605,58,5,63,0,inf
16606,56,10,66,0,inf
16607,64,7,71,0,inf
16608,56,12,68,0,inf
16609,67,11,78,0,inf
16610,66,11,77,0,inf
16611,63,7,70,0,inf
16612,51,8,59,0,inf
16613,62,9,71,0,inf
16614,66,9,75,0,inf
16615,59,6,65,0,inf
16616,64,6,70,0,inf
16617,60,10,70,0,inf
16618,59,6,65,0,inf
16619,58,13,71,0,inf
16620,53,13,66,0,inf
16621,50,9,59,0,inf
16622,52,11,63,0,inf
16623,58,7,65,0,inf
16624,64,5,69,0,inf
16625,57,6,63,0,inf
16626,58,9,67,0,inf
16627,67,8,75,0,inf
16628,61,11,72,0,inf
16629,67,7,74,0,inf
16630,62,9,71,0,inf
16631,52,9,61,0,inf
16632,51,5,56,0,inf
16633,57,10,67,0,inf
16634,57,9,66,0,inf
16635,65,13,78,0,inf
16636,60,7,67,0,inf
16637,57,7,64,0,inf
16638,52,7,59,0,inf
16639,65,8,73,0,inf
16640,63,10,73,0,inf
16641,62,10,72,0,inf
16642,52,11,63,0,inf
16643,63,9,72,0,inf
16644,56,11,67,0,inf
16645,50,9,59,0,inf
16646,61,5,66,0,inf
16647,53,5,58,0,inf
16648,61,6,67,0,inf
16649,50,10,60,0,inf
16650,64,12,76,0,inf
16651,64,11,75,0,inf
16652,50,13,63,0,inf
16653,66,11,77,0,inf
16654,57,5,62,0,inf
16655,61,9,70,0,inf
16656,53,9,62,0,inf
16657,51,7,58,0,inf
16658,59,6,65,0,inf
16659,66,12,78,1,1.1912054093448887
16660,65,11,76,0,inf
16661,52,9,61,0,inf
16662,54,7,61,0,inf
16663,64,9,73,0,inf
16664,64,7,71,1,4.263143597405161
16665,63,13,76,0,inf
16666,66,9,75,0,inf
16667,65,9,74,0,inf
16668,56,6,62,0,inf
16669,62,11,73,0,inf
16670,56,13,69,0,inf
16671,61,11,72,0,inf
16672,67,7,74,0,inf
16673,52,7,59,0,inf
16674,51,11,62,0,inf
16675,55,5,60,0,inf
16676,56,7,63,0,inf
16677,59,10,69,0,inf
16678,65,12,77,0,inf
16679,57,12,69,0,inf
16680,67,5,72,0,inf
16681,57,11,68,0,inf
16682,64,8,72,0,inf
16683,67,11,78,0,inf
16684,60,10,70,0,inf
16685,67,12,79,0,inf
16686,59,7,66,0,inf
16687,53,13,66,0,inf
16688,63,12,75,0,inf
16689,53,11,64,0,inf
16690,50,12,62,0,inf
16691,62,7,69,0,inf
16692,58,13,71,0,inf
16693,66,11,77,0,inf
16694,55,10,65,0,inf
16695,66,6,72,0,inf
16696,51,6,57,0,inf
16697,56,12,68,1,5.294088415456393
16698,61,11,72,0,inf
16699,51,10,61,0,inf
16700,57,13,70,0,inf
16701,52,13,65,0,inf
16702,67,9,76,0,inf
16703,53,9,62,0,inf
16704,57,10,67,0,inf
16705,65,6,71,0,inf
16706,51,5,56,0,inf
16707,58,6,64,0,inf
16708,66,7,73,0,inf
16709,55,13,68,0,inf
16710,55,11,66,0,inf
16711,58,13,71,0,inf
16712,56,9,65,0,inf
16713,57,13,70,0,inf
16714,59,10,69,0,inf
16715,64,5,69,0,inf
16716,52,11,63,0,inf
16717,57,10,67,0,inf
16718,57,5,62,0,inf
16719,59,12,71,0,inf
16720,52,13,65,0,inf
16721,66,10,76,0,inf
16722,67,13,80,0,inf
16723,65,13,78,0,inf
16724,54,13,67,0,inf
16725,62,5,67,0,inf
16726,65,9,74,0,inf
16727,56,5,61,0,inf
16728,59,8,67,0,inf
16729,62,6,68,0,inf
16730,64,13,77,0,inf
16731,55,6,61,0,inf
16732,55,9,64,1,5.512055918082844
16733,60,7,67,1,3.2887606921707047
16734,58,6,64,0,inf
16735,64,10,74,0,inf
16736,66,13,79,0,inf
16737,58,13,71,0,inf
16738,50,11,61,0,inf
16739,66,5,71,0,inf
16740,56,10,66,0,inf
16741,59,5,64,0,inf
16742,52,10,62,0,inf
16743,53,12,65,0,inf
16744,53,8,61,0,inf
16745,59,6,65,0,inf
16746,55,5,60,0,inf
16747,64,5,69,0,inf
16748,55,7,62,0,inf
16749,56,5,61,0,inf
16750,53,13,66,0,inf
16751,65,8,73,0,inf
16752,65,12,77,0,inf
16753,52,5,57,0,inf
16754,63,9,72,0,inf
16755,61,12,73,0,inf
16756,66,11,77,0,inf
16757,60,12,72,0,inf
16758,54,11,65,1,3.1366284795676904
16759,67,6,73,0,inf
16760,65,6,71,0,inf
16761,64,9,73,0,inf
16762,57,10,67,0,inf
16763,63,12,75,0,inf
16764,52,12,64,0,inf
16765,55,11,66,0,inf
16766,54,8,62,0,inf
16767,65,8,73,0,inf
16768,63,11,74,0,inf
16769,56,13,69,0,inf
16770,50,12,62,0,inf
16771,62,11,73,0,inf
16772,61,9,70,0,inf
16773,60,7,67,0,inf
16774,57,12,69,0,inf
16775,59,8,67,0,inf
16776,53,12,65,0,inf
16777,52,10,62,0,inf
16778,60,9,69,0,inf
16779,55,10,65,0,inf
16780,52,7,59,0,inf
16781,61,10,71,0,inf
16782,64,5,69,0,inf
16783,59,10,69,0,inf
16784,56,10,66,0,inf
16785,55,6,61,0,inf
16786,56,9,65,0,inf
16787,63,5,68,0,inf
16788,55,7,62,0,inf
16789,55,10,65,0,inf
16790,51,11,62,0,inf
16791,55,11,66,0,inf
16792,64,9,73,0,inf
16793,50,10,60,0,inf
16794,64,9,73,0,inf
16795,52,10,62,0,inf
16796,66,12,78,0,inf
16797,63,5,68,0,inf
16798,55,5,60,0,inf
16799,65,11,76,0,inf
16800,67,5,72,0,inf
16801,50,9,59,0,inf
16802,61,7,68,0,inf
16803,51,5,56,0,inf
16804,63,13,76,0,inf
16805,63,6,69,1,5.344103943517894
16806,53,13,66,0,inf
16807,59,11,70,0,inf
16808,51,11,62,0,inf
16809,59,5,64,0,inf
16810,54,12,66,0,inf
16811,59,10,69,0,inf
16812,65,9,74,0,inf
16813,57,13,70,0,inf
16814,66,13,79,1,1.4369410774825866
16815,61,8,69,0,inf
16816,65,5,70,0,inf
16817,66,10,76,0,inf
16818,58,7,65,0,inf
16819,65,7,72,0,inf
16820,67,12,79,0,inf
16821,56,13,69,0,inf
16822,52,11,63,0,inf
16823,59,5,64,0,inf
16824,55,10,65,0,inf
16825,52,12,64,0,inf
16826,58,6,64,0,inf
16827,56,8,64,0,inf
16828,67,12,79,0,inf
16829,53,10,63,0,inf
16830,53,11,64,0,inf
16831,51,6,57,1,3.7647227540476607
16832,62,13,75,0,inf
16833,65,8,73,0,inf
16834,67,6,73,0,inf
16835,50,7,57,0,inf
16836,56,9,65,0,inf
16837,66,12,78,0,inf
16838,63,10,73,1,6.319900894381448
16839,56,13,69,0,inf
16840,51,12,63,0,inf
16841,58,11,69,0,inf
16842,58,6,64,0,inf
16843,53,10,63,0,inf
16844,51,12,63,0,inf
16845,60,13,73,0,inf
16846,64,8,72,0,inf
16847,66,10,76,0,inf
16848,51,8,59,0,inf
16849,67,12,79,0,inf
16850,56,10,66,0,inf
16851,57,13,70,0,inf
16852,55,11,66,0,inf
16853,63,10,73,0,inf
16854,58,13,71,0,inf
16855,65,13,78,0,inf
16856,60,6,66,0,inf
16857,64,9,73,0,inf
16858,61,5,66,0,inf
16859,57,10,67,0,inf
16860,61,11,72,0,inf
16861,50,8,58,0,inf
16862,60,6,66,0,inf
16863,59,8,67,0,inf
16864,63,12,75,0,inf
16865,61,9,70,0,inf
16866,67,11,78,0,inf
16867,54,8,62,0,inf
16868,51,9,60,0,inf
16869,60,10,70,0,inf
16870,57,9,66,0,inf
16871,64,8,72,0,inf
16872,54,7,61,0,inf
16873,66,6,72,0,inf
16874,55,6,61,0,inf
16875,53,11,64,0,inf
16876,67,5,72,0,inf
16877,53,10,63,0,inf
16878,57,11,68,0,inf
16879,50,12,62,0,inf
16880,50,5,55,0,inf
16881,59,9,68,0,inf
16882,59,10,69,0,inf
16883,52,5,57,0,inf
16884,52,10,62,0,inf
16885,66,7,73,0,inf
16886,54,11,65,0,inf
16887,50,10,60,0,inf
16888,66,12,78,0,inf
16889,57,9,66,0,inf
16890,63,7,70,0,inf
16891,64,12,76,0,inf
16892,66,12,78,0,inf
16893,66,8,74,0,inf
16894,50,9,59,0,inf
16895,52,12,64,0,inf
16896,63,7,70,0,inf
16897,53,6,59,0,inf
16898,53,5,58,0,inf
16899,50,13,63,0,inf
16900,59,8,67,0,inf
16901,63,13,76,0,inf
16902,55,8,63,0,inf
16903,55,7,62,0,inf
16904,52,12,64,0,inf
16905,60,10,70,0,inf
16906,50,13,63,0,inf
16907,53,9,62,0,inf
16908,54,8,62,0,inf
16909,52,6,58,0,inf
16910,54,11,65,0,inf
16911,60,8,68,0,inf
16912,60,10,70,0,inf
16913,54,5,59,0,inf
16914,54,6,60,0,inf
16915,52,5,57,0,inf
16916,67,8,75,0,inf
16917,62,13,75,0,inf
16918,66,6,72,0,inf
16919,55,13,68,0,inf
16920,56,10,66,0,inf
16921,61,10,71,0,inf
16922,56,8,64,0,inf
16923,52,11,63,0,inf
16924,57,10,67,0,inf
16925,53,10,63,0,inf
16926,62,6,68,0,inf
16927,51,11,62,0,inf
16928,59,11,70,0,inf
16929,62,13,75,0,inf
16930,51,10,61,0,inf
16931,52,6,58,0,inf
16932,65,6,71,0,inf
16933,58,8,66,0,inf
16934,65,7,72,0,inf
16935,50,11,61,0,inf
16936,53,12,65,0,inf
16937,52,11,63,0,inf
16938,61,11,72,0,inf
16939,52,11,63,0,inf
16940,56,5,61,0,inf
16941,65,7,72,0,inf
16942,50,5,55,0,inf
16943,56,11,67,0,inf
16944,60,10,70,0,inf
16945,67,7,74,0,inf
16946,56,11,67,0,inf
16947,64,9,73,0,inf
16948,56,6,62,0,inf
16949,55,10,65,0,inf
16950,66,7,73,0,inf
16951,50,9,59,0,inf
16952,62,9,71,0,inf
16953,65,9,74,0,inf
16954,67,5,72,0,inf
16955,64,9,73,0,inf
16956,61,13,74,0,inf
16957,58,8,66,0,inf
16958,57,6,63,0,inf
16959,61,13,74,0,inf
16960,57,10,67,0,inf
16961,50,10,60,0,inf
16962,55,10,65,0,inf
16963,62,11,73,0,inf
16964,66,7,73,0,inf
16965,50,11,61,0,inf
16966,66,11,77,0,inf
16967,54,9,63,0,inf
16968,62,11,73,0,inf
16969,54,9,63,0,inf
16970,62,10,72,0,inf
16971,54,10,64,0,inf
16972,64,10,74,0,inf
16973,64,7,71,0,inf
16974,54,5,59,0,inf
16975,52,5,57,0,inf
16976,63,12,75,0,inf
16977,59,6,65,0,inf
16978,63,13,76,0,inf
16979,67,8,75,0,inf
16980,62,8,70,0,inf
16981,67,9,76,0,inf
16982,53,13,66,0,inf
16983,54,12,66,0,inf
16984,53,7,60,0,inf
16985,55,5,60,0,inf
16986,66,10,76,0,inf
16987,60,6,66,0,inf
16988,62,10,72,0,inf
16989,67,5,72,0,inf
16990,61,13,74,0,inf
16991,67,8,75,0,inf
16992,66,10,76,0,inf
16993,63,10,73,0,inf
16994,67,8,75,0,inf
16995,59,11,70,0,inf
16996,58,12,70,0,inf
16997,57,7,64,0,inf
16998,53,9,62,0,inf
16999,52,7,59,0,inf
17000,67,12,79,0,inf
17001,62,5,67,0,inf
17002,66,12,78,0,inf
17003,56,8,64,0,inf
17004,67,10,77,0,inf
17005,61,8,69,0,inf
17006,51,7,58,0,inf
17007,59,5,64,0,inf
17008,55,7,62,0,inf
17009,50,12,62,0,inf
17010,67,8,75,0,inf
17011,52,6,58,0,inf
17012,53,7,60,0,inf
17013,65,10,75,1,8.679351296166416
17014,58,8,66,0,inf
17015,52,10,62,0,inf
17016,59,11,70,0,inf
17017,67,7,74,0,inf
17018,63,13,76,0,inf
17019,62,11,73,0,inf
17020,54,5,59,0,inf
17021,59,5,64,0,inf
17022,64,9,73,0,inf
17023,54,9,63,0,inf
17024,50,12,62,0,inf
17025,50,12,62,0,inf
17026,53,9,62,0,inf
17027,50,9,59,0,inf
17028,67,10,77,0,inf
17029,59,5,64,0,inf
17030,65,5,70,0,inf
17031,66,6,72,1,1.5654007538593788
17032,54,5,59,0,inf
17033,50,6,56,0,inf
17034,63,5,68,0,inf
17035,62,9,71,0,inf
17036,50,13,63,0,inf
17037,53,7,60,0,inf
17038,66,9,75,0,inf
17039,51,12,63,0,inf
17040,66,7,73,0,inf
17041,60,9,69,0,inf
17042,66,13,79,0,inf
17043,67,12,79,0,inf
17044,61,13,74,0,inf
17045,51,13,64,0,inf
17046,66,12,78,0,inf
17047,52,13,65,0,inf
17048,61,12,73,0,inf
17049,64,5,69,0,inf
17050,59,9,68,0,inf
17051,53,7,60,0,inf
17052,56,5,61,0,inf
17053,57,13,70,0,inf
17054,62,7,69,0,inf
17055,56,6,62,0,inf
17056,53,9,62,0,inf
17057,50,8,58,0,inf
17058,51,7,58,0,inf
17059,59,7,66,0,inf
17060,59,11,70,0,inf
17061,60,7,67,0,inf
17062,58,11,69,0,inf
17063,66,10,76,0,inf
17064,60,11,71,0,inf
17065,62,7,69,0,inf
17066,66,13,79,0,inf
17067,61,5,66,0,inf
17068,65,5,70,0,inf
17069,50,8,58,0,inf
17070,58,7,65,0,inf
17071,67,12,79,0,inf
17072,53,5,58,0,inf
17073,67,8,75,0,inf
17074,58,13,71,0,inf
17075,53,8,61,0,inf
17076,63,5,68,0,inf
17077,64,7,71,0,inf
17078,59,6,65,0,inf
17079,61,6,67,0,inf
17080,63,8,71,0,inf
17081,51,12,63,0,inf
17082,50,8,58,0,inf
17083,64,7,71,0,inf
17084,64,6,70,0,inf
17085,59,13,72,0,inf
17086,55,9,64,0,inf
17087,63,9,72,0,inf
17088,52,11,63,0,inf
17089,67,6,73,0,inf
17090,63,9,72,0,inf
17091,51,13,64,0,inf
17092,65,9,74,0,inf
17093,53,10,63,0,inf
17094,63,6,69,0,inf
17095,53,7,60,0,inf
17096,57,9,66,0,inf
17097,67,10,77,0,inf
17098,58,6,64,0,inf
17099,50,7,57,0,inf
17100,59,13,72,0,inf
17101,60,9,69,0,inf
17102,55,11,66,0,inf
17103,60,5,65,0,inf
17104,54,7,61,0,inf
17105,53,13,66,0,inf
17106,64,7,71,0,inf
17107,66,10,76,0,inf
17108,50,5,55,0,inf
17109,63,13,76,0,inf
17110,67,10,77,0,inf
17111,59,9,68,0,inf
17112,55,13,68,0,inf
17113,51,13,64,0,inf
17114,67,9,76,0,inf
17115,65,10,75,0,inf
17116,60,8,68,0,inf
17117,59,5,64,0,inf
17118,51,10,61,0,inf
17119,67,11,78,0,inf
17120,66,8,74,0,inf
17121,65,13,78,0,inf
17122,56,8,64,0,inf
17123,66,11,77,0,inf
17124,61,7,68,1,1.6405183882183891
17125,63,13,76,0,inf
17126,63,6,69,0,inf
17127,61,11,72,0,inf
17128,62,6,68,0,inf
17129,55,12,67,0,inf
17130,55,6,61,0,inf
17131,51,13,64,0,inf
17132,58,6,64,0,inf
17133,53,11,64,0,inf
17134,61,12,73,0,inf
17135,55,12,67,0,inf
17136,59,12,71,0,inf
17137,53,9,62,0,inf
17138,61,6,67,0,inf
17139,54,5,59,0,inf
17140,57,5,62,0,inf
17141,54,7,61,0,inf
17142,50,5,55,0,inf
17143,63,8,71,0,inf
17144,62,5,67,0,inf
17145,53,10,63,0,inf
17146,55,5,60,0,inf
17147,66,13,79,0,inf
17148,50,11,61,0,inf
17149,66,6,72,0,inf
17150,64,10,74,0,inf
17151,63,11,74,0,inf
17152,53,8,61,0,inf
17153,67,8,75,0,inf
17154,64,6,70,0,inf
17155,64,10,74,0,inf
17156,54,7,61,1,6.634487194693037
17157,56,13,69,0,inf
17158,54,5,59,0,inf
17159,67,6,73,0,inf
17160,64,13,77,0,inf
17161,50,11,61,0,inf
17162,53,13,66,0,inf
17163,63,12,75,0,inf
17164,64,9,73,0,inf
17165,55,5,60,0,inf
17166,61,6,67,0,inf
17167,57,8,65,0,inf
17168,67,12,79,0,inf
17169,60,9,69,0,inf
17170,58,8,66,0,inf
17171,55,13,68,0,inf
17172,66,12,78,0,inf
17173,53,12,65,0,inf
17174,55,13,68,0,inf
17175,53,12,65,0,inf
17176,57,11,68,1,5.671537370637658
17177,51,9,60,0,inf
17178,58,5,63,0,inf
17179,55,13,68,0,inf
17180,67,12,79,0,inf
17181,60,9,69,1,6.702194884751705
17182,64,10,74,0,inf
17183,62,6,68,0,inf
17184,59,6,65,0,inf
17185,66,13,79,0,inf
17186,65,10,75,0,inf
17187,60,12,72,0,inf
17188,65,8,73,0,inf
17189,63,13,76,0,inf
17190,58,11,69,0,inf
17191,61,9,70,0,inf
17192,60,13,73,0,inf
17193,61,6,67,0,inf
17194,61,8,69,0,inf
17195,59,5,64,0,inf
17196,53,13,66,0,inf
17197,62,12,74,0,inf
17198,59,10,69,0,inf
17199,51,10,61,0,inf
17200,57,7,64,0,inf
17201,57,5,62,0,inf
17202,55,10,65,0,inf
17203,58,8,66,0,inf
17204,50,12,62,0,inf
17205,54,12,66,0,inf
17206,64,11,75,0,inf
17207,54,9,63,0,inf
17208,54,9,63,0,inf
17209,66,13,79,0,inf
17210,52,10,62,0,inf
17211,58,10,68,0,inf
17212,56,12,68,0,inf
17213,56,6,62,0,inf
17214,60,7,67,0,inf
17215,50,5,55,0,inf
17216,63,7,70,0,inf
17217,59,12,71,0,inf
17218,59,11,70,0,inf
17219,58,13,71,0,inf
17220,65,6,71,0,inf
17221,54,5,59,0,inf
17222,53,11,64,0,inf
17223,52,11,63,0,inf
17224,58,13,71,0,inf
17225,61,7,68,0,inf
17226,57,8,65,0,inf
17227,53,6,59,0,inf
17228,54,8,62,0,inf
17229,60,13,73,0,inf
17230,50,9,59,0,inf
17231,56,9,65,0,inf
17232,61,5,66,0,inf
17233,65,9,74,0,inf
17234,51,13,64,0,inf
17235,53,9,62,0,inf
17236,50,7,57,0,inf
17237,65,13,78,0,inf
17238,56,12,68,0,inf
17239,58,9,67,0,inf
17240,58,10,68,0,inf
17241,54,7,61,0,inf
17242,56,11,67,0,inf
17243,66,7,73,0,inf
17244,64,12,76,0,inf
17245,53,12,65,0,inf
17246,55,9,64,0,inf
17247,61,9,70,0,inf
17248,53,12,65,0,inf
17249,64,13,77,0,inf
17250,67,11,78,0,inf
17251,50,13,63,0,inf
17252,53,8,61,0,inf
17253,58,10,68,0,inf
17254,50,9,59,0,inf
17255,63,8,71,0,inf
17256,67,6,73,0,inf
17257,52,13,65,0,inf
17258,56,7,63,0,inf
17259,53,8,61,0,inf
17260,55,13,68,0,inf
17261,55,13,68,0,inf
17262,60,7,67,0,inf
17263,66,8,74,0,inf
17264,58,6,64,0,inf
17265,58,7,65,0,inf
17266,56,5,61,0,inf
17267,54,5,59,0,inf
17268,63,10,73,0,inf
17269,58,9,67,1,6.280670543084696
17270,66,13,79,0,inf
17271,52,11,63,0,inf
17272,52,12,64,0,inf
17273,66,8,74,0,inf
17274,54,6,60,0,inf
17275,59,5,64,0,inf
17276,65,7,72,0,inf
17277,51,12,63,0,inf
17278,54,5,59,0,inf
17279,65,12,77,0,inf
17280,56,8,64,0,inf
17281,67,9,76,0,inf
17282,65,12,77,0,inf
17283,56,11,67,0,inf
17284,59,9,68,0,inf
17285,54,5,59,0,inf
17286,51,5,56,0,inf
17287,52,11,63,0,inf
17288,58,5,63,0,inf
17289,54,13,67,0,inf
17290,57,11,68,0,inf
17291,52,11,63,0,inf
17292,67,6,73,0,inf
17293,51,5,56,0,inf
17294,65,6,71,0,inf
17295,55,11,66,0,inf
17296,65,12,77,0,inf
17297,55,13,68,0,inf
17298,59,13,72,0,inf
17299,50,13,63,0,inf
17300,59,10,69,0,inf
17301,57,9,66,0,inf
17302,54,13,67,0,inf
17303,51,5,56,0,inf
17304,66,12,78,0,inf
17305,58,6,64,0,inf
17306,66,11,77,0,inf
17307,60,10,70,0,inf
17308,67,10,77,0,inf
17309,56,9,65,0,inf
17310,56,13,69,0,inf
17311,62,10,72,0,inf
17312,51,5,56,0,inf
17313,62,6,68,0,inf
17314,56,8,64,0,inf
17315,61,12,73,0,inf
17316,52,13,65,0,inf
17317,58,9,67,0,inf
17318,59,6,65,0,inf
17319,65,12,77,0,inf
17320,65,8,73,0,inf
17321,66,10,76,0,inf
17322,51,6,57,0,inf
17323,51,11,62,0,inf
17324,51,7,58,0,inf
17325,55,12,67,0,inf
17326,60,11,71,0,inf
17327,55,9,64,0,inf
17328,60,7,67,0,inf
17329,66,5,71,0,inf
17330,54,6,60,0,inf
17331,57,5,62,0,inf
17332,58,10,68,0,inf
17333,61,11,72,0,inf
17334,53,8,61,0,inf
17335,50,12,62,0,inf
17336,55,13,68,0,inf
17337,51,11,62,0,inf
17338,55,12,67,0,inf
17339,64,8,72,0,inf
17340,62,10,72,0,inf
17341,51,5,56,0,inf
17342,51,13,64,0,inf
17343,66,6,72,0,inf
17344,50,8,58,0,inf
17345,62,13,75,0,inf
17346,65,5,70,0,inf
17347,60,11,71,0,inf
17348,60,7,67,0,inf
17349,53,13,66,0,inf
17350,61,7,68,0,inf
17351,60,5,65,0,inf
17352,52,8,60,0,inf
17353,61,6,67,0,inf
17354,53,13,66,0,inf
17355,52,10,62,0,inf
17356,52,5,57,0,inf
17357,52,9,61,0,inf
17358,67,5,72,0,inf
17359,58,12,70,0,inf
17360,57,6,63,0,inf
17361,65,8,73,0,inf
17362,66,9,75,0,inf
17363,53,6,59,0,inf
17364,51,10,61,0,inf
17365,56,5,61,0,inf
17366,67,8,75,0,inf
17367,67,8,75,0,inf
17368,50,10,60,0,inf
17369,57,9,66,0,inf
17370,62,9,71,0,inf
17371,60,10,70,0,inf
17372,57,9,66,0,inf
17373,61,10,71,0,inf
17374,63,8,71,0,inf
17375,60,7,67,0,inf
17376,62,10,72,0,inf
17377,53,5,58,0,inf
17378,52,12,64,0,inf
17379,62,12,74,0,inf
17380,66,13,79,0,inf
17381,62,6,68,0,inf
17382,51,5,56,0,inf
17383,65,6,71,0,inf
17384,66,12,78,0,inf
17385,61,8,69,0,inf
17386,67,12,79,0,inf
17387,50,7,57,0,inf
17388,59,11,70,0,inf
17389,61,9,70,0,inf
17390,62,11,73,0,inf
17391,53,5,58,0,inf
17392,66,6,72,0,inf
17393,60,10,70,0,inf
17394,66,10,76,0,inf
17395,50,8,58,0,inf
17396,55,9,64,1,8.744210566885826
17397,64,5,69,0,inf
17398,63,6,69,0,inf
17399,64,5,69,0,inf
17400,67,5,72,0,inf
17401,57,13,70,0,inf
17402,53,8,61,0,inf
17403,63,8,71,0,inf
17404,67,11,78,0,inf
17405,61,7,68,1,5.086933352820736
17406,61,8,69,0,inf
17407,66,6,72,0,inf
17408,61,5,66,0,inf
17409,61,9,70,0,inf
17410,53,6,59,0,inf
17411,66,10,76,0,inf
17412,65,7,72,0,inf
17413,51,7,58,0,inf
17414,64,13,77,0,inf
17415,63,7,70,0,inf
17416,66,7,73,0,inf
17417,64,7,71,0,inf
17418,56,10,66,0,inf
17419,61,5,66,0,inf
17420,59,11,70,0,inf
17421,51,13,64,0,inf
17422,60,5,65,0,inf
17423,59,7,66,0,inf
17424,50,12,62,0,inf
17425,67,6,73,1,4.138487747900726
17426,54,13,67,1,3.74513400534191
17427,57,13,70,0,inf
17428,51,10,61,0,inf
17429,51,6,57,0,inf
17430,67,8,75,0,inf
17431,55,9,64,0,inf
17432,55,8,63,0,inf
17433,66,12,78,0,inf
17434,52,13,65,0,inf
17435,55,7,62,0,inf
17436,53,7,60,0,inf
17437,54,13,67,0,inf
17438,51,8,59,0,inf
17439,51,10,61,0,inf
17440,63,13,76,0,inf
17441,61,12,73,0,inf
17442,62,6,68,0,inf
17443,52,6,58,0,inf
17444,52,7,59,0,inf
17445,53,12,65,0,inf
17446,61,5,66,0,inf
17447,59,13,72,0,inf
17448,53,12,65,0,inf
17449,57,6,63,0,inf
17450,54,8,62,0,inf
17451,63,6,69,0,inf
17452,50,11,61,0,inf
17453,61,12,73,0,inf
17454,57,7,64,0,inf
17455,59,10,69,1,3.478917744172321
17456,67,13,80,0,inf
17457,54,5,59,0,inf
17458,52,11,63,0,inf
17459,52,9,61,1,0.5554907824753386
17460,62,13,75,0,inf
17461,62,9,71,0,inf
17462,50,10,60,0,inf
17463,62,9,71,0,inf
17464,60,8,68,0,inf
17465,61,7,68,0,inf
17466,61,11,72,1,9.130660685307518
17467,50,9,59,0,inf
17468,59,10,69,0,inf
17469,66,8,74,0,inf
17470,53,12,65,0,inf
17471,56,7,63,0,inf
17472,66,7,73,0,inf
17473,65,7,72,0,inf
17474,52,11,63,0,inf
17475,53,9,62,0,inf
17476,60,10,70,0,inf
17477,55,11,66,0,inf
17478,64,5,69,0,inf
17479,58,11,69,0,inf
17480,64,6,70,0,inf
17481,64,5,69,0,inf
17482,54,11,65,0,inf
17483,56,11,67,0,inf
17484,60,13,73,0,inf
17485,66,6,72,0,inf
17486,58,8,66,0,inf
17487,67,10,77,0,inf
17488,57,8,65,0,inf
17489,66,10,76,0,inf
17490,67,11,78,0,inf
17491,62,12,74,0,inf
17492,66,5,71,0,inf
17493,53,6,59,0,inf
17494,58,9,67,0,inf
17495,64,5,69,0,inf
17496,54,5,59,0,inf
17497,59,13,72,1,1.1618819881596778
17498,62,10,72,0,inf
17499,61,6,67,0,inf
17500,60,6,66,0,inf
17501,51,12,63,1,2.015636789944722
17502,62,10,72,0,inf
17503,59,12,71,0,inf
17504,63,13,76,0,inf
17505,58,13,71,0,inf
17506,62,10,72,0,inf
17507,55,9,64,0,inf
17508,66,7,73,0,inf
17509,57,7,64,0,inf
17510,60,12,72,0,inf
17511,58,10,68,1,0.39752445538854886
17512,50,13,63,0,inf
17513,50,11,61,0,inf
17514,65,8,73,0,inf
17515,59,7,66,0,inf
17516,64,9,73,0,inf
17517,54,8,62,0,inf
17518,56,13,69,0,inf
17519,56,12,68,0,inf
17520,54,7,61,0,inf
17521,64,5,69,0,inf
17522,52,9,61,0,inf
17523,60,9,69,0,inf
17524,62,9,71,0,inf
17525,66,5,71,0,inf
17526,54,8,62,0,inf
17527,65,13,78,0,inf
17528,62,8,70,0,inf
17529,60,12,72,0,inf
17530,54,12,66,0,inf
17531,65,10,75,0,inf
17532,53,10,63,0,inf
17533,51,8,59,0,inf
17534,67,7,74,0,inf
17535,64,9,73,0,inf
17536,59,9,68,0,inf
17537,67,11,78,0,inf
17538,58,7,65,0,inf
17539,55,5,60,0,inf
17540,55,7,62,0,inf
17541,53,5,58,0,inf
17542,57,10,67,0,inf
17543,55,7,62,0,inf
17544,57,10,67,0,inf
17545,56,12,68,0,inf
17546,58,8,66,0,inf
17547,60,9,69,0,inf
17548,65,8,73,0,inf
17549,66,9,75,0,inf
17550,56,7,63,0,inf
17551,54,13,67,0,inf
17552,53,10,63,0,inf
17553,55,6,61,0,inf
17554,64,9,73,0,inf
17555,65,7,72,0,inf
17556,52,13,65,0,inf
17557,63,12,75,1,9.638605975660525
17558,57,10,67,0,inf
17559,62,9,71,0,inf
17560,64,8,72,0,inf
17561,51,5,56,0,inf
17562,61,7,68,0,inf
17563,51,6,57,0,inf
17564,51,11,62,0,inf
17565,52,13,65,0,inf
17566,65,8,73,0,inf
17567,67,10,77,0,inf
17568,51,11,62,0,inf
17569,51,7,58,0,inf
17570,59,11,70,0,inf
17571,50,5,55,0,inf
17572,58,8,66,1,4.381914486812526
17573,52,12,64,0,inf
17574,55,7,62,0,inf
17575,62,6,68,0,inf
17576,66,7,73,0,inf
17577,59,10,69,0,inf
17578,63,9,72,0,inf
17579,67,8,75,0,inf
17580,65,8,73,0,inf
17581,60,10,70,0,inf
17582,52,11,63,0,inf
17583,65,11,76,0,inf
17584,51,12,63,0,inf
17585,64,5,69,0,inf
17586,66,8,74,0,inf
17587,62,11,73,0,inf
17588,61,6,67,0,inf
17589,62,6,68,0,inf
17590,52,8,60,0,inf
17591,61,9,70,0,inf
17592,54,6,60,0,inf
17593,65,8,73,0,inf
17594,54,13,67,0,inf
17595,51,12,63,0,inf
17596,56,9,65,0,inf
17597,54,9,63,0,inf
17598,56,11,67,0,inf
17599,56,13,69,0,inf
17600,65,5,70,0,inf
17601,59,7,66,0,inf
17602,55,11,66,0,inf
17603,52,7,59,0,inf
17604,53,7,60,0,inf
17605,64,12,76,0,inf
17606,56,6,62,1,4.218203555216142
17607,61,13,74,0,inf
17608,66,11,77,0,inf
17609,55,12,67,0,inf
17610,60,5,65,0,inf
17611,63,8,71,0,inf
17612,58,5,63,0,inf
17613,59,7,66,0,inf
17614,51,6,57,0,inf
17615,60,11,71,0,inf
17616,53,5,58,0,inf
17617,61,11,72,0,inf
17618,57,10,67,0,inf
17619,53,9,62,0,inf
17620,50,11,61,0,inf
17621,54,9,63,0,inf
17622,50,6,56,0,inf
17623,52,11,63,0,inf
17624,66,11,77,0,inf
17625,55,11,66,0,inf
17626,56,8,64,0,inf
17627,58,8,66,0,inf
17628,53,11,64,1,8.664755829465292
17629,52,11,63,0,inf
17630,56,11,67,0,inf
17631,64,10,74,0,inf
17632,61,10,71,0,inf
17633,54,5,59,0,inf
17634,54,11,65,0,inf
17635,50,7,57,0,inf
17636,56,12,68,0,inf
17637,58,12,70,0,inf
17638,54,9,63,0,inf
17639,51,7,58,0,inf
17640,66,9,75,0,inf
17641,67,9,76,0,inf
17642,58,9,67,0,inf
17643,62,12,74,0,inf
17644,61,11,72,0,inf
17645,55,8,63,0,inf
17646,64,11,75,0,inf
17647,60,10,70,0,inf
17648,59,9,68,0,inf
17649,55,9,64,0,inf
17650,52,7,59,0,inf
17651,62,9,71,0,inf
17652,62,13,75,0,inf
17653,53,11,64,0,inf
17654,51,9,60,0,inf
17655,50,11,61,0,inf
17656,54,12,66,0,inf
17657,54,8,62,0,inf
17658,67,9,76,0,inf
17659,52,9,61,0,inf
17660,55,5,60,0,inf
17661,56,9,65,0,inf
17662,61,8,69,0,inf
17663,51,10,61,0,inf
17664,65,13,78,0,inf
17665,56,12,68,0,inf
17666,56,9,65,1,3.642387834219548
17667,58,6,64,0,inf
17668,53,11,64,0,inf
17669,57,8,65,0,inf
17670,66,9,75,0,inf
17671,62,11,73,0,inf
17672,52,12,64,0,inf
17673,63,11,74,0,inf
17674,62,9,71,0,inf
17675,57,10,67,0,inf
17676,55,9,64,0,inf
17677,64,6,70,0,inf
17678,59,5,64,0,inf
17679,64,11,75,0,inf
17680,56,6,62,0,inf
17681,54,9,63,0,inf
17682,58,11,69,0,inf
17683,61,10,71,0,inf
17684,56,6,62,0,inf
17685,59,7,66,0,inf
17686,59,13,72,0,inf
17687,64,10,74,0,inf
17688,51,9,60,0,inf
17689,64,11,75,1,0.6990179933075922
17690,53,12,65,0,inf
17691,66,8,74,0,inf
17692,55,8,63,0,inf
17693,57,11,68,0,inf
17694,67,7,74,0,inf
17695,67,11,78,0,inf
17696,62,13,75,0,inf
17697,60,7,67,0,inf
17698,52,10,62,0,inf
17699,60,10,70,0,inf
17700,66,13,79,0,inf
17701,53,12,65,0,inf
17702,59,7,66,0,inf
17703,63,5,68,0,inf
17704,56,13,69,0,inf
17705,60,8,68,0,inf
17706,52,5,57,0,inf
17707,54,13,67,0,inf
17708,54,8,62,1,3.097409239775864
17709,56,8,64,0,inf
17710,52,13,65,0,inf
17711,57,8,65,0,inf
17712,54,7,61,0,inf
17713,58,5,63,0,inf
17714,56,9,65,0,inf
17715,61,10,71,0,inf
17716,58,10,68,0,inf
17717,56,13,69,0,inf
17718,59,9,68,0,inf
17719,63,5,68,0,inf
17720,63,5,68,1,1.3518939473109555
17721,54,7,61,0,inf
17722,50,10,60,0,inf
17723,66,9,75,0,inf
17724,66,10,76,0,inf
17725,67,5,72,0,inf
17726,65,13,78,0,inf
17727,62,7,69,0,inf
17728,67,5,72,0,inf
17729,55,12,67,0,inf
17730,56,8,64,0,inf
17731,55,11,66,0,inf
17732,50,8,58,0,inf
17733,55,5,60,0,inf
17734,56,11,67,0,inf
17735,53,9,62,0,inf
17736,50,10,60,0,inf
17737,54,13,67,0,inf
17738,56,11,67,0,inf
17739,67,13,80,0,inf
17740,58,13,71,0,inf
17741,59,6,65,0,inf
17742,63,6,69,0,inf
17743,53,12,65,0,inf
17744,60,5,65,0,inf
17745,67,7,74,0,inf
17746,54,11,65,0,inf
17747,66,10,76,0,inf
17748,57,13,70,0,inf
17749,56,5,61,0,inf
17750,55,7,62,0,inf
17751,50,7,57,0,inf
17752,56,13,69,0,inf
17753,60,9,69,0,inf
17754,61,10,71,0,inf
17755,51,6,57,0,inf
17756,65,9,74,0,inf
17757,60,6,66,0,inf
17758,57,11,68,0,inf
17759,63,11,74,0,inf
17760,63,7,70,0,inf
17761,64,5,69,0,inf
17762,67,8,75,0,inf
17763,66,6,72,0,inf
17764,53,11,64,1,2.4366132890167407
17765,56,12,68,0,inf
17766,52,5,57,0,inf
17767,58,11,69,0,inf
17768,53,5,58,0,inf
17769,62,8,70,0,inf
17770,57,9,66,0,inf
17771,60,12,72,0,inf
17772,60,12,72,0,inf
17773,55,13,68,0,inf
17774,67,5,72,0,inf
17775,50,5,55,1,1.7001586466207144
17776,60,12,72,0,inf
17777,62,6,68,0,inf
17778,62,10,72,0,inf
17779,56,10,66,0,inf
17780,57,10,67,0,inf
17781,57,8,65,0,inf
17782,62,7,69,0,inf
17783,58,8,66,0,inf
17784,50,13,63,0,inf
17785,65,7,72,0,inf
17786,61,10,71,0,inf
17787,53,9,62,0,inf
17788,53,9,62,0,inf
17789,54,8,62,0,inf
17790,57,9,66,0,inf
17791,67,11,78,0,inf
17792,57,8,65,0,inf
17793,60,12,72,0,inf
17794,67,6,73,0,inf
17795,62,5,67,0,inf
17796,51,12,63,0,inf
17797,59,10,69,0,inf
17798,67,12,79,0,inf
17799,56,6,62,0,inf
17800,63,10,73,0,inf
17801,66,12,78,0,inf
17802,52,5,57,0,inf
17803,61,13,74,0,inf
17804,64,10,74,0,inf
17805,62,13,75,0,inf
17806,59,5,64,0,inf
17807,61,11,72,0,inf
17808,50,11,61,0,inf
17809,50,13,63,0,inf
17810,63,11,74,0,inf
17811,62,12,74,0,inf
17812,61,6,67,0,inf
17813,59,6,65,0,inf
17814,63,7,70,0,inf
17815,60,11,71,1,10.554282970227845
17816,66,5,71,0,inf
17817,65,10,75,0,inf
17818,51,7,58,0,inf
17819,58,12,70,0,inf
17820,67,5,72,0,inf
17821,62,9,71,0,inf
17822,50,10,60,0,inf
17823,59,8,67,0,inf
17824,64,12,76,0,inf
17825,51,12,63,0,inf
17826,50,9,59,0,inf
17827,50,5,55,0,inf
17828,50,6,56,0,inf
17829,60,5,65,0,inf
17830,52,10,62,0,inf
17831,59,6,65,0,inf
17832,64,11,75,0,inf
17833,50,7,57,0,inf
17834,64,7,71,0,inf
17835,59,5,64,0,inf
17836,64,6,70,1,1.2424315737669787
17837,50,9,59,0,inf
17838,50,11,61,0,inf
17839,63,11,74,0,inf
17840,64,8,72,0,inf
17841,64,9,73,0,inf
17842,67,7,74,0,inf
17843,65,10,75,0,inf
17844,59,9,68,0,inf
17845,61,7,68,0,inf
17846,57,12,69,0,inf
17847,61,12,73,0,inf
17848,51,7,58,0,inf
17849,59,5,64,0,inf
17850,61,9,70,0,inf
17851,52,13,65,0,inf
17852,63,7,70,0,inf
17853,63,10,73,0,inf
17854,63,8,71,0,inf
17855,52,7,59,0,inf
17856,62,12,74,0,inf
17857,64,7,71,0,inf
17858,61,9,70,0,inf
17859,58,10,68,0,inf
17860,67,13,80,0,inf
17861,61,9,70,1,2.9209129700623464
17862,58,13,71,0,inf
17863,55,12,67,0,inf
17864,50,10,60,0,inf
17865,57,9,66,0,inf
17866,56,5,61,0,inf
17867,57,13,70,0,inf
17868,63,7,70,0,inf
17869,55,12,67,0,inf
17870,60,12,72,0,inf
17871,67,7,74,0,inf
17872,54,7,61,0,inf
17873,66,8,74,0,inf
17874,55,11,66,0,inf
17875,50,7,57,0,inf
17876,66,12,78,0,inf
17877,64,9,73,0,inf
17878,66,9,75,0,inf
17879,64,8,72,0,inf
17880,59,8,67,0,inf
17881,56,8,64,0,inf
17882,63,6,69,0,inf
17883,64,7,71,0,inf
17884,61,5,66,0,inf
17885,58,8,66,0,inf
17886,57,7,64,0,inf
17887,53,9,62,0,inf
17888,50,11,61,0,inf
17889,50,5,55,0,inf
17890,62,12,74,0,inf
17891,52,6,58,0,inf
17892,63,8,71,0,inf
17893,65,9,74,0,inf
17894,56,8,64,0,inf
17895,64,12,76,0,inf
17896,62,7,69,0,inf
17897,56,5,61,0,inf
17898,50,13,63,0,inf
17899,50,8,58,0,inf
17900,50,12,62,0,inf
17901,63,12,75,0,inf
17902,64,9,73,0,inf
17903,60,6,66,0,inf
17904,55,12,67,0,inf
17905,65,12,77,0,inf
17906,51,10,61,0,inf
17907,51,11,62,0,inf
17908,57,12,69,0,inf
17909,67,6,73,0,inf
17910,50,12,62,0,inf
17911,62,11,73,0,inf
17912,63,9,72,0,inf
17913,67,8,75,0,inf
17914,52,12,64,0,inf
17915,52,8,60,0,inf
17916,53,12,65,0,inf
17917,64,11,75,0,inf
17918,50,6,56,0,inf
17919,54,5,59,0,inf
17920,59,10,69,0,inf
17921,65,7,72,0,inf
17922,54,9,63,0,inf
17923,56,7,63,0,inf
17924,54,10,64,0,inf
17925,61,11,72,0,inf
17926,57,12,69,0,inf
17927,57,12,69,0,inf
17928,54,6,60,0,inf
17929,55,6,61,0,inf
17930,66,6,72,0,inf
17931,61,9,70,0,inf
17932,50,7,57,0,inf
17933,55,8,63,0,inf
17934,55,7,62,0,inf
17935,55,13,68,0,inf
17936,61,5,66,0,inf
17937,65,13,78,0,inf
17938,60,8,68,0,inf
17939,65,6,71,0,inf
17940,64,5,69,0,inf
17941,61,13,74,1,4.64465767420667
17942,50,11,61,0,inf
17943,63,7,70,0,inf
17944,54,6,60,0,inf
17945,60,8,68,0,inf
17946,63,9,72,0,inf
17947,62,10,72,0,inf
17948,66,13,79,0,inf
17949,56,5,61,0,inf
17950,67,6,73,0,inf
17951,59,5,64,0,inf
17952,64,12,76,0,inf
17953,64,13,77,0,inf
17954,58,10,68,1,0.7267435877420567
17955,54,9,63,0,inf
17956,66,13,79,0,inf
17957,53,5,58,0,inf
17958,52,12,64,0,inf
17959,53,9,62,0,inf
17960,55,13,68,0,inf
17961,51,8,59,0,inf
17962,53,6,59,0,inf
17963,60,8,68,0,inf
17964,54,11,65,0,inf
17965,61,11,72,0,inf
17966,63,5,68,1,3.5028249656737387
17967,57,9,66,0,inf
17968,51,5,56,0,inf
17969,52,13,65,0,inf
17970,55,11,66,0,inf
17971,65,6,71,0,inf
17972,56,7,63,0,inf
17973,58,11,69,0,inf
17974,58,12,70,0,inf
17975,54,13,67,0,inf
17976,63,11,74,0,inf
17977,53,5,58,0,inf
17978,51,7,58,0,inf
17979,57,9,66,0,inf
17980,56,10,66,0,inf
17981,62,11,73,0,inf
17982,51,13,64,0,inf
17983,62,7,69,0,inf
17984,58,8,66,0,inf
17985,64,6,70,0,inf
17986,62,5,67,0,inf
17987,64,9,73,0,inf
17988,54,8,62,0,inf
17989,59,13,72,0,inf
17990,59,9,68,0,inf
17991,52,9,61,0,inf
17992,63,7,70,0,inf
17993,50,5,55,0,inf
17994,65,9,74,0,inf
17995,50,13,63,0,inf
17996,52,8,60,0,inf
17997,52,6,58,0,inf
17998,53,7,60,0,inf
17999,58,11,69,0,inf
18000,55,13,68,0,inf
18001,50,5,55,0,inf
18002,61,10,71,0,inf
18003,64,10,74,0,inf
18004,67,11,78,0,inf
18005,64,7,71,0,inf
18006,65,8,73,0,inf
18007,66,8,74,0,inf
18008,62,10,72,0,inf
18009,56,8,64,0,inf
18010,58,7,65,0,inf
18011,55,8,63,0,inf
18012,51,9,60,0,inf
18013,51,9,60,0,inf
18014,67,11,78,0,inf
18015,64,8,72,0,inf
18016,58,6,64,0,inf
18017,65,5,70,0,inf
18018,55,13,68,0,inf
18019,52,7,59,0,inf
18020,56,6,62,0,inf
18021,66,7,73,0,inf
18022,62,6,68,1,3.9061165642145568
18023,65,13,78,1,6.084709568026327
18024,54,12,66,0,inf
18025,53,12,65,0,inf
18026,67,10,77,0,inf
18027,59,7,66,0,inf
18028,53,13,66,0,inf
18029,63,13,76,0,inf
18030,56,13,69,0,inf
18031,54,13,67,0,inf
18032,52,5,57,0,inf
18033,53,11,64,0,inf
18034,63,9,72,0,inf
18035,54,6,60,0,inf
18036,54,11,65,1,10.986078055602476
18037,58,8,66,0,inf
18038,65,12,77,0,inf
18039,52,10,62,0,inf
18040,65,13,78,0,inf
18041,65,6,71,0,inf
18042,61,13,74,0,inf
18043,56,8,64,0,inf
18044,60,6,66,0,inf
18045,60,6,66,0,inf
18046,62,7,69,0,inf
18047,54,6,60,0,inf
18048,54,8,62,0,inf
18049,50,5,55,0,inf
18050,63,7,70,0,inf
18051,64,10,74,0,inf
18052,53,9,62,0,inf
18053,60,9,69,0,inf
18054,65,12,77,0,inf
18055,52,7,59,0,inf
18056,55,11,66,0,inf
18057,65,7,72,0,inf
18058,59,13,72,0,inf
18059,50,5,55,0,inf
18060,58,6,64,0,inf
18061,64,9,73,0,inf
18062,55,6,61,0,inf
18063,63,5,68,0,inf
18064,67,11,78,0,inf
18065,50,10,60,0,inf
18066,55,7,62,0,inf
18067,67,8,75,0,inf
18068,53,12,65,0,inf
18069,65,6,71,0,inf
18070,64,5,69,0,inf
18071,67,7,74,0,inf
18072,66,13,79,0,inf
18073,53,9,62,0,inf
18074,54,8,62,0,inf
18075,65,10,75,0,inf
18076,63,5,68,0,inf
18077,53,9,62,0,inf
18078,55,5,60,0,inf
18079,61,11,72,0,inf
18080,62,11,73,0,inf
18081,63,5,68,0,inf
18082,57,12,69,0,inf
18083,58,12,70,0,inf
18084,55,12,67,0,inf
18085,64,9,73,0,inf
18086,50,8,58,1,5.543458337771511
18087,65,11,76,0,inf
18088,58,7,65,0,inf
18089,50,13,63,0,inf
18090,56,12,68,0,inf
18091,57,7,64,0,inf
18092,58,12,70,0,inf
18093,56,11,67,0,inf
18094,63,11,74,0,inf
18095,60,6,66,0,inf
18096,54,11,65,0,inf
18097,59,11,70,0,inf
18098,52,13,65,0,inf
18099,52,6,58,0,inf
18100,62,7,69,0,inf
18101,55,12,67,0,inf
18102,50,12,62,0,inf
18103,61,6,67,0,inf
18104,63,13,76,0,inf
18105,58,7,65,0,inf
18106,53,13,66,0,inf
18107,63,9,72,0,inf
18108,59,13,72,0,inf
18109,66,5,71,0,inf
18110,56,10,66,0,inf
18111,52,10,62,0,inf
18112,60,11,71,0,inf
18113,67,5,72,0,inf
18114,67,13,80,0,inf
18115,61,8,69,0,inf
18116,64,6,70,0,inf
18117,63,6,69,0,inf
18118,66,10,76,0,inf
18119,54,13,67,0,inf
18120,66,8,74,0,inf
18121,55,8,63,0,inf
18122,61,9,70,0,inf
18123,61,9,70,0,inf
18124,61,13,74,1,8.72814677920644
18125,53,12,65,0,inf
18126,52,12,64,0,inf
18127,64,5,69,0,inf
18128,56,13,69,0,inf
18129,58,13,71,0,inf
18130,66,13,79,0,inf
18131,53,6,59,0,inf
18132,61,5,66,0,inf
18133,50,10,60,0,inf
18134,55,8,63,0,inf
18135,58,6,64,0,inf
18136,51,11,62,0,inf
18137,63,7,70,0,inf
18138,63,12,75,0,inf
18139,60,6,66,0,inf
18140,58,10,68,0,inf
18141,63,6,69,0,inf
18142,67,13,80,0,inf
18143,62,11,73,0,inf
18144,63,10,73,0,inf
18145,65,11,76,0,inf
18146,62,8,70,0,inf
18147,63,12,75,0,inf
18148,51,12,63,0,inf
18149,67,11,78,0,inf
18150,59,13,72,0,inf
18151,63,8,71,0,inf
18152,59,7,66,0,inf
18153,51,8,59,0,inf
18154,55,11,66,0,inf
18155,54,6,60,0,inf
18156,50,6,56,0,inf
18157,60,9,69,0,inf
18158,61,9,70,0,inf
18159,58,6,64,0,inf
18160,50,6,56,0,inf
18161,60,9,69,0,inf
18162,59,8,67,0,inf
18163,62,10,72,0,inf
18164,51,7,58,0,inf
18165,64,12,76,0,inf
18166,66,10,76,0,inf
18167,60,5,65,0,inf
18168,64,8,72,0,inf
18169,54,10,64,0,inf
18170,59,12,71,0,inf
18171,65,9,74,0,inf
18172,50,13,63,0,inf
18173,53,8,61,0,inf
18174,60,11,71,0,inf
18175,65,6,71,0,inf
18176,61,6,67,0,inf
18177,60,13,73,0,inf
18178,50,7,57,0,inf
18179,50,13,63,1,10.223784662485762
18180,59,11,70,0,inf
18181,64,8,72,0,inf
18182,65,7,72,0,inf
18183,62,12,74,1,5.196293173883788
18184,59,5,64,0,inf
18185,59,6,65,0,inf
18186,56,5,61,0,inf
18187,54,12,66,0,inf
18188,53,5,58,0,inf
18189,56,11,67,0,inf
18190,66,9,75,0,inf
18191,67,10,77,0,inf
18192,66,6,72,0,inf
18193,66,10,76,0,inf
18194,65,7,72,0,inf
18195,67,6,73,0,inf
18196,62,13,75,0,inf
18197,63,6,69,0,inf
18198,53,8,61,0,inf
18199,67,5,72,0,inf
18200,60,12,72,0,inf
18201,57,9,66,0,inf
18202,66,5,71,0,inf
18203,66,12,78,0,inf
18204,54,10,64,0,inf
18205,65,5,70,0,inf
18206,60,10,70,0,inf
18207,52,7,59,0,inf
18208,55,9,64,0,inf
18209,61,6,67,0,inf
18210,50,9,59,1,0.799766168826821
18211,51,10,61,0,inf
18212,63,8,71,0,inf
18213,63,6,69,0,inf
18214,60,7,67,0,inf
18215,58,10,68,0,inf
18216,51,12,63,0,inf
18217,54,11,65,0,inf
18218,66,12,78,0,inf
18219,65,8,73,0,inf
18220,50,6,56,0,inf
18221,55,13,68,0,inf
18222,61,11,72,0,inf
18223,60,8,68,0,inf
18224,63,11,74,0,inf
18225,65,10,75,0,inf
18226,64,10,74,0,inf
18227,62,13,75,0,inf
18228,61,7,68,0,inf
18229,63,8,71,0,inf
18230,56,7,63,0,inf
18231,55,7,62,0,inf
18232,58,8,66,0,inf
18233,67,12,79,0,inf
18234,53,9,62,0,inf
18235,59,8,67,0,inf
18236,59,10,69,0,inf
18237,54,7,61,0,inf
18238,57,13,70,0,inf
18239,52,8,60,0,inf
18240,59,11,70,0,inf
18241,57,10,67,0,inf
18242,67,12,79,0,inf
18243,52,12,64,0,inf
18244,56,7,63,0,inf
18245,66,12,78,0,inf
18246,66,11,77,0,inf
18247,55,9,64,0,inf
18248,64,12,76,0,inf
18249,64,9,73,0,inf
18250,51,11,62,0,inf
18251,65,11,76,0,inf
18252,62,5,67,0,inf
18253,67,10,77,0,inf
18254,57,8,65,0,inf
18255,67,10,77,0,inf
18256,63,11,74,0,inf
18257,65,5,70,0,inf
18258,57,12,69,0,inf
18259,54,8,62,0,inf
18260,56,7,63,0,inf
18261,53,10,63,0,inf
18262,56,9,65,0,inf
18263,66,5,71,0,inf
18264,61,12,73,1,10.620288177511028
18265,62,12,74,1,3.4215771164858353
18266,63,10,73,0,inf
18267,53,5,58,0,inf
18268,53,7,60,0,inf
18269,56,9,65,0,inf
18270,57,5,62,0,inf
18271,52,6,58,0,inf
18272,51,13,64,0,inf
18273,59,9,68,0,inf
18274,61,5,66,0,inf
18275,56,9,65,0,inf
18276,53,8,61,0,inf
18277,55,8,63,0,inf
18278,58,7,65,0,inf
18279,50,7,57,0,inf
18280,57,12,69,0,inf
18281,58,12,70,0,inf
18282,61,9,70,0,inf
18283,62,10,72,0,inf
18284,61,12,73,0,inf
18285,54,5,59,0,inf
18286,51,5,56,0,inf
18287,56,11,67,0,inf
18288,67,7,74,0,inf
18289,52,8,60,0,inf
18290,52,5,57,0,inf
18291,67,7,74,0,inf
18292,57,10,67,0,inf
18293,56,12,68,0,inf
18294,62,9,71,0,inf
18295,53,8,61,0,inf
18296,61,5,66,0,inf
18297,57,11,68,0,inf
18298,51,10,61,0,inf
18299,66,10,76,0,inf
18300,63,11,74,0,inf
18301,54,9,63,0,inf
18302,59,8,67,0,inf
18303,61,7,68,1,5.2423429092741
18304,52,13,65,0,inf
18305,52,8,60,0,inf
18306,65,12,77,0,inf
18307,66,12,78,0,inf
18308,50,10,60,0,inf
18309,57,9,66,0,inf
18310,63,5,68,0,inf
18311,57,7,64,0,inf
18312,64,8,72,0,inf
18313,60,8,68,0,inf
18314,67,12,79,0,inf
18315,51,9,60,0,inf
18316,51,7,58,0,inf
18317,58,9,67,0,inf
18318,66,11,77,0,inf
18319,53,6,59,0,inf
18320,65,12,77,0,inf
18321,57,5,62,0,inf
18322,67,12,79,0,inf
18323,60,7,67,0,inf
18324,53,7,60,0,inf
18325,61,8,69,0,inf
18326,67,6,73,0,inf
18327,50,12,62,0,inf
18328,59,5,64,0,inf
18329,64,9,73,0,inf
18330,53,6,59,0,inf
18331,63,6,69,0,inf
18332,59,6,65,0,inf
18333,54,5,59,0,inf
18334,62,12,74,0,inf
18335,50,13,63,0,inf
18336,54,8,62,0,inf
18337,53,7,60,0,inf
18338,57,10,67,0,inf
18339,63,11,74,0,inf
18340,55,12,67,0,inf
18341,66,13,79,1,11.733467064134814
18342,62,8,70,0,inf
18343,65,12,77,0,inf
18344,67,10,77,1,7.808226332866951
18345,54,12,66,0,inf
18346,67,5,72,0,inf
18347,67,13,80,0,inf
18348,60,9,69,0,inf
18349,56,9,65,0,inf
18350,57,6,63,0,inf
18351,62,9,71,0,inf
18352,64,8,72,1,3.0757723715266536
18353,63,11,74,0,inf
18354,52,6,58,1,5.416803340400804
18355,61,6,67,0,inf
18356,52,10,62,0,inf
18357,54,13,67,0,inf
18358,60,11,71,0,inf
18359,65,12,77,0,inf
18360,56,8,64,0,inf
18361,67,9,76,0,inf
18362,65,7,72,0,inf
18363,50,9,59,0,inf
18364,61,6,67,0,inf
18365,57,13,70,0,inf
18366,59,8,67,0,inf
18367,52,11,63,0,inf
18368,59,6,65,0,inf
18369,62,11,73,0,inf
18370,59,12,71,1,11.847475645562
18371,67,9,76,0,inf
18372,51,12,63,0,inf
18373,54,7,61,0,inf
18374,52,12,64,0,inf
18375,59,8,67,0,inf
18376,59,10,69,0,inf
18377,64,12,76,0,inf
18378,66,12,78,0,inf
18379,62,7,69,0,inf
18380,57,7,64,0,inf
18381,55,9,64,0,inf
18382,60,11,71,0,inf
18383,62,5,67,0,inf
18384,64,5,69,0,inf
18385,57,6,63,0,inf
18386,67,11,78,0,inf
18387,51,11,62,0,inf
18388,53,13,66,0,inf
18389,65,10,75,0,inf
18390,57,9,66,0,inf
18391,64,12,76,0,inf
18392,67,9,76,0,inf
18393,60,10,70,0,inf
18394,51,10,61,0,inf
18395,56,6,62,0,inf
18396,55,8,63,0,inf
18397,64,9,73,0,inf
18398,54,13,67,0,inf
18399,62,7,69,0,inf
18400,53,9,62,0,inf
18401,67,8,75,0,inf
18402,66,6,72,0,inf
18403,53,11,64,0,inf
18404,56,9,65,0,inf
18405,61,9,70,0,inf
18406,63,12,75,0,inf
18407,57,9,66,0,inf
18408,60,11,71,0,inf
18409,66,9,75,0,inf
18410,56,10,66,0,inf
18411,60,5,65,0,inf
18412,53,13,66,0,inf
18413,64,7,71,0,inf
18414,50,8,58,0,inf
18415,63,8,71,0,inf
18416,58,5,63,0,inf
18417,51,13,64,0,inf
18418,53,12,65,0,inf
18419,58,9,67,0,inf
18420,59,5,64,0,inf
18421,61,8,69,0,inf
18422,67,8,75,0,inf
18423,50,7,57,0,inf
18424,54,12,66,0,inf
18425,53,5,58,0,inf
18426,59,5,64,0,inf
18427,65,11,76,0,inf
18428,60,13,73,0,inf
18429,59,9,68,0,inf
18430,51,9,60,0,inf
18431,52,13,65,0,inf
18432,63,9,72,0,inf
18433,61,12,73,0,inf
18434,63,6,69,0,inf
18435,50,7,57,0,inf
18436,53,10,63,0,inf
18437,66,8,74,0,inf
18438,50,13,63,0,inf
18439,50,12,62,0,inf
18440,67,5,72,0,inf
18441,64,13,77,0,inf
18442,63,6,69,0,inf
18443,57,6,63,1,4.925716350510989
18444,60,5,65,0,inf
18445,67,7,74,0,inf
18446,55,6,61,0,inf
18447,54,5,59,0,inf
18448,52,11,63,0,inf
18449,57,9,66,0,inf
18450,59,5,64,0,inf
18451,62,9,71,0,inf
18452,56,10,66,0,inf
18453,52,12,64,0,inf
18454,51,8,59,0,inf
18455,67,6,73,0,inf
18456,54,6,60,0,inf
18457,53,8,61,0,inf
18458,64,7,71,0,inf
18459,61,9,70,0,inf
18460,67,11,78,0,inf
18461,50,7,57,0,inf
18462,61,10,71,0,inf
18463,64,9,73,0,inf
18464,55,10,65,0,inf
18465,60,7,67,1,0.13491770952276738
18466,64,5,69,0,inf
18467,65,8,73,0,inf
18468,59,8,67,0,inf
18469,60,11,71,0,inf
18470,65,10,75,0,inf
18471,52,11,63,0,inf
18472,58,9,67,0,inf
18473,57,6,63,0,inf
18474,58,5,63,0,inf
18475,51,5,56,0,inf
18476,66,6,72,0,inf
18477,59,9,68,0,inf
18478,61,7,68,0,inf
18479,60,9,69,0,inf
18480,53,12,65,0,inf
18481,62,10,72,0,inf
18482,50,13,63,0,inf
18483,66,5,71,0,inf
18484,60,5,65,0,inf
18485,58,5,63,0,inf
18486,53,11,64,0,inf
18487,58,7,65,0,inf
18488,64,7,71,0,inf
18489,51,13,64,0,inf
18490,51,6,57,0,inf
18491,50,11,61,0,inf
18492,66,13,79,0,inf
18493,64,5,69,0,inf
18494,63,11,74,0,inf
18495,63,13,76,0,inf
18496,61,11,72,0,inf
18497,54,12,66,0,inf
18498,66,9,75,0,inf
18499,59,11,70,0,inf
18500,66,10,76,0,inf
18501,63,6,69,1,4.823759988515633
18502,67,9,76,0,inf
18503,56,12,68,0,inf
18504,52,7,59,0,inf
18505,56,12,68,1,7.332633999519096
18506,62,12,74,0,inf
18507,56,5,61,0,inf
18508,63,11,74,0,inf
18509,51,9,60,0,inf
18510,50,6,56,0,inf
18511,67,10,77,0,inf
18512,59,9,68,0,inf
18513,66,10,76,0,inf
18514,50,8,58,0,inf
18515,61,12,73,0,inf
18516,55,10,65,0,inf
18517,53,7,60,0,inf
18518,65,11,76,0,inf
18519,58,11,69,0,inf
18520,51,11,62,0,inf
18521,65,6,71,0,inf
18522,57,12,69,0,inf
18523,63,10,73,0,inf
18524,59,11,70,0,inf
18525,66,13,79,0,inf
18526,62,13,75,1,9.222799198298617
18527,60,8,68,0,inf
18528,61,11,72,0,inf
18529,50,6,56,0,inf
18530,61,10,71,0,inf
18531,57,13,70,0,inf
18532,63,12,75,0,inf
18533,58,6,64,0,inf
18534,50,10,60,0,inf
18535,54,5,59,0,inf
18536,57,11,68,0,inf
18537,57,6,63,0,inf
18538,56,13,69,0,inf
18539,63,12,75,0,inf
18540,64,8,72,0,inf
18541,53,6,59,0,inf
18542,50,6,56,0,inf
18543,59,5,64,0,inf
18544,58,7,65,0,inf
18545,66,12,78,0,inf
18546,62,6,68,0,inf
18547,67,10,77,0,inf
18548,63,5,68,0,inf
18549,50,6,56,0,inf
18550,65,10,75,0,inf
18551,58,6,64,0,inf
18552,63,7,70,0,inf
18553,56,8,64,0,inf
18554,53,5,58,0,inf
18555,56,13,69,0,inf
18556,53,9,62,0,inf
18557,64,11,75,0,inf
18558,65,7,72,0,inf
18559,59,8,67,0,inf
18560,65,12,77,0,inf
18561,57,5,62,0,inf
18562,63,8,71,0,inf
18563,59,10,69,0,inf
18564,58,6,64,0,inf
18565,61,13,74,0,inf
18566,54,9,63,0,inf
18567,54,10,64,0,inf
18568,50,6,56,0,inf
18569,56,13,69,0,inf
18570,57,11,68,0,inf
18571,56,7,63,0,inf
18572,58,13,71,0,inf
18573,60,8,68,0,inf
18574,60,7,67,0,inf
18575,67,12,79,0,inf
18576,51,6,57,0,inf
18577,65,6,71,0,inf
18578,66,10,76,0,inf
18579,55,13,68,0,inf
18580,62,12,74,0,inf
18581,61,10,71,0,inf
18582,56,12,68,0,inf
18583,53,8,61,0,inf
18584,63,6,69,0,inf
18585,53,12,65,0,inf
18586,59,9,68,0,inf
18587,59,13,72,0,inf
18588,57,12,69,0,inf
18589,60,7,67,0,inf
18590,60,5,65,0,inf
18591,57,8,65,0,inf
18592,59,12,71,0,inf
18593,54,6,60,0,inf
18594,67,5,72,0,inf
18595,58,10,68,0,inf
18596,64,7,71,0,inf
18597,61,9,70,0,inf
18598,53,5,58,0,inf
18599,61,5,66,0,inf
18600,57,6,63,0,inf
18601,57,11,68,0,inf
18602,63,12,75,0,inf
18603,67,7,74,0,inf
18604,67,10,77,0,inf
18605,61,12,73,0,inf
18606,58,7,65,0,inf
18607,60,7,67,0,inf
18608,50,10,60,0,inf
18609,55,6,61,0,inf
18610,66,6,72,0,inf
18611,52,7,59,0,inf
18612,61,9,70,0,inf
18613,66,8,74,0,inf
18614,53,13,66,0,inf
18615,64,6,70,0,inf
18616,54,6,60,0,inf
18617,52,6,58,0,inf
18618,55,11,66,0,inf
18619,63,12,75,0,inf
18620,51,11,62,0,inf
18621,62,10,72,0,inf
18622,61,12,73,0,inf
18623,67,11,78,0,inf
18624,58,6,64,0,inf
18625,53,9,62,0,inf
18626,66,11,77,0,inf
18627,62,11,73,0,inf
18628,54,10,64,0,inf
18629,65,11,76,0,inf
18630,62,6,68,0,inf
18631,61,12,73,0,inf
18632,64,5,69,1,4.334025044409145
18633,52,8,60,0,inf
18634,61,13,74,0,inf
18635,59,10,69,0,inf
18636,67,7,74,0,inf
18637,61,10,71,0,inf
18638,51,10,61,0,inf
18639,61,7,68,0,inf
18640,63,6,69,0,inf
18641,50,6,56,0,inf
18642,51,6,57,0,inf
18643,62,7,69,1,4.29356111854716
18644,62,13,75,0,inf
18645,57,12,69,0,inf
18646,56,8,64,0,inf
18647,53,8,61,0,inf
18648,54,9,63,0,inf
18649,61,8,69,0,inf
18650,52,7,59,0,inf
18651,65,5,70,0,inf
18652,57,11,68,0,inf
18653,67,9,76,0,inf
18654,67,13,80,0,inf
18655,51,11,62,0,inf
18656,65,12,77,0,inf
18657,64,10,74,0,inf
18658,59,6,65,0,inf
18659,59,13,72,0,inf
18660,55,8,63,0,inf
18661,56,13,69,0,inf
18662,67,11,78,0,inf
18663,67,11,78,0,inf
18664,52,11,63,0,inf
18665,50,8,58,0,inf
18666,66,6,72,0,inf
18667,65,9,74,0,inf
18668,57,7,64,0,inf
18669,52,13,65,0,inf
18670,52,7,59,0,inf
18671,65,13,78,0,inf
18672,63,11,74,0,inf
18673,57,9,66,0,inf
18674,53,9,62,0,inf
18675,57,6,63,0,inf
18676,51,9,60,0,inf
18677,53,7,60,0,inf
18678,51,8,59,0,inf
18679,52,9,61,0,inf
18680,61,9,70,0,inf
18681,52,6,58,0,inf
18682,52,13,65,0,inf
18683,63,8,71,0,inf
18684,58,9,67,0,inf
18685,50,9,59,1,3.873177193637133
18686,51,13,64,0,inf
18687,60,6,66,0,inf
18688,67,8,75,0,inf
18689,50,12,62,0,inf
18690,63,8,71,0,inf
18691,66,13,79,0,inf
18692,57,12,69,0,inf
18693,58,11,69,0,inf
18694,52,5,57,0,inf
18695,64,7,71,0,inf
18696,57,6,63,0,inf
18697,57,10,67,0,inf
18698,65,10,75,0,inf
18699,66,11,77,0,inf
18700,53,10,63,0,inf
18701,51,5,56,0,inf
18702,57,7,64,0,inf
18703,67,13,80,1,0.7427200499501936
18704,66,5,71,0,inf
18705,50,6,56,0,inf
18706,52,6,58,0,inf
18707,65,9,74,0,inf
18708,59,10,69,0,inf
18709,53,6,59,0,inf
18710,52,9,61,0,inf
18711,62,9,71,0,inf
18712,66,9,75,0,inf
18713,63,12,75,0,inf
18714,65,6,71,0,inf
18715,62,6,68,0,inf
18716,62,8,70,0,inf
18717,59,5,64,0,inf
18718,66,12,78,0,inf
18719,61,9,70,0,inf
18720,67,13,80,0,inf
18721,64,9,73,1,4.126908638806938
18722,56,13,69,1,1.8463272313945112
18723,61,13,74,0,inf
18724,65,13,78,0,inf
18725,65,6,71,0,inf
18726,61,6,67,0,inf
18727,57,8,65,0,inf
18728,59,10,69,0,inf
18729,57,5,62,0,inf
18730,61,9,70,1,1.0941064709439772
18731,50,6,56,0,inf
18732,67,6,73,0,inf
18733,54,6,60,0,inf
18734,50,13,63,0,inf
18735,61,10,71,0,inf
18736,53,11,64,0,inf
18737,63,13,76,0,inf
18738,56,7,63,0,inf
18739,54,12,66,0,inf
18740,58,9,67,1,0.35029354069178
18741,61,6,67,0,inf
18742,51,8,59,0,inf
18743,62,11,73,1,5.113527843223608
18744,56,12,68,0,inf
18745,50,13,63,0,inf
18746,62,7,69,0,inf
18747,65,10,75,0,inf
18748,63,7,70,0,inf
18749,60,10,70,0,inf
18750,61,8,69,0,inf
18751,58,12,70,0,inf
18752,50,13,63,0,inf
18753,59,10,69,0,inf
18754,61,7,68,0,inf
18755,64,9,73,0,inf
18756,51,12,63,0,inf
18757,52,11,63,1,5.056524290525523
18758,67,6,73,1,2.7287691157984284
18759,56,7,63,0,inf
18760,52,9,61,0,inf
18761,60,9,69,0,inf
18762,57,9,66,0,inf
18763,64,13,77,0,inf
18764,66,7,73,0,inf
18765,63,8,71,0,inf
18766,64,9,73,0,inf
18767,50,11,61,0,inf
18768,59,8,67,0,inf
18769,55,5,60,0,inf
18770,64,13,77,0,inf
18771,52,13,65,0,inf
18772,63,11,74,0,inf
18773,52,5,57,0,inf
18774,60,12,72,0,inf
18775,67,7,74,0,inf
18776,65,12,77,0,inf
18777,62,6,68,1,5.029740139514871
18778,67,10,77,0,inf
18779,65,11,76,0,inf
18780,60,8,68,0,inf
18781,63,13,76,0,inf
18782,51,9,60,0,inf
18783,62,6,68,0,inf
18784,58,9,67,0,inf
18785,52,8,60,0,inf
18786,57,5,62,0,inf
18787,51,11,62,0,inf
18788,61,9,70,0,inf
18789,67,12,79,0,inf
18790,63,11,74,0,inf
18791,58,5,63,0,inf
18792,56,11,67,0,inf
18793,61,11,72,0,inf
18794,53,6,59,1,1.3649771593726996
18795,59,7,66,0,inf
18796,62,10,72,1,8.890526339989734
18797,51,6,57,0,inf
18798,64,12,76,0,inf
18799,50,5,55,0,inf
18800,62,11,73,0,inf
18801,64,5,69,0,inf
18802,59,7,66,1,3.3819340051162428
18803,52,5,57,0,inf
18804,65,11,76,0,inf
18805,57,9,66,0,inf
18806,63,12,75,0,inf
18807,67,12,79,1,5.8089266097962735
18808,56,7,63,0,inf
18809,57,12,69,0,inf
18810,56,9,65,0,inf
18811,55,12,67,0,inf
18812,61,9,70,1,1.5876737859901766
18813,52,13,65,0,inf
18814,64,7,71,0,inf
18815,54,6,60,0,inf
18816,64,10,74,0,inf
18817,58,11,69,0,inf
18818,66,13,79,0,inf
18819,58,12,70,0,inf
18820,53,7,60,0,inf
18821,54,8,62,0,inf
18822,65,6,71,0,inf
18823,66,6,72,0,inf
18824,56,11,67,0,inf
18825,62,7,69,0,inf
18826,53,7,60,0,inf
18827,64,9,73,0,inf
18828,60,12,72,0,inf
18829,60,12,72,0,inf
18830,60,7,67,0,inf
18831,56,10,66,0,inf
18832,57,6,63,0,inf
18833,58,6,64,0,inf
18834,52,12,64,0,inf
18835,51,12,63,0,inf
18836,65,7,72,0,inf
18837,65,5,70,0,inf
18838,52,10,62,0,inf
18839,59,11,70,0,inf
18840,54,8,62,0,inf
18841,50,9,59,0,inf
18842,58,13,71,0,inf
18843,61,7,68,0,inf
18844,57,5,62,0,inf
18845,67,11,78,1,7.850261960804133
18846,59,7,66,0,inf
18847,59,8,67,0,inf
18848,58,11,69,0,inf
18849,57,7,64,0,inf
18850,67,11,78,0,inf
18851,52,13,65,0,inf
18852,58,8,66,0,inf
18853,52,13,65,0,inf
18854,58,13,71,0,inf
18855,55,7,62,0,inf
18856,65,12,77,0,inf
18857,58,6,64,0,inf
18858,53,13,66,0,inf
18859,50,9,59,0,inf
18860,51,12,63,0,inf
18861,54,7,61,0,inf
18862,66,10,76,0,inf
18863,50,9,59,0,inf
18864,50,10,60,0,inf
18865,61,10,71,0,inf
18866,60,11,71,0,inf
18867,59,5,64,0,inf
18868,62,8,70,0,inf
18869,64,5,69,0,inf
18870,62,7,69,0,inf
18871,59,8,67,0,inf
18872,58,7,65,0,inf
18873,60,12,72,0,inf
18874,51,11,62,0,inf
18875,52,12,64,0,inf
18876,50,5,55,0,inf
18877,59,13,72,0,inf
18878,52,10,62,1,2.112392069388349
18879,53,8,61,0,inf
18880,65,5,70,0,inf
18881,65,9,74,0,inf
18882,52,10,62,0,inf
18883,51,12,63,0,inf
18884,55,13,68,0,inf
18885,66,8,74,0,inf
18886,65,13,78,0,inf
18887,66,11,77,0,inf
18888,66,12,78,0,inf
18889,53,10,63,0,inf
18890,67,6,73,0,inf
18891,50,13,63,0,inf
18892,55,8,63,0,inf
18893,52,7,59,0,inf
18894,56,9,65,0,inf
18895,62,9,71,0,inf
18896,52,5,57,0,inf
18897,62,11,73,0,inf
18898,51,7,58,0,inf
18899,61,9,70,0,inf
18900,62,7,69,0,inf
18901,54,12,66,0,inf
18902,62,12,74,0,inf
18903,65,9,74,0,inf
18904,65,6,71,0,inf
18905,65,9,74,0,inf
18906,55,6,61,0,inf
18907,51,5,56,0,inf
18908,64,13,77,0,inf
18909,54,5,59,0,inf
18910,54,8,62,0,inf
18911,59,9,68,0,inf
18912,64,5,69,1,0.5900762021633739
18913,59,7,66,0,inf
18914,57,11,68,0,inf
18915,58,10,68,0,inf
18916,53,13,66,0,inf
18917,66,7,73,0,inf
18918,57,11,68,0,inf
18919,53,11,64,0,inf
18920,55,5,60,0,inf
18921,58,12,70,0,inf
18922,50,5,55,0,inf
18923,56,7,63,0,inf
18924,52,11,63,0,inf
18925,67,12,79,0,inf
18926,62,5,67,0,inf
18927,65,5,70,0,inf
18928,56,8,64,0,inf
18929,59,10,69,0,inf
18930,59,13,72,0,inf
18931,50,12,62,0,inf
18932,58,5,63,0,inf
18933,51,13,64,0,inf
18934,58,13,71,0,inf
18935,54,12,66,0,inf
18936,67,8,75,0,inf
18937,62,10,72,0,inf
18938,56,10,66,0,inf
18939,54,13,67,0,inf
18940,56,12,68,0,inf
18941,53,10,63,0,inf
18942,65,9,74,0,inf
18943,62,12,74,0,inf
18944,54,5,59,0,inf
18945,50,6,56,0,inf
18946,62,10,72,0,inf
18947,65,12,77,1,6.712662136233931
18948,57,5,62,0,inf
18949,58,13,71,0,inf
18950,62,6,68,0,inf
18951,60,9,69,0,inf
18952,55,7,62,0,inf
18953,52,7,59,0,inf
18954,61,12,73,0,inf
18955,66,10,76,0,inf
18956,54,13,67,0,inf
18957,61,11,72,0,inf
18958,66,7,73,0,inf
18959,61,13,74,0,inf
18960,63,5,68,0,inf
18961,52,13,65,0,inf
18962,60,11,71,0,inf
18963,50,8,58,0,inf
18964,66,12,78,0,inf
18965,67,10,77,0,inf
18966,52,12,64,0,inf
18967,60,12,72,0,inf
18968,67,10,77,0,inf
18969,51,8,59,1,2.735223535860854
18970,50,9,59,0,inf
18971,62,5,67,0,inf
18972,55,10,65,0,inf
18973,60,5,65,0,inf
18974,59,13,72,1,12.296542837724374
18975,58,9,67,0,inf
18976,61,5,66,0,inf
18977,56,11,67,0,inf
18978,56,11,67,0,inf
18979,57,11,68,0,inf
18980,57,5,62,0,inf
18981,61,9,70,0,inf
18982,66,10,76,1,4.249756103804486
18983,50,10,60,0,inf
18984,53,10,63,0,inf
18985,64,10,74,0,inf
18986,51,12,63,0,inf
18987,52,6,58,0,inf
18988,60,10,70,0,inf
18989,53,11,64,0,inf
18990,61,6,67,0,inf
18991,60,6,66,0,inf
18992,57,13,70,0,inf
18993,64,12,76,0,inf
18994,54,10,64,0,inf
18995,57,8,65,0,inf
18996,55,11,66,0,inf
18997,50,11,61,0,inf
18998,56,8,64,0,inf
18999,57,10,67,0,inf
19000,66,13,79,0,inf
19001,51,10,61,0,inf
19002,66,9,75,0,inf
19003,52,5,57,0,inf
19004,52,8,60,0,inf
19005,58,11,69,0,inf
19006,55,13,68,0,inf
19007,56,11,67,0,inf
19008,55,11,66,0,inf
19009,62,7,69,0,inf
19010,63,10,73,0,inf
19011,60,5,65,0,inf
19012,53,9,62,0,inf
19013,66,13,79,0,inf
19014,51,13,64,0,inf
19015,64,8,72,0,inf
19016,53,9,62,0,inf
19017,67,13,80,0,inf
19018,55,7,62,0,inf
19019,63,5,68,0,inf
19020,65,6,71,0,inf
19021,62,8,70,0,inf
19022,63,13,76,1,2.082365782477055
19023,50,9,59,0,inf
19024,54,6,60,0,inf
19025,64,9,73,0,inf
19026,56,7,63,0,inf
19027,59,12,71,0,inf
19028,55,7,62,0,inf
19029,57,7,64,0,inf
19030,65,11,76,0,inf
19031,61,5,66,0,inf
19032,53,6,59,0,inf
19033,50,6,56,0,inf
19034,66,5,71,0,inf
19035,66,8,74,0,inf
19036,58,7,65,0,inf
19037,62,5,67,0,inf
19038,64,9,73,0,inf
19039,61,8,69,0,inf
19040,53,12,65,0,inf
19041,59,10,69,0,inf
19042,61,13,74,0,inf
19043,62,6,68,0,inf
19044,51,10,61,0,inf
19045,65,13,78,1,0.40422128342692076
19046,52,13,65,0,inf
19047,52,9,61,0,inf
19048,60,5,65,0,inf
19049,56,5,61,0,inf
19050,55,8,63,0,inf
19051,64,13,77,0,inf
19052,50,13,63,1,11.26802529047118
19053,62,5,67,0,inf
19054,58,6,64,0,inf
19055,52,11,63,0,inf
19056,63,11,74,0,inf
19057,63,7,70,0,inf
19058,67,5,72,0,inf
19059,58,5,63,0,inf
19060,51,9,60,0,inf
19061,50,8,58,0,inf
19062,56,8,64,0,inf
19063,62,7,69,0,inf
19064,54,13,67,0,inf
19065,60,9,69,1,6.9573658308213595
19066,66,8,74,0,inf
19067,63,8,71,0,inf
19068,63,6,69,0,inf
19069,52,7,59,0,inf
19070,55,6,61,0,inf
19071,54,7,61,0,inf
19072,55,6,61,0,inf
19073,63,5,68,0,inf
19074,66,5,71,0,inf
19075,57,11,68,0,inf
19076,57,9,66,0,inf
19077,66,12,78,0,inf
19078,61,8,69,0,inf
19079,57,9,66,0,inf
19080,51,9,60,0,inf
19081,54,13,67,0,inf
19082,53,10,63,0,inf
19083,62,11,73,0,inf
19084,64,11,75,0,inf
19085,50,12,62,0,inf
19086,55,12,67,0,inf
19087,60,13,73,0,inf
19088,52,9,61,0,inf
19089,65,11,76,0,inf
19090,53,11,64,0,inf
19091,56,12,68,0,inf
19092,57,10,67,0,inf
19093,50,5,55,0,inf
19094,62,9,71,0,inf
19095,60,10,70,0,inf
19096,59,12,71,0,inf
19097,53,7,60,0,inf
19098,63,8,71,0,inf
19099,66,11,77,0,inf
19100,67,9,76,1,0.5887316622725649
19101,50,13,63,0,inf
19102,55,5,60,0,inf
19103,57,5,62,0,inf
19104,56,9,65,0,inf
19105,58,9,67,0,inf
19106,55,6,61,0,inf
19107,58,7,65,1,6.799532159526336
19108,54,7,61,0,inf
19109,59,6,65,0,inf
19110,56,13,69,0,inf
19111,63,6,69,0,inf
19112,51,7,58,0,inf
19113,58,8,66,0,inf
19114,57,7,64,1,5.239956910153751
19115,55,10,65,0,inf
19116,65,5,70,0,inf
19117,61,10,71,0,inf
19118,57,11,68,0,inf
19119,54,11,65,0,inf
19120,51,8,59,0,inf
19121,51,6,57,0,inf
19122,62,10,72,0,inf
19123,53,11,64,0,inf
19124,52,8,60,0,inf
19125,64,5,69,0,inf
19126,54,11,65,0,inf
19127,52,8,60,0,inf
19128,59,10,69,0,inf
19129,62,6,68,0,inf
19130,61,5,66,0,inf
19131,52,12,64,0,inf
19132,53,6,59,0,inf
19133,58,7,65,0,inf
19134,61,6,67,0,inf
19135,54,5,59,0,inf
19136,50,5,55,0,inf
19137,63,8,71,0,inf
19138,52,9,61,0,inf
19139,64,8,72,0,inf
19140,60,5,65,0,inf
19141,64,12,76,0,inf
19142,50,13,63,0,inf
19143,50,6,56,0,inf
19144,61,9,70,0,inf
19145,67,6,73,0,inf
19146,53,11,64,0,inf
19147,50,13,63,0,inf
19148,55,9,64,0,inf
19149,61,9,70,0,inf
19150,58,13,71,0,inf
19151,58,10,68,0,inf
19152,52,13,65,0,inf
19153,54,12,66,0,inf
19154,61,10,71,0,inf
19155,64,5,69,0,inf
19156,52,5,57,0,inf
19157,52,11,63,0,inf
19158,59,12,71,0,inf
19159,52,9,61,0,inf
19160,67,5,72,0,inf
19161,56,8,64,1,3.387107217819114
19162,65,6,71,0,inf
19163,62,11,73,0,inf
19164,59,6,65,0,inf
19165,55,12,67,0,inf
19166,51,12,63,0,inf
19167,66,5,71,0,inf
19168,61,13,74,0,inf
19169,64,10,74,0,inf
19170,65,5,70,0,inf
19171,50,11,61,0,inf
19172,66,7,73,0,inf
19173,58,11,69,0,inf
19174,50,12,62,0,inf
19175,64,11,75,0,inf
19176,50,10,60,0,inf
19177,64,11,75,0,inf
19178,54,13,67,0,inf
19179,51,6,57,0,inf
19180,51,10,61,0,inf
19181,65,6,71,0,inf
19182,55,13,68,0,inf
19183,55,7,62,0,inf
19184,53,12,65,0,inf
19185,64,11,75,0,inf
19186,59,8,67,0,inf
19187,54,8,62,0,inf
19188,63,5,68,0,inf
19189,54,11,65,1,5.118095744278627
19190,60,9,69,0,inf
19191,55,12,67,0,inf
19192,53,12,65,0,inf
19193,58,11,69,0,inf
19194,58,5,63,0,inf
19195,59,11,70,0,inf
19196,66,5,71,0,inf
19197,51,11,62,0,inf
19198,58,9,67,0,inf
19199,60,12,72,1,6.1609904891269025
19200,58,8,66,0,inf
19201,59,13,72,0,inf
19202,51,6,57,0,inf
19203,50,6,56,0,inf
19204,60,12,72,0,inf
19205,67,7,74,0,inf
19206,52,8,60,0,inf
19207,61,12,73,0,inf
19208,61,8,69,0,inf
19209,55,12,67,0,inf
19210,52,6,58,0,inf
19211,53,13,66,0,inf
19212,62,7,69,0,inf
19213,65,5,70,0,inf
19214,67,11,78,0,inf
19215,55,6,61,0,inf
19216,64,11,75,0,inf
19217,63,5,68,0,inf
19218,51,5,56,0,inf
19219,53,11,64,0,inf
19220,55,8,63,0,inf
19221,58,12,70,0,inf
19222,66,10,76,0,inf
19223,50,5,55,0,inf
19224,64,10,74,0,inf
19225,60,10,70,0,inf
19226,64,7,71,0,inf
19227,60,8,68,0,inf
19228,56,8,64,0,inf
19229,67,6,73,0,inf
19230,59,5,64,0,inf
19231,57,5,62,0,inf
19232,51,11,62,0,inf
19233,59,11,70,0,inf
19234,59,5,64,0,inf
19235,67,5,72,0,inf
19236,60,11,71,0,inf
19237,60,11,71,0,inf
19238,59,7,66,0,inf
19239,50,11,61,0,inf
19240,64,9,73,0,inf
19241,58,13,71,0,inf
19242,50,5,55,0,inf
19243,62,5,67,0,inf
19244,51,6,57,0,inf
19245,55,12,67,1,0.5217497049525761
19246,53,5,58,0,inf
19247,67,7,74,0,inf
19248,54,13,67,0,inf
19249,56,12,68,0,inf
19250,56,11,67,0,inf
19251,50,10,60,0,inf
19252,50,12,62,0,inf
19253,51,13,64,0,inf
19254,64,9,73,0,inf
19255,57,6,63,0,inf
19256,51,8,59,0,inf
19257,64,6,70,0,inf
19258,61,6,67,0,inf
19259,66,13,79,0,inf
19260,63,7,70,1,0.04105428579775605
19261,66,13,79,0,inf
19262,56,6,62,0,inf
19263,54,13,67,0,inf
19264,56,13,69,0,inf
19265,66,8,74,1,2.793169321484257
19266,55,5,60,0,inf
19267,57,11,68,0,inf
19268,67,9,76,0,inf
19269,54,6,60,0,inf
19270,64,6,70,0,inf
19271,56,8,64,0,inf
19272,65,13,78,0,inf
19273,54,7,61,0,inf
19274,66,13,79,0,inf
19275,64,7,71,0,inf
19276,54,8,62,0,inf
19277,54,12,66,0,inf
19278,64,13,77,0,inf
19279,63,12,75,0,inf
19280,54,6,60,0,inf
19281,64,10,74,0,inf
19282,54,10,64,1,2.181124291053237
19283,66,12,78,1,3.6855034162362728
19284,51,7,58,0,inf
19285,60,6,66,0,inf
19286,52,13,65,0,inf
19287,61,13,74,0,inf
19288,58,7,65,0,inf
19289,64,9,73,0,inf
19290,54,6,60,0,inf
19291,66,8,74,0,inf
19292,62,5,67,0,inf
19293,66,12,78,0,inf
19294,62,12,74,0,inf
19295,59,7,66,0,inf
19296,62,9,71,0,inf
19297,59,12,71,0,inf
19298,63,5,68,0,inf
19299,58,8,66,0,inf
19300,50,10,60,0,inf
19301,66,11,77,0,inf
19302,53,9,62,1,4.852696637282591
19303,67,11,78,0,inf
19304,60,5,65,0,inf
19305,66,10,76,0,inf
19306,61,6,67,0,inf
19307,59,9,68,0,inf
19308,60,12,72,0,inf
19309,55,8,63,0,inf
19310,63,9,72,0,inf
19311,61,8,69,0,inf
19312,61,10,71,0,inf
19313,54,7,61,0,inf
19314,64,10,74,0,inf
19315,60,11,71,0,inf
19316,62,9,71,1,5.522134148370469
19317,63,13,76,0,inf
19318,64,9,73,0,inf
19319,60,6,66,0,inf
19320,50,9,59,0,inf
19321,64,5,69,0,inf
19322,51,6,57,0,inf
19323,58,11,69,0,inf
19324,52,12,64,0,inf
19325,57,5,62,0,inf
19326,52,11,63,0,inf
19327,61,13,74,0,inf
19328,61,8,69,0,inf
19329,57,5,62,0,inf
19330,54,7,61,0,inf
19331,62,12,74,0,inf
19332,52,9,61,0,inf
19333,60,11,71,0,inf
19334,61,7,68,0,inf
19335,66,10,76,0,inf
19336,56,12,68,0,inf
19337,62,9,71,0,inf
19338,67,7,74,0,inf
19339,60,5,65,0,inf
19340,58,7,65,0,inf
19341,60,7,67,0,inf
19342,52,10,62,0,inf
19343,57,13,70,0,inf
19344,61,8,69,0,inf
19345,51,9,60,0,inf
19346,62,11,73,0,inf
19347,51,6,57,0,inf
19348,59,6,65,0,inf
19349,56,12,68,0,inf
19350,64,13,77,1,7.173239990215777
19351,53,5,58,0,inf
19352,61,11,72,0,inf
19353,55,11,66,0,inf
19354,65,6,71,0,inf
19355,60,10,70,0,inf
19356,56,9,65,0,inf
19357,66,10,76,0,inf
19358,61,13,74,0,inf
19359,60,9,69,0,inf
19360,50,13,63,0,inf
19361,56,11,67,0,inf
19362,64,12,76,0,inf
19363,64,9,73,0,inf
19364,67,5,72,0,inf
19365,62,9,71,0,inf
19366,60,11,71,0,inf
19367,56,5,61,0,inf
19368,56,5,61,0,inf
19369,54,5,59,0,inf
19370,67,10,77,0,inf
19371,62,12,74,0,inf
19372,53,8,61,0,inf
19373,60,5,65,0,inf
19374,55,5,60,0,inf
19375,65,13,78,0,inf
19376,61,8,69,0,inf
19377,56,11,67,0,inf
19378,55,11,66,0,inf
19379,52,8,60,0,inf
19380,60,9,69,0,inf
19381,57,7,64,0,inf
19382,67,10,77,0,inf
19383,63,5,68,0,inf
19384,56,8,64,0,inf
19385,59,6,65,0,inf
19386,61,12,73,0,inf
19387,57,12,69,0,inf
19388,58,8,66,0,inf
19389,55,8,63,0,inf
19390,65,13,78,0,inf
19391,64,6,70,0,inf
19392,66,7,73,0,inf
19393,59,6,65,0,inf
19394,66,7,73,0,inf
19395,66,12,78,0,inf
19396,56,8,64,0,inf
19397,56,7,63,0,inf
19398,56,10,66,0,inf
19399,57,13,70,0,inf
19400,67,11,78,0,inf
19401,51,7,58,0,inf
19402,50,6,56,0,inf
19403,53,9,62,0,inf
19404,55,12,67,0,inf
19405,62,8,70,0,inf
19406,66,12,78,0,inf
19407,67,12,79,0,inf
19408,59,5,64,0,inf
19409,52,10,62,0,inf
19410,54,8,62,0,inf
19411,60,12,72,0,inf
19412,62,5,67,0,inf
19413,62,8,70,0,inf
19414,61,8,69,0,inf
19415,56,5,61,0,inf
19416,67,11,78,0,inf
19417,61,6,67,0,inf
19418,67,9,76,0,inf
19419,62,5,67,0,inf
19420,67,7,74,0,inf
19421,53,10,63,0,inf
19422,66,10,76,0,inf
19423,65,6,71,0,inf
19424,51,12,63,0,inf
19425,65,8,73,0,inf
19426,64,6,70,0,inf
19427,67,13,80,0,inf
19428,53,10,63,0,inf
19429,65,6,71,0,inf
19430,62,9,71,0,inf
19431,61,5,66,0,inf
19432,55,6,61,0,inf
19433,54,7,61,0,inf
19434,62,8,70,0,inf
19435,66,9,75,0,inf
19436,58,6,64,0,inf
19437,58,11,69,0,inf
19438,52,6,58,0,inf
19439,58,5,63,0,inf
19440,62,5,67,0,inf
19441,53,7,60,0,inf
19442,54,7,61,0,inf
19443,55,10,65,0,inf
19444,52,5,57,0,inf
19445,57,11,68,0,inf
19446,63,11,74,0,inf
19447,50,5,55,0,inf
19448,58,6,64,0,inf
19449,63,13,76,0,inf
19450,55,6,61,0,inf
19451,58,13,71,0,inf
19452,63,7,70,0,inf
19453,62,5,67,0,inf
19454,52,10,62,0,inf
19455,54,13,67,0,inf
19456,65,8,73,0,inf
19457,56,7,63,0,inf
19458,62,8,70,0,inf
19459,63,11,74,0,inf
19460,53,8,61,0,inf
19461,61,13,74,0,inf
19462,52,7,59,0,inf
19463,66,13,79,0,inf
19464,54,12,66,0,inf
19465,54,11,65,1,9.943069160509644
19466,66,5,71,0,inf
19467,65,6,71,0,inf
19468,66,9,75,0,inf
19469,67,5,72,0,inf
19470,50,6,56,0,inf
19471,53,8,61,0,inf
19472,53,7,60,0,inf
19473,58,13,71,0,inf
19474,53,13,66,0,inf
19475,53,9,62,0,inf
19476,58,13,71,1,1.2475815528405008
19477,62,11,73,0,inf
19478,67,6,73,0,inf
19479,66,13,79,0,inf
19480,56,13,69,0,inf
19481,59,7,66,0,inf
19482,66,12,78,0,inf
19483,53,11,64,0,inf
19484,65,7,72,1,3.4022335976979434
19485,60,7,67,0,inf
19486,52,12,64,0,inf
19487,51,6,57,0,inf
19488,53,9,62,0,inf
19489,56,13,69,0,inf
19490,65,9,74,0,inf
19491,66,9,75,1,4.601490580604732
19492,56,12,68,0,inf
19493,61,9,70,0,inf
19494,54,11,65,0,inf
19495,60,11,71,0,inf
19496,60,10,70,0,inf
19497,60,10,70,0,inf
19498,53,9,62,0,inf
19499,67,5,72,0,inf
19500,62,5,67,0,inf
19501,52,8,60,0,inf
19502,56,5,61,0,inf
19503,63,10,73,0,inf
19504,65,7,72,0,inf
19505,56,11,67,0,inf
19506,61,7,68,0,inf
19507,59,5,64,0,inf
19508,57,9,66,0,inf
19509,55,13,68,1,6.061307034833284
19510,60,7,67,0,inf
19511,60,5,65,0,inf
19512,63,5,68,0,inf
19513,59,5,64,0,inf
19514,64,7,71,0,inf
19515,53,13,66,0,inf
19516,54,5,59,0,inf
19517,53,6,59,0,inf
19518,54,9,63,0,inf
19519,50,11,61,0,inf
19520,63,7,70,0,inf
19521,66,5,71,0,inf
19522,66,7,73,0,inf
19523,65,12,77,0,inf
19524,53,11,64,0,inf
19525,65,7,72,0,inf
19526,67,8,75,0,inf
19527,56,11,67,0,inf
19528,52,7,59,0,inf
19529,50,5,55,0,inf
19530,64,5,69,0,inf
19531,65,8,73,0,inf
19532,59,10,69,0,inf
19533,58,7,65,0,inf
19534,53,12,65,0,inf
19535,57,5,62,0,inf
19536,67,12,79,0,inf
19537,59,13,72,0,inf
19538,62,10,72,0,inf
19539,64,11,75,0,inf
19540,65,8,73,0,inf
19541,64,12,76,0,inf
19542,55,5,60,0,inf
19543,64,12,76,0,inf
19544,57,12,69,0,inf
19545,62,5,67,0,inf
19546,51,9,60,0,inf
19547,56,8,64,0,inf
19548,58,5,63,0,inf
19549,64,13,77,0,inf
19550,52,10,62,0,inf
19551,64,8,72,0,inf
19552,56,10,66,0,inf
19553,59,6,65,0,inf
19554,62,9,71,0,inf
19555,52,13,65,0,inf
19556,57,6,63,0,inf
19557,51,5,56,0,inf
19558,50,7,57,0,inf
19559,56,7,63,0,inf
19560,57,8,65,0,inf
19561,65,8,73,0,inf
19562,59,7,66,0,inf
19563,67,10,77,0,inf
19564,55,8,63,0,inf
19565,61,10,71,0,inf
19566,61,6,67,0,inf
19567,50,6,56,0,inf
19568,63,6,69,0,inf
19569,52,12,64,0,inf
19570,64,10,74,0,inf
19571,65,5,70,0,inf
19572,63,11,74,0,inf
19573,60,9,69,0,inf
19574,54,12,66,0,inf
19575,67,10,77,0,inf
19576,62,13,75,0,inf
19577,61,8,69,0,inf
19578,62,7,69,0,inf
19579,65,5,70,0,inf
19580,51,7,58,0,inf
19581,65,5,70,0,inf
19582,59,7,66,0,inf
19583,59,13,72,0,inf
19584,51,8,59,0,inf
19585,53,13,66,0,inf
19586,54,7,61,0,inf
19587,52,13,65,0,inf
19588,66,11,77,0,inf
19589,59,5,64,0,inf
19590,63,10,73,0,inf
19591,54,13,67,0,inf
19592,57,13,70,0,inf
19593,60,13,73,0,inf
19594,56,9,65,0,inf
19595,66,8,74,0,inf
19596,55,9,64,0,inf
19597,52,5,57,0,inf
19598,66,12,78,0,inf
19599,62,8,70,0,inf
19600,67,13,80,0,inf
19601,52,9,61,0,inf
19602,62,8,70,0,inf
19603,61,7,68,0,inf
19604,65,9,74,0,inf
19605,58,11,69,0,inf
19606,67,13,80,0,inf
19607,52,8,60,0,inf
19608,67,12,79,0,inf
19609,52,6,58,0,inf
19610,67,8,75,0,inf
19611,67,5,72,0,inf
19612,52,11,63,0,inf
19613,63,7,70,0,inf
19614,64,10,74,0,inf
19615,66,7,73,0,inf
19616,58,7,65,0,inf
19617,58,5,63,0,inf
19618,55,5,60,0,inf
19619,58,8,66,0,inf
19620,58,9,67,0,inf
19621,50,12,62,0,inf
19622,53,5,58,0,inf
19623,53,9,62,0,inf
19624,54,9,63,0,inf
19625,51,7,58,0,inf
19626,57,10,67,0,inf
19627,52,8,60,0,inf
19628,50,6,56,0,inf
19629,63,9,72,0,inf
19630,55,8,63,0,inf
19631,59,6,65,0,inf
19632,55,7,62,0,inf
19633,58,5,63,0,inf
19634,66,5,71,0,inf
19635,63,11,74,0,inf
19636,54,7,61,0,inf
19637,56,6,62,0,inf
19638,57,6,63,0,inf
19639,52,6,58,0,inf
19640,65,5,70,0,inf
19641,56,6,62,0,inf
19642,59,6,65,0,inf
19643,58,6,64,0,inf
19644,64,7,71,0,inf
19645,55,8,63,0,inf
19646,61,10,71,0,inf
19647,63,6,69,0,inf
19648,53,10,63,0,inf
19649,67,9,76,0,inf
19650,56,9,65,0,inf
19651,63,11,74,0,inf
19652,58,12,70,0,inf
19653,65,9,74,0,inf
19654,58,6,64,0,inf
19655,52,6,58,0,inf
19656,66,9,75,0,inf
19657,65,12,77,0,inf
19658,57,7,64,0,inf
19659,59,8,67,0,inf
19660,60,10,70,0,inf
19661,51,9,60,0,inf
19662,59,6,65,0,inf
19663,59,9,68,0,inf
19664,66,9,75,0,inf
19665,57,11,68,0,inf
19666,59,5,64,0,inf
19667,54,6,60,0,inf
19668,51,9,60,0,inf
19669,62,10,72,0,inf
19670,61,12,73,1,7.312273468760935
19671,54,11,65,0,inf
19672,52,12,64,0,inf
19673,61,11,72,1,8.013258106514058
19674,58,10,68,0,inf
19675,60,5,65,0,inf
19676,50,10,60,0,inf
19677,54,6,60,0,inf
19678,58,10,68,0,inf
19679,50,6,56,0,inf
19680,62,10,72,0,inf
19681,66,13,79,0,inf
19682,56,8,64,0,inf
19683,59,6,65,0,inf
19684,63,12,75,0,inf
19685,52,13,65,0,inf
19686,62,9,71,0,inf
19687,52,5,57,0,inf
19688,60,12,72,0,inf
19689,65,7,72,0,inf
19690,62,10,72,0,inf
19691,53,9,62,0,inf
19692,56,5,61,0,inf
19693,54,7,61,0,inf
19694,59,9,68,0,inf
19695,63,8,71,0,inf
19696,63,13,76,0,inf
19697,58,6,64,0,inf
19698,67,12,79,0,inf
19699,53,11,64,0,inf
19700,56,11,67,0,inf
19701,51,7,58,0,inf
19702,60,5,65,0,inf
19703,56,9,65,0,inf
19704,62,8,70,0,inf
19705,52,5,57,0,inf
19706,62,8,70,0,inf
19707,51,11,62,0,inf
19708,66,9,75,0,inf
19709,58,9,67,0,inf
19710,65,9,74,0,inf
19711,55,6,61,0,inf
19712,62,12,74,0,inf
19713,64,8,72,0,inf
19714,57,13,70,0,inf
19715,54,11,65,0,inf
19716,54,10,64,0,inf
19717,67,13,80,0,inf
19718,55,5,60,0,inf
19719,50,9,59,0,inf
19720,52,12,64,0,inf
19721,57,11,68,0,inf
19722,57,6,63,0,inf
19723,59,11,70,0,inf
19724,50,12,62,0,inf
19725,65,12,77,0,inf
19726,66,12,78,0,inf
19727,58,7,65,0,inf
19728,56,8,64,0,inf
19729,62,9,71,0,inf
19730,62,6,68,0,inf
19731,50,6,56,0,inf
19732,50,6,56,0,inf
19733,66,9,75,0,inf
19734,50,10,60,0,inf
19735,56,11,67,0,inf
19736,61,12,73,0,inf
19737,65,13,78,0,inf
19738,58,11,69,0,inf
19739,52,5,57,0,inf
19740,63,11,74,0,inf
19741,65,12,77,0,inf
19742,67,13,80,0,inf
19743,55,8,63,0,inf
19744,61,13,74,1,3.032827178643757
19745,55,9,64,0,inf
19746,62,12,74,0,inf
19747,61,5,66,0,inf
19748,62,7,69,0,inf
19749,51,6,57,0,inf
19750,61,12,73,0,inf
19751,56,12,68,0,inf
19752,54,7,61,0,inf
19753,57,7,64,0,inf
19754,55,9,64,0,inf
19755,51,11,62,0,inf
19756,66,8,74,0,inf
19757,65,12,77,0,inf
19758,62,7,69,0,inf
19759,61,11,72,0,inf
19760,63,10,73,0,inf
19761,60,11,71,0,inf
19762,57,5,62,0,inf
19763,64,8,72,0,inf
19764,50,11,61,0,inf
19765,52,13,65,0,inf
19766,52,6,58,0,inf
19767,60,6,66,0,inf
19768,52,10,62,0,inf
19769,52,6,58,0,inf
19770,66,7,73,0,inf
19771,61,5,66,0,inf
19772,57,9,66,0,inf
19773,65,12,77,0,inf
19774,65,10,75,1,2.4386109049977307
19775,55,8,63,0,inf
19776,53,9,62,0,inf
19777,62,6,68,0,inf
19778,56,12,68,0,inf
19779,56,6,62,0,inf
19780,66,6,72,0,inf
19781,67,13,80,0,inf
19782,66,6,72,0,inf
19783,56,6,62,1,3.6258309365741184
19784,52,12,64,0,inf
19785,61,13,74,0,inf
19786,67,5,72,0,inf
19787,66,11,77,0,inf
19788,52,12,64,0,inf
19789,65,12,77,0,inf
19790,52,13,65,0,inf
19791,52,8,60,0,inf
19792,56,5,61,0,inf
19793,57,13,70,0,inf
19794,57,9,66,0,inf
19795,55,13,68,0,inf
19796,52,13,65,0,inf
19797,56,11,67,0,inf
19798,66,7,73,0,inf
19799,55,8,63,0,inf
19800,55,9,64,0,inf
19801,60,10,70,1,8.918899982274382
19802,67,5,72,0,inf
19803,59,9,68,0,inf
19804,52,7,59,0,inf
19805,51,8,59,0,inf
19806,66,9,75,0,inf
19807,56,11,67,0,inf
19808,65,12,77,0,inf
19809,50,13,63,0,inf
19810,62,6,68,0,inf
19811,64,12,76,0,inf
19812,60,9,69,0,inf
19813,61,11,72,1,1.9852843613821989
19814,56,10,66,0,inf
19815,66,6,72,0,inf
19816,65,5,70,0,inf
19817,56,6,62,0,inf
19818,56,10,66,0,inf
19819,58,5,63,0,inf
19820,66,11,77,0,inf
19821,52,8,60,0,inf
19822,67,11,78,0,inf
19823,63,7,70,0,inf
19824,60,10,70,0,inf
19825,56,8,64,0,inf
19826,57,12,69,0,inf
19827,59,11,70,0,inf
19828,56,6,62,0,inf
19829,54,10,64,0,inf
19830,66,8,74,0,inf
19831,62,9,71,0,inf
19832,61,7,68,0,inf
19833,55,6,61,0,inf
19834,59,10,69,0,inf
19835,50,13,63,0,inf
19836,52,7,59,0,inf
19837,59,7,66,0,inf
19838,60,12,72,0,inf
19839,51,7,58,0,inf
19840,56,13,69,0,inf
19841,55,8,63,0,inf
19842,51,8,59,0,inf
19843,54,11,65,0,inf
19844,50,10,60,0,inf
19845,51,12,63,0,inf
19846,50,9,59,0,inf
19847,62,5,67,0,inf
19848,53,5,58,0,inf
19849,50,8,58,0,inf
19850,55,6,61,0,inf
19851,64,8,72,0,inf
19852,55,6,61,0,inf
19853,63,11,74,0,inf
19854,59,8,67,0,inf
19855,56,10,66,0,inf
19856,66,9,75,0,inf
19857,56,12,68,0,inf
19858,56,5,61,0,inf
19859,62,5,67,0,inf
19860,55,12,67,0,inf
19861,50,12,62,0,inf
19862,62,13,75,0,inf
19863,57,8,65,0,inf
19864,63,9,72,0,inf
19865,51,12,63,0,inf
19866,59,8,67,0,inf
19867,64,9,73,0,inf
19868,64,8,72,0,inf
19869,66,9,75,0,inf
19870,51,6,57,0,inf
19871,62,9,71,0,inf
19872,60,11,71,0,inf
19873,65,12,77,0,inf
19874,51,5,56,0,inf
19875,56,10,66,0,inf
19876,60,8,68,0,inf
19877,54,7,61,0,inf
19878,57,8,65,0,inf
19879,54,13,67,0,inf
19880,64,6,70,0,inf
19881,56,5,61,0,inf
19882,52,6,58,0,inf
19883,57,7,64,0,inf
19884,58,9,67,0,inf
19885,67,12,79,0,inf
19886,51,13,64,0,inf
19887,65,5,70,0,inf
19888,62,9,71,0,inf
19889,66,9,75,0,inf
19890,57,11,68,0,inf
19891,66,11,77,0,inf
19892,63,6,69,0,inf
19893,59,8,67,0,inf
19894,51,12,63,0,inf
19895,59,6,65,0,inf
19896,57,11,68,0,inf
19897,64,11,75,0,inf
19898,64,7,71,0,inf
19899,64,6,70,0,inf
19900,64,10,74,0,inf
19901,57,6,63,0,inf
19902,63,10,73,0,inf
19903,54,10,64,0,inf
19904,58,9,67,0,inf
19905,61,12,73,0,inf
19906,52,9,61,0,inf
19907,53,5,58,0,inf
19908,55,9,64,0,inf
19909,52,10,62,0,inf
19910,54,6,60,0,inf
19911,58,13,71,0,inf
19912,56,12,68,0,inf
19913,62,11,73,0,inf
19914,58,5,63,0,inf
19915,66,8,74,0,inf
19916,58,5,63,0,inf
19917,53,9,62,0,inf
19918,52,9,61,1,1.3390772915838696
19919,56,5,61,0,inf
19920,67,7,74,0,inf
19921,67,12,79,0,inf
19922,54,8,62,0,inf
19923,50,8,58,0,inf
19924,64,8,72,0,inf
19925,53,10,63,0,inf
19926,67,7,74,0,inf
19927,64,11,75,0,inf
19928,57,10,67,0,inf
19929,66,13,79,0,inf
19930,51,11,62,1,6.462287437622102
19931,63,10,73,0,inf
19932,59,11,70,0,inf
19933,52,9,61,0,inf
19934,60,7,67,0,inf
19935,65,13,78,0,inf
19936,55,9,64,0,inf
19937,51,12,63,0,inf
19938,62,12,74,0,inf
19939,50,9,59,0,inf
19940,57,6,63,0,inf
19941,66,12,78,0,inf
19942,64,10,74,0,inf
19943,66,9,75,0,inf
19944,59,12,71,0,inf
19945,50,9,59,0,inf
19946,54,6,60,0,inf
19947,52,13,65,0,inf
19948,52,8,60,0,inf
19949,52,7,59,0,inf
19950,52,12,64,0,inf
19951,53,10,63,0,inf
19952,62,6,68,0,inf
19953,54,8,62,0,inf
19954,64,9,73,0,inf
19955,53,7,60,0,inf
19956,53,9,62,0,inf
19957,63,10,73,0,inf
19958,62,11,73,0,inf
19959,64,5,69,0,inf
19960,64,7,71,0,inf
19961,53,11,64,0,inf
19962,51,6,57,0,inf
19963,56,5,61,0,inf
19964,65,7,72,0,inf
19965,62,8,70,0,inf
19966,62,11,73,0,inf
19967,66,6,72,0,inf
19968,54,7,61,0,inf
19969,64,11,75,0,inf
19970,52,12,64,0,inf
19971,60,6,66,0,inf
19972,64,7,71,0,inf
19973,61,9,70,0,inf
19974,64,5,69,0,inf
19975,66,6,72,0,inf
19976,63,7,70,0,inf
19977,55,7,62,0,inf
19978,61,12,73,0,inf
19979,55,13,68,0,inf
19980,51,11,62,0,inf
19981,62,7,69,0,inf
19982,66,10,76,0,inf
19983,53,6,59,0,inf
19984,62,8,70,0,inf
19985,50,7,57,0,inf
19986,61,5,66,1,3.931515846098506
19987,59,6,65,0,inf
19988,53,9,62,0,inf
19989,63,8,71,0,inf
19990,64,13,77,0,inf
19991,54,10,64,0,inf
19992,60,13,73,0,inf
19993,52,7,59,0,inf
19994,54,12,66,0,inf
19995,61,11,72,0,inf
19996,57,12,69,0,inf
19997,67,6,73,0,inf
19998,56,12,68,1,7.108343558670171
19999,56,6,62,1,5.357619588268655
20000,62,5,67,0,inf
20001,58,5,63,0,inf
20002,52,11,63,0,inf
20003,65,8,73,0,inf
20004,66,13,79,0,inf
20005,57,8,65,0,inf
20006,52,9,61,0,inf
20007,56,13,69,0,inf
20008,58,9,67,0,inf
20009,64,11,75,0,inf
20010,64,7,71,0,inf
20011,62,10,72,0,inf
20012,58,7,65,0,inf
20013,53,5,58,0,inf
20014,60,10,70,0,inf
20015,54,6,60,0,inf
20016,53,7,60,0,inf
20017,67,6,73,0,inf
20018,65,12,77,0,inf
20019,67,12,79,0,inf
20020,50,7,57,0,inf
20021,54,6,60,0,inf
20022,54,9,63,0,inf
20023,59,11,70,0,inf
20024,67,7,74,0,inf
20025,56,11,67,0,inf
20026,50,13,63,0,inf
20027,54,9,63,0,inf
20028,62,7,69,0,inf
20029,62,13,75,0,inf
20030,58,8,66,0,inf
20031,64,8,72,0,inf
20032,54,8,62,0,inf
20033,62,8,70,0,inf
20034,61,6,67,1,2.340006302646657
20035,59,9,68,0,inf
20036,55,6,61,0,inf
20037,57,7,64,0,inf
20038,57,6,63,0,inf
20039,65,13,78,1,3.048767920603794
20040,60,10,70,0,inf
20041,64,11,75,0,inf
20042,54,5,59,0,inf
20043,54,13,67,0,inf
20044,53,13,66,1,5.087606705870044
20045,61,6,67,0,inf
20046,61,12,73,0,inf
20047,57,6,63,0,inf
20048,56,6,62,0,inf
20049,54,12,66,0,inf
20050,56,8,64,0,inf
20051,58,10,68,0,inf
20052,61,5,66,0,inf
20053,55,5,60,0,inf
20054,52,12,64,0,inf
20055,66,8,74,0,inf
20056,57,13,70,0,inf
20057,54,11,65,0,inf
20058,58,6,64,0,inf
20059,51,12,63,0,inf
20060,66,11,77,0,inf
20061,55,11,66,0,inf
20062,50,10,60,0,inf
20063,64,12,76,0,inf
20064,65,5,70,0,inf
20065,67,13,80,0,inf
20066,57,5,62,0,inf
20067,61,9,70,0,inf
20068,54,11,65,0,inf
20069,53,11,64,0,inf
20070,56,7,63,0,inf
20071,66,6,72,0,inf
20072,67,8,75,0,inf
20073,58,6,64,0,inf
20074,61,11,72,0,inf
20075,58,10,68,0,inf
20076,55,13,68,0,inf
20077,54,6,60,0,inf
20078,65,9,74,0,inf
20079,65,7,72,0,inf
20080,54,5,59,0,inf
20081,67,5,72,0,inf
20082,55,12,67,0,inf
20083,51,5,56,0,inf
20084,53,8,61,0,inf
20085,66,13,79,0,inf
20086,62,7,69,0,inf
20087,57,11,68,0,inf
20088,66,9,75,0,inf
20089,50,11,61,1,6.065039227922185
20090,63,7,70,1,2.3380485642392017
20091,60,6,66,0,inf
20092,51,8,59,0,inf
20093,63,12,75,0,inf
20094,60,7,67,0,inf
20095,59,6,65,0,inf
20096,66,12,78,0,inf
20097,52,11,63,0,inf
20098,62,12,74,0,inf
20099,56,11,67,0,inf
20100,50,6,56,0,inf
20101,53,9,62,0,inf
20102,67,12,79,0,inf
20103,67,12,79,0,inf
20104,59,8,67,0,inf
20105,67,13,80,0,inf
20106,60,7,67,0,inf
20107,54,11,65,0,inf
20108,57,7,64,0,inf
20109,55,9,64,0,inf
20110,65,11,76,0,inf
20111,66,7,73,0,inf
20112,51,7,58,0,inf
20113,63,6,69,0,inf
20114,57,13,70,0,inf
20115,59,11,70,0,inf
20116,62,8,70,0,inf
20117,57,6,63,0,inf
20118,59,13,72,0,inf
20119,59,6,65,0,inf
20120,55,12,67,0,inf
20121,66,7,73,0,inf
20122,60,6,66,0,inf
20123,61,5,66,0,inf
20124,55,10,65,0,inf
20125,54,9,63,0,inf
20126,50,10,60,0,inf
20127,61,5,66,0,inf
20128,60,5,65,0,inf
20129,61,9,70,0,inf
20130,65,12,77,0,inf
20131,58,5,63,0,inf
20132,66,9,75,0,inf
20133,59,5,64,0,inf
20134,60,8,68,0,inf
20135,67,11,78,0,inf
20136,63,10,73,0,inf
20137,56,13,69,0,inf
20138,59,5,64,0,inf
20139,66,13,79,1,5.465487041060598
20140,58,11,69,0,inf
20141,67,13,80,0,inf
20142,55,5,60,0,inf
20143,50,8,58,0,inf
20144,56,5,61,0,inf
20145,60,10,70,0,inf
20146,50,10,60,0,inf
20147,65,12,77,0,inf
20148,55,9,64,0,inf
20149,56,10,66,0,inf
20150,51,9,60,0,inf
20151,55,11,66,0,inf
20152,52,6,58,0,inf
20153,58,11,69,0,inf
20154,62,8,70,0,inf
20155,58,11,69,0,inf
20156,53,11,64,0,inf
20157,65,12,77,0,inf
20158,62,10,72,0,inf
20159,50,9,59,0,inf
20160,54,13,67,0,inf
20161,67,6,73,0,inf
20162,56,7,63,0,inf
20163,57,10,67,0,inf
20164,63,10,73,0,inf
20165,59,7,66,0,inf
20166,59,13,72,0,inf
20167,51,10,61,0,inf
20168,52,9,61,0,inf
20169,56,6,62,0,inf
20170,53,8,61,0,inf
20171,65,6,71,0,inf
20172,57,6,63,0,inf
20173,54,6,60,0,inf
20174,57,10,67,1,1.3560743836819498
20175,53,7,60,0,inf
20176,63,10,73,0,inf
20177,63,7,70,0,inf
20178,55,10,65,0,inf
20179,54,12,66,0,inf
20180,65,8,73,0,inf
20181,58,11,69,0,inf
20182,63,13,76,0,inf
20183,64,9,73,0,inf
20184,64,7,71,0,inf
20185,65,11,76,0,inf
20186,61,10,71,0,inf
20187,52,8,60,0,inf
20188,50,5,55,0,inf
20189,55,11,66,0,inf
20190,66,8,74,0,inf
20191,62,8,70,0,inf
20192,50,5,55,0,inf
20193,61,12,73,1,3.0147216335321616
20194,61,13,74,0,inf
20195,51,5,56,0,inf
20196,67,9,76,0,inf
20197,65,8,73,0,inf
20198,55,5,60,0,inf
20199,51,11,62,0,inf
20200,64,12,76,0,inf
20201,50,7,57,0,inf
20202,63,10,73,0,inf
20203,62,10,72,0,inf
20204,50,7,57,0,inf
20205,67,11,78,0,inf
20206,61,8,69,0,inf
20207,64,6,70,0,inf
20208,53,11,64,0,inf
20209,57,6,63,0,inf
20210,57,7,64,0,inf
20211,61,5,66,0,inf
20212,50,8,58,0,inf
20213,55,8,63,0,inf
20214,52,7,59,0,inf
20215,52,8,60,0,inf
20216,53,5,58,0,inf
20217,51,9,60,0,inf
20218,65,7,72,1,5.548185588231718
20219,61,5,66,0,inf
20220,66,5,71,0,inf
20221,58,9,67,0,inf
20222,62,13,75,0,inf
20223,50,12,62,1,11.521466070968437
20224,57,6,63,0,inf
20225,60,6,66,0,inf
20226,51,5,56,0,inf
20227,62,6,68,0,inf
20228,54,10,64,0,inf
20229,62,7,69,0,inf
20230,55,8,63,0,inf
20231,51,5,56,0,inf
20232,63,13,76,0,inf
20233,52,9,61,0,inf
20234,60,8,68,1,2.027365024432143
20235,60,11,71,0,inf
20236,51,10,61,0,inf
20237,54,13,67,0,inf
20238,63,11,74,0,inf
20239,52,6,58,0,inf
20240,51,7,58,0,inf
20241,58,9,67,0,inf
20242,57,12,69,0,inf
20243,53,9,62,0,inf
20244,55,13,68,0,inf
20245,54,5,59,0,inf
20246,52,9,61,0,inf
20247,50,11,61,0,inf
20248,62,12,74,0,inf
20249,62,8,70,0,inf
20250,54,9,63,0,inf
20251,55,10,65,0,inf
20252,52,8,60,0,inf
20253,55,11,66,0,inf
20254,60,12,72,0,inf
20255,52,13,65,0,inf
20256,55,6,61,0,inf
20257,60,12,72,0,inf
20258,60,12,72,0,inf
20259,52,10,62,0,inf
20260,64,10,74,0,inf
20261,67,11,78,0,inf
20262,65,8,73,0,inf
20263,56,7,63,0,inf
20264,61,8,69,0,inf
20265,63,5,68,0,inf
20266,66,6,72,0,inf
20267,50,13,63,0,inf
20268,51,9,60,0,inf
20269,62,9,71,0,inf
20270,59,8,67,0,inf
20271,60,9,69,1,8.745009390497074
20272,61,11,72,0,inf
20273,57,6,63,0,inf
20274,67,11,78,0,inf
20275,50,11,61,1,8.714272863510132
20276,62,10,72,0,inf
20277,56,8,64,0,inf
20278,64,10,74,0,inf
20279,54,13,67,0,inf
20280,63,11,74,0,inf
20281,66,5,71,0,inf
20282,54,8,62,0,inf
20283,50,7,57,0,inf
20284,55,13,68,0,inf
20285,50,10,60,0,inf
20286,60,9,69,0,inf
20287,51,8,59,0,inf
20288,65,8,73,0,inf
20289,54,7,61,0,inf
20290,57,7,64,0,inf
20291,56,13,69,0,inf
20292,60,9,69,0,inf
20293,66,12,78,0,inf
20294,50,8,58,0,inf
20295,58,8,66,0,inf
20296,57,11,68,0,inf
20297,63,6,69,0,inf
20298,50,13,63,0,inf
20299,54,12,66,0,inf
20300,56,5,61,0,inf
20301,51,6,57,0,inf
20302,61,9,70,0,inf
20303,52,6,58,0,inf
20304,59,6,65,0,inf
20305,54,6,60,0,inf
20306,66,9,75,0,inf
20307,66,5,71,0,inf
20308,51,7,58,0,inf
20309,63,10,73,0,inf
20310,66,5,71,0,inf
20311,67,13,80,0,inf
20312,54,13,67,0,inf
20313,67,11,78,0,inf
20314,58,5,63,0,inf
20315,64,10,74,0,inf
20316,57,10,67,0,inf
20317,65,12,77,0,inf
20318,59,13,72,0,inf
20319,57,12,69,0,inf
20320,50,13,63,0,inf
20321,66,12,78,0,inf
20322,60,13,73,0,inf
20323,61,11,72,0,inf
20324,56,9,65,0,inf
20325,61,7,68,0,inf
20326,54,11,65,0,inf
20327,52,11,63,0,inf
20328,63,6,69,0,inf
20329,56,9,65,0,inf
20330,50,13,63,0,inf
20331,53,7,60,0,inf
20332,56,8,64,0,inf
20333,57,11,68,0,inf
20334,53,9,62,0,inf
20335,62,5,67,0,inf
20336,57,9,66,0,inf
20337,55,13,68,0,inf
20338,57,5,62,0,inf
20339,65,5,70,0,inf
20340,54,12,66,0,inf
20341,50,5,55,0,inf
20342,65,12,77,0,inf
20343,66,9,75,0,inf
20344,62,7,69,0,inf
20345,61,5,66,0,inf
20346,67,10,77,0,inf
20347,63,12,75,0,inf
20348,54,8,62,0,inf
20349,55,5,60,0,inf
20350,62,9,71,0,inf
20351,59,8,67,0,inf
20352,51,8,59,0,inf
20353,65,10,75,0,inf
20354,53,11,64,1,6.82019016941441
20355,60,9,69,0,inf
20356,55,8,63,0,inf
20357,50,13,63,0,inf
20358,53,11,64,0,inf
20359,66,10,76,0,inf
20360,64,5,69,0,inf
20361,51,13,64,0,inf
20362,57,8,65,0,inf
20363,58,9,67,0,inf
20364,59,10,69,0,inf
20365,51,9,60,0,inf
20366,56,9,65,1,5.412611017973738
20367,52,5,57,0,inf
20368,60,9,69,1,8.947757519403964
20369,64,12,76,0,inf
20370,55,8,63,0,inf
20371,59,11,70,0,inf
20372,53,6,59,0,inf
20373,59,8,67,0,inf
20374,60,8,68,0,inf
20375,51,10,61,0,inf
20376,64,10,74,0,inf
20377,65,7,72,0,inf
20378,62,5,67,0,inf
20379,61,13,74,0,inf
20380,50,11,61,0,inf
20381,60,11,71,0,inf
20382,67,8,75,0,inf
20383,57,10,67,0,inf
20384,62,6,68,0,inf
20385,58,12,70,0,inf
20386,55,13,68,0,inf
20387,57,13,70,0,inf
20388,66,8,74,0,inf
20389,53,7,60,0,inf
20390,50,6,56,0,inf
20391,64,9,73,0,inf
20392,62,6,68,0,inf
20393,59,12,71,0,inf
20394,63,9,72,0,inf
20395,55,12,67,0,inf
20396,51,9,60,0,inf
20397,51,9,60,0,inf
20398,67,6,73,1,2.5786011834237996
20399,59,9,68,0,inf
20400,55,9,64,0,inf
20401,50,7,57,0,inf
20402,59,12,71,0,inf
20403,64,13,77,0,inf
20404,63,5,68,0,inf
20405,60,5,65,0,inf
20406,56,13,69,0,inf
20407,55,8,63,1,7.674882354619214
20408,56,11,67,0,inf
20409,64,7,71,1,5.9253158296626935
20410,57,7,64,0,inf
20411,53,13,66,0,inf
20412,59,11,70,1,5.666442239300281
20413,60,11,71,0,inf
20414,57,12,69,0,inf
20415,55,9,64,0,inf
20416,52,12,64,0,inf
20417,54,11,65,0,inf
20418,56,7,63,0,inf
20419,53,6,59,0,inf
20420,63,6,69,0,inf
20421,50,7,57,0,inf
20422,67,5,72,0,inf
20423,67,10,77,0,inf
20424,56,8,64,0,inf
20425,60,11,71,0,inf
20426,64,11,75,0,inf
20427,53,9,62,0,inf
20428,53,11,64,0,inf
20429,63,6,69,0,inf
20430,52,12,64,0,inf
20431,52,13,65,0,inf
20432,51,9,60,0,inf
20433,51,11,62,0,inf
20434,60,8,68,0,inf
20435,50,7,57,0,inf
20436,54,6,60,0,inf
20437,57,7,64,1,0.9591125747693852
20438,52,5,57,0,inf
20439,56,11,67,0,inf
20440,63,12,75,0,inf
20441,52,8,60,0,inf
20442,63,5,68,0,inf
20443,51,5,56,0,inf
20444,67,10,77,0,inf
20445,63,9,72,0,inf
20446,50,11,61,0,inf
20447,64,13,77,0,inf
20448,55,6,61,0,inf
20449,56,11,67,0,inf
20450,58,12,70,0,inf
20451,61,11,72,0,inf
20452,55,5,60,0,inf
20453,61,5,66,0,inf
20454,53,10,63,0,inf
20455,57,12,69,0,inf
20456,51,8,59,0,inf
20457,55,7,62,0,inf
20458,57,11,68,0,inf
20459,51,12,63,0,inf
20460,61,9,70,0,inf
20461,62,5,67,0,inf
20462,52,10,62,0,inf
20463,61,8,69,0,inf
20464,63,7,70,0,inf
20465,67,6,73,0,inf
20466,53,12,65,0,inf
20467,50,7,57,0,inf
20468,65,12,77,0,inf
20469,56,6,62,0,inf
20470,51,10,61,1,6.140256738168112
20471,57,7,64,0,inf
20472,58,11,69,0,inf
20473,60,5,65,0,inf
20474,62,6,68,0,inf
20475,56,6,62,0,inf
20476,66,12,78,0,inf
20477,53,8,61,0,inf
20478,59,6,65,0,inf
20479,59,9,68,0,inf
20480,58,10,68,0,inf
20481,52,11,63,0,inf
20482,60,12,72,0,inf
20483,61,9,70,0,inf
20484,65,5,70,0,inf
20485,58,11,69,0,inf
20486,56,9,65,0,inf
20487,64,5,69,0,inf
20488,56,9,65,0,inf
20489,60,12,72,0,inf
20490,66,5,71,0,inf
20491,57,9,66,0,inf
20492,65,8,73,0,inf
20493,55,13,68,1,4.408924909454271
20494,58,12,70,0,inf
20495,63,5,68,0,inf
20496,64,6,70,0,inf
20497,52,5,57,0,inf
20498,56,12,68,0,inf
20499,65,5,70,0,inf
20500,58,8,66,1,2.38757527808918
20501,60,13,73,0,inf
20502,66,5,71,0,inf
20503,52,12,64,0,inf
20504,51,5,56,0,inf
20505,65,11,76,0,inf
20506,50,5,55,0,inf
20507,67,11,78,0,inf
20508,59,6,65,0,inf
20509,61,6,67,0,inf
20510,63,8,71,0,inf
20511,61,13,74,0,inf
20512,67,5,72,0,inf
20513,54,5,59,0,inf
20514,67,5,72,0,inf
20515,53,6,59,0,inf
20516,60,13,73,0,inf
20517,65,8,73,0,inf
20518,52,5,57,0,inf
20519,66,7,73,0,inf
20520,60,5,65,0,inf
20521,64,8,72,0,inf
20522,60,9,69,0,inf
20523,59,7,66,0,inf
20524,59,13,72,0,inf
20525,61,12,73,0,inf
20526,52,9,61,0,inf
20527,50,6,56,0,inf
20528,65,7,72,0,inf
20529,53,8,61,0,inf
20530,67,7,74,0,inf
20531,64,8,72,0,inf
20532,67,12,79,0,inf
20533,54,13,67,0,inf
20534,55,7,62,0,inf
20535,58,12,70,0,inf
20536,53,12,65,0,inf
20537,66,13,79,0,inf
20538,57,9,66,0,inf
20539,60,5,65,0,inf
20540,53,13,66,0,inf
20541,65,13,78,0,inf
20542,62,13,75,0,inf
20543,51,13,64,0,inf
20544,66,9,75,0,inf
20545,63,11,74,1,5.768635055511282
20546,66,5,71,0,inf
20547,53,11,64,0,inf
20548,60,11,71,0,inf
20549,63,7,70,0,inf
20550,63,10,73,0,inf
20551,67,7,74,0,inf
20552,65,8,73,0,inf
20553,52,8,60,0,inf
20554,53,9,62,0,inf
20555,53,10,63,0,inf
20556,66,10,76,0,inf
20557,58,5,63,0,inf
20558,54,6,60,0,inf
20559,64,12,76,0,inf
20560,64,13,77,1,10.777509184652047
20561,66,13,79,0,inf
20562,66,7,73,0,inf
20563,50,11,61,0,inf
20564,64,11,75,0,inf
20565,51,8,59,0,inf
20566,50,9,59,0,inf
20567,55,10,65,0,inf
20568,50,5,55,0,inf
20569,63,5,68,0,inf
20570,64,5,69,0,inf
20571,54,10,64,0,inf
20572,52,11,63,0,inf
20573,60,9,69,0,inf
20574,59,9,68,0,inf
20575,56,13,69,0,inf
20576,61,9,70,0,inf
20577,51,5,56,0,inf
20578,60,7,67,0,inf
20579,63,10,73,0,inf
20580,52,6,58,0,inf
20581,52,5,57,0,inf
20582,62,7,69,0,inf
20583,58,13,71,0,inf
20584,59,13,72,0,inf
20585,60,7,67,0,inf
20586,53,6,59,0,inf
20587,65,7,72,0,inf
20588,58,11,69,0,inf
20589,59,8,67,0,inf
20590,50,5,55,0,inf
20591,56,13,69,0,inf
20592,50,9,59,0,inf
20593,65,7,72,0,inf
20594,52,6,58,0,inf
20595,64,7,71,0,inf
20596,56,13,69,0,inf
20597,57,5,62,0,inf
20598,65,7,72,0,inf
20599,55,10,65,0,inf
20600,58,8,66,0,inf
20601,62,5,67,0,inf
20602,51,10,61,0,inf
20603,67,6,73,0,inf
20604,52,13,65,0,inf
20605,65,12,77,0,inf
20606,50,10,60,0,inf
20607,67,10,77,0,inf
20608,59,7,66,0,inf
20609,64,10,74,0,inf
20610,51,5,56,0,inf
20611,56,13,69,0,inf
20612,57,8,65,0,inf
20613,56,6,62,0,inf
20614,53,11,64,0,inf
20615,51,7,58,0,inf
20616,60,13,73,0,inf
20617,59,6,65,0,inf
20618,56,10,66,0,inf
20619,56,11,67,0,inf
20620,53,9,62,0,inf
20621,64,10,74,0,inf
20622,65,7,72,0,inf
20623,57,9,66,0,inf
20624,53,12,65,0,inf
20625,61,7,68,0,inf
20626,58,11,69,0,inf
20627,60,10,70,0,inf
20628,54,6,60,0,inf
20629,51,6,57,0,inf
20630,53,10,63,0,inf
20631,56,8,64,0,inf
20632,58,13,71,0,inf
20633,61,6,67,0,inf
20634,67,6,73,0,inf
20635,61,12,73,0,inf
20636,59,10,69,0,inf
20637,65,9,74,0,inf
20638,64,9,73,0,inf
20639,67,7,74,0,inf
20640,58,12,70,0,inf
20641,59,12,71,1,2.692350041272121
20642,59,12,71,0,inf
20643,59,12,71,0,inf
20644,57,11,68,0,inf
20645,65,6,71,0,inf
20646,60,12,72,0,inf
20647,66,9,75,0,inf
20648,58,10,68,0,inf
20649,53,6,59,0,inf
20650,54,8,62,0,inf
20651,61,6,67,0,inf
20652,62,10,72,0,inf
20653,67,9,76,0,inf
20654,58,7,65,0,inf
20655,55,6,61,0,inf
20656,61,7,68,0,inf
20657,51,8,59,0,inf
20658,54,12,66,0,inf
20659,62,7,69,1,1.505714229896391
20660,53,13,66,0,inf
20661,60,13,73,0,inf
20662,55,7,62,0,inf
20663,67,7,74,0,inf
20664,59,6,65,0,inf
20665,52,8,60,0,inf
20666,52,6,58,0,inf
20667,54,12,66,0,inf
20668,61,12,73,0,inf
20669,54,7,61,0,inf
20670,62,8,70,0,inf
20671,61,5,66,0,inf
20672,51,9,60,0,inf
20673,58,9,67,0,inf
20674,61,8,69,1,5.05019037859708
20675,60,7,67,0,inf
20676,66,8,74,0,inf
20677,59,7,66,0,inf
20678,51,12,63,0,inf
20679,54,13,67,0,inf
20680,66,11,77,0,inf
20681,57,11,68,0,inf
20682,65,5,70,0,inf
20683,53,12,65,0,inf
20684,65,6,71,0,inf
20685,62,11,73,0,inf
20686,66,5,71,0,inf
20687,56,13,69,0,inf
20688,67,10,77,0,inf
20689,54,6,60,0,inf
20690,55,7,62,0,inf
20691,54,10,64,0,inf
20692,59,8,67,0,inf
20693,64,12,76,0,inf
20694,62,13,75,0,inf
20695,64,10,74,0,inf
20696,67,9,76,0,inf
20697,53,7,60,0,inf
20698,67,8,75,0,inf
20699,65,9,74,0,inf
20700,67,8,75,0,inf
20701,57,7,64,0,inf
20702,56,12,68,0,inf
20703,55,7,62,1,0.32712885507702083
20704,59,8,67,0,inf
20705,65,12,77,0,inf
20706,64,9,73,0,inf
20707,57,12,69,0,inf
20708,67,12,79,0,inf
20709,64,7,71,0,inf
20710,53,6,59,0,inf
20711,50,11,61,0,inf
20712,62,11,73,0,inf
20713,56,8,64,0,inf
20714,53,9,62,0,inf
20715,58,7,65,0,inf
20716,59,6,65,0,inf
20717,60,12,72,0,inf
20718,51,13,64,0,inf
20719,65,13,78,0,inf
20720,51,9,60,0,inf
20721,54,11,65,0,inf
20722,50,12,62,0,inf
20723,58,11,69,0,inf
20724,52,9,61,0,inf
20725,64,13,77,0,inf
20726,53,11,64,0,inf
20727,50,5,55,0,inf
20728,62,8,70,0,inf
20729,66,11,77,0,inf
20730,64,5,69,0,inf
20731,58,6,64,0,inf
20732,57,8,65,0,inf
20733,50,7,57,0,inf
20734,59,8,67,0,inf
20735,61,10,71,0,inf
20736,56,9,65,0,inf
20737,64,11,75,0,inf
20738,50,11,61,0,inf
20739,62,10,72,0,inf
20740,57,5,62,0,inf
20741,61,6,67,0,inf
20742,57,13,70,0,inf
20743,53,11,64,0,inf
20744,62,8,70,0,inf
20745,57,6,63,0,inf
20746,62,8,70,0,inf
20747,67,11,78,0,inf
20748,63,8,71,0,inf
20749,67,9,76,0,inf
20750,62,9,71,0,inf
20751,53,6,59,0,inf
20752,50,11,61,0,inf
20753,55,10,65,0,inf
20754,50,7,57,0,inf
20755,63,7,70,0,inf
20756,66,9,75,0,inf
20757,62,10,72,0,inf
20758,58,10,68,0,inf
20759,60,11,71,0,inf
20760,52,7,59,1,4.8125674572411725
20761,55,7,62,0,inf
20762,57,10,67,0,inf
20763,58,8,66,0,inf
20764,59,13,72,0,inf
20765,59,7,66,0,inf
20766,51,8,59,0,inf
20767,58,11,69,0,inf
20768,55,12,67,0,inf
20769,63,13,76,0,inf
20770,61,10,71,0,inf
20771,63,7,70,0,inf
20772,51,5,56,0,inf
20773,67,13,80,0,inf
20774,66,13,79,0,inf
20775,51,5,56,0,inf
20776,56,7,63,0,inf
20777,56,11,67,0,inf
20778,61,5,66,0,inf
20779,55,5,60,0,inf
20780,52,10,62,0,inf
20781,54,6,60,0,inf
20782,57,8,65,0,inf
20783,67,9,76,0,inf
20784,52,8,60,0,inf
20785,65,12,77,0,inf
20786,59,5,64,0,inf
20787,67,6,73,0,inf
20788,64,7,71,0,inf
20789,51,8,59,0,inf
20790,61,11,72,0,inf
20791,60,12,72,0,inf
20792,56,6,62,0,inf
20793,52,8,60,0,inf
20794,50,8,58,0,inf
20795,65,11,76,0,inf
20796,66,11,77,0,inf
20797,65,13,78,0,inf
20798,51,9,60,0,inf
20799,66,7,73,0,inf
20800,54,7,61,0,inf
20801,50,11,61,0,inf
20802,55,8,63,0,inf
20803,59,8,67,0,inf
20804,53,7,60,0,inf
20805,64,13,77,0,inf
20806,60,11,71,0,inf
20807,63,6,69,0,inf
20808,55,10,65,0,inf
20809,55,11,66,0,inf
20810,53,12,65,0,inf
20811,50,9,59,0,inf
20812,55,9,64,0,inf
20813,64,11,75,0,inf
20814,51,13,64,0,inf
20815,63,12,75,0,inf
20816,60,13,73,0,inf
20817,56,8,64,0,inf
20818,53,10,63,0,inf
20819,58,13,71,0,inf
20820,57,6,63,0,inf
20821,64,13,77,0,inf
20822,65,7,72,0,inf
20823,66,10,76,0,inf
20824,50,13,63,0,inf
20825,66,8,74,0,inf
20826,65,12,77,0,inf
20827,56,11,67,0,inf
20828,54,11,65,0,inf
20829,63,8,71,0,inf
20830,66,12,78,1,7.9079146678827215
20831,62,11,73,0,inf
20832,62,6,68,0,inf
20833,51,8,59,0,inf
20834,51,12,63,0,inf
20835,50,8,58,0,inf
20836,64,7,71,0,inf
20837,54,10,64,0,inf
20838,60,5,65,0,inf
20839,59,12,71,0,inf
20840,58,9,67,0,inf
20841,65,7,72,0,inf
20842,61,10,71,0,inf
20843,60,12,72,0,inf
20844,53,8,61,0,inf
20845,58,7,65,0,inf
20846,66,10,76,0,inf
20847,51,13,64,0,inf
20848,59,6,65,0,inf
20849,66,11,77,0,inf
20850,57,11,68,0,inf
20851,61,11,72,0,inf
20852,54,7,61,0,inf
20853,50,12,62,0,inf
20854,63,8,71,0,inf
20855,61,6,67,0,inf
20856,56,7,63,0,inf
20857,60,7,67,0,inf
20858,57,7,64,0,inf
20859,59,8,67,0,inf
20860,55,10,65,0,inf
20861,51,9,60,0,inf
20862,61,7,68,0,inf
20863,54,8,62,0,inf
20864,50,7,57,0,inf
20865,58,12,70,0,inf
20866,53,12,65,0,inf
20867,56,13,69,0,inf
20868,66,12,78,0,inf
20869,63,9,72,0,inf
20870,57,9,66,0,inf
20871,65,7,72,0,inf
20872,51,6,57,0,inf
20873,62,9,71,0,inf
20874,59,9,68,0,inf
20875,67,11,78,0,inf
20876,66,7,73,0,inf
20877,50,5,55,0,inf
20878,63,13,76,0,inf
20879,59,10,69,0,inf
20880,50,8,58,0,inf
20881,50,12,62,0,inf
20882,57,7,64,0,inf
20883,60,10,70,0,inf
20884,55,6,61,0,inf
20885,66,11,77,0,inf
20886,54,13,67,0,inf
20887,64,12,76,0,inf
20888,52,10,62,0,inf
20889,66,10,76,0,inf
20890,62,13,75,0,inf
20891,64,8,72,0,inf
20892,57,8,65,0,inf
20893,50,10,60,0,inf
20894,63,7,70,0,inf
20895,63,10,73,0,inf
20896,54,6,60,0,inf
20897,54,7,61,0,inf
20898,65,10,75,0,inf
20899,56,8,64,0,inf
20900,50,11,61,0,inf
20901,53,12,65,0,inf
20902,54,8,62,0,inf
20903,54,5,59,0,inf
20904,62,5,67,0,inf
20905,51,10,61,0,inf
20906,64,10,74,0,inf
20907,62,9,71,0,inf
20908,58,9,67,0,inf
20909,58,8,66,0,inf
20910,52,12,64,0,inf
20911,51,7,58,0,inf
20912,56,11,67,0,inf
20913,59,13,72,0,inf
20914,57,8,65,0,inf
20915,65,7,72,0,inf
20916,55,12,67,0,inf
20917,51,13,64,0,inf
20918,57,9,66,0,inf
20919,54,11,65,0,inf
20920,51,9,60,0,inf
20921,62,12,74,0,inf
20922,64,12,76,1,7.875481905598605
20923,51,9,60,0,inf
20924,58,6,64,0,inf
20925,59,9,68,0,inf
20926,51,10,61,0,inf
20927,64,9,73,0,inf
20928,62,9,71,0,inf
20929,64,8,72,0,inf
20930,59,7,66,0,inf
20931,55,12,67,0,inf
20932,53,8,61,0,inf
20933,54,7,61,0,inf
20934,51,9,60,0,inf
20935,58,5,63,0,inf
20936,57,9,66,0,inf
20937,63,10,73,0,inf
20938,55,7,62,0,inf
20939,56,11,67,0,inf
20940,63,9,72,0,inf
20941,52,12,64,0,inf
20942,60,13,73,0,inf
20943,60,8,68,0,inf
20944,52,9,61,0,inf
20945,53,12,65,0,inf
20946,55,10,65,0,inf
20947,63,5,68,0,inf
20948,57,9,66,0,inf
20949,64,11,75,0,inf
20950,65,9,74,0,inf
20951,51,12,63,0,inf
20952,58,11,69,0,inf
20953,62,7,69,0,inf
20954,66,6,72,0,inf
20955,60,12,72,0,inf
20956,50,5,55,0,inf
20957,54,13,67,0,inf
20958,65,12,77,0,inf
20959,52,8,60,0,inf
20960,60,8,68,0,inf
20961,58,10,68,1,8.491680822570686
20962,55,6,61,0,inf
20963,50,5,55,1,0.21455811369352773
20964,56,9,65,0,inf
20965,52,7,59,0,inf
20966,56,10,66,0,inf
20967,53,7,60,0,inf
20968,62,8,70,0,inf
20969,54,10,64,0,inf
20970,59,10,69,0,inf
20971,61,13,74,0,inf
20972,60,9,69,0,inf
20973,65,6,71,0,inf
20974,52,10,62,0,inf
20975,58,9,67,0,inf
20976,56,8,64,0,inf
20977,52,6,58,0,inf
20978,65,9,74,0,inf
20979,51,6,57,0,inf
20980,62,13,75,0,inf
20981,55,13,68,0,inf
20982,58,10,68,0,inf
20983,67,8,75,0,inf
20984,66,8,74,0,inf
20985,54,11,65,0,inf
20986,53,6,59,0,inf
20987,61,6,67,0,inf
20988,53,7,60,0,inf
20989,52,6,58,0,inf
20990,54,7,61,0,inf
20991,59,8,67,0,inf
20992,50,11,61,0,inf
20993,52,8,60,0,inf
20994,50,11,61,0,inf
20995,63,10,73,0,inf
20996,53,12,65,0,inf
20997,60,8,68,0,inf
20998,60,5,65,0,inf
20999,66,7,73,0,inf
21000,64,5,69,0,inf
21001,65,9,74,0,inf
21002,60,8,68,0,inf
21003,67,6,73,0,inf
21004,65,12,77,0,inf
21005,60,9,69,0,inf
21006,51,10,61,0,inf
21007,67,6,73,0,inf
21008,51,5,56,0,inf
21009,56,5,61,0,inf
21010,53,11,64,0,inf
21011,50,8,58,0,inf
21012,55,12,67,0,inf
21013,60,11,71,0,inf
21014,66,5,71,1,3.149272816657273
21015,52,7,59,0,inf
21016,61,12,73,0,inf
21017,64,10,74,0,inf
21018,52,6,58,0,inf
21019,54,13,67,0,inf
21020,61,12,73,1,6.840081139969541
21021,60,13,73,0,inf
21022,55,13,68,0,inf
21023,63,11,74,0,inf
21024,56,9,65,0,inf
21025,60,6,66,0,inf
21026,64,6,70,1,1.708814343557009
21027,64,11,75,0,inf
21028,58,5,63,0,inf
21029,54,6,60,0,inf
21030,51,11,62,0,inf
21031,54,9,63,0,inf
21032,54,9,63,0,inf
21033,66,8,74,0,inf
21034,60,7,67,0,inf
21035,62,8,70,0,inf
21036,51,7,58,0,inf
21037,61,9,70,0,inf
21038,62,10,72,0,inf
21039,65,13,78,0,inf
21040,67,13,80,0,inf
21041,61,8,69,0,inf
21042,60,5,65,0,inf
21043,61,8,69,0,inf
21044,55,12,67,0,inf
21045,53,13,66,0,inf
21046,62,6,68,0,inf
21047,62,5,67,1,2.808171318628652
21048,51,7,58,0,inf
21049,51,5,56,0,inf
21050,63,11,74,0,inf
21051,66,11,77,0,inf
21052,54,9,63,0,inf
21053,64,6,70,0,inf
21054,51,7,58,0,inf
21055,51,11,62,0,inf
21056,57,6,63,0,inf
21057,56,11,67,1,10.277106746181872
21058,66,5,71,0,inf
21059,65,6,71,0,inf
21060,56,10,66,0,inf
21061,55,7,62,0,inf
21062,58,12,70,0,inf
21063,52,9,61,0,inf
21064,56,12,68,0,inf
21065,59,7,66,0,inf
21066,67,11,78,0,inf
21067,52,12,64,0,inf
21068,59,8,67,0,inf
21069,60,9,69,0,inf
21070,56,13,69,0,inf
21071,58,8,66,0,inf
21072,53,8,61,0,inf
21073,51,7,58,0,inf
21074,58,12,70,0,inf
21075,55,5,60,0,inf
21076,55,6,61,0,inf
21077,54,6,60,0,inf
21078,55,12,67,0,inf
21079,55,13,68,0,inf
21080,56,7,63,0,inf
21081,66,7,73,0,inf
21082,58,6,64,0,inf
21083,60,7,67,0,inf
21084,52,6,58,0,inf
21085,62,5,67,0,inf
21086,65,13,78,0,inf
21087,59,9,68,0,inf
21088,61,6,67,0,inf
21089,67,7,74,0,inf
21090,50,11,61,0,inf
21091,66,12,78,0,inf
21092,55,7,62,0,inf
21093,50,9,59,0,inf
21094,58,8,66,0,inf
21095,56,10,66,0,inf
21096,55,12,67,0,inf
21097,50,5,55,0,inf
21098,61,5,66,0,inf
21099,60,6,66,0,inf
21100,52,9,61,0,inf
21101,53,12,65,0,inf
21102,52,8,60,0,inf
21103,52,13,65,0,inf
21104,59,5,64,0,inf
21105,63,8,71,0,inf
21106,54,6,60,0,inf
21107,54,5,59,0,inf
21108,55,9,64,0,inf
21109,65,8,73,0,inf
21110,60,13,73,0,inf
21111,63,11,74,0,inf
21112,50,8,58,0,inf
21113,66,7,73,0,inf
21114,61,7,68,0,inf
21115,60,7,67,0,inf
21116,63,8,71,0,inf
21117,52,9,61,0,inf
21118,64,8,72,0,inf
21119,67,9,76,0,inf
21120,56,8,64,0,inf
21121,53,5,58,0,inf
21122,66,9,75,0,inf
21123,61,11,72,0,inf
21124,62,7,69,0,inf
21125,53,8,61,0,inf
21126,57,5,62,0,inf
21127,60,10,70,0,inf
21128,55,6,61,0,inf
21129,50,8,58,0,inf
21130,57,12,69,0,inf
21131,62,5,67,0,inf
21132,65,8,73,0,inf
21133,56,12,68,0,inf
21134,65,8,73,0,inf
21135,62,10,72,0,inf
21136,52,9,61,0,inf
21137,54,9,63,0,inf
21138,55,6,61,0,inf
21139,58,13,71,0,inf
21140,58,7,65,0,inf
21141,66,10,76,0,inf
21142,57,8,65,0,inf
21143,59,5,64,1,2.0702384844113624
21144,60,13,73,0,inf
21145,53,6,59,0,inf
21146,67,6,73,0,inf
21147,50,12,62,0,inf
21148,62,12,74,1,2.106476823075056
21149,63,13,76,0,inf
21150,50,8,58,0,inf
21151,64,11,75,1,1.883114975547457
21152,54,8,62,0,inf
21153,60,13,73,0,inf
21154,59,11,70,0,inf
21155,54,6,60,0,inf
21156,63,9,72,0,inf
21157,66,5,71,0,inf
21158,51,12,63,0,inf
21159,62,8,70,0,inf
21160,51,8,59,0,inf
21161,63,7,70,0,inf
21162,61,12,73,0,inf
21163,60,11,71,0,inf
21164,50,11,61,0,inf
21165,53,8,61,0,inf
21166,52,9,61,0,inf
21167,61,5,66,0,inf
21168,65,6,71,0,inf
21169,67,8,75,0,inf
21170,55,9,64,0,inf
21171,57,8,65,0,inf
21172,63,11,74,0,inf
21173,50,5,55,0,inf
21174,61,12,73,0,inf
21175,64,13,77,1,4.825498071530276
21176,64,11,75,0,inf
21177,55,8,63,0,inf
21178,63,13,76,0,inf
21179,58,12,70,0,inf
21180,51,12,63,0,inf
21181,64,8,72,0,inf
21182,57,12,69,0,inf
21183,62,6,68,0,inf
21184,57,10,67,1,9.236477996316026
21185,61,10,71,0,inf
21186,50,10,60,0,inf
21187,54,9,63,0,inf
21188,67,12,79,0,inf
21189,62,12,74,0,inf
21190,54,10,64,0,inf
21191,53,5,58,0,inf
21192,50,11,61,0,inf
21193,59,6,65,0,inf
21194,58,6,64,0,inf
21195,50,11,61,0,inf
21196,58,12,70,0,inf
21197,62,13,75,0,inf
21198,54,13,67,0,inf
21199,59,5,64,0,inf
21200,66,11,77,0,inf
21201,54,11,65,0,inf
21202,67,11,78,0,inf
21203,55,8,63,0,inf
21204,53,8,61,0,inf
21205,58,11,69,0,inf
21206,57,5,62,0,inf
21207,59,5,64,0,inf
21208,57,13,70,0,inf
21209,51,7,58,0,inf
21210,59,8,67,0,inf
21211,59,5,64,0,inf
21212,55,7,62,0,inf
21213,52,8,60,0,inf
21214,50,12,62,0,inf
21215,55,5,60,0,inf
21216,63,7,70,0,inf
21217,52,6,58,0,inf
21218,51,10,61,0,inf
21219,50,10,60,1,6.260662747428718
21220,53,12,65,0,inf
21221,54,12,66,0,inf
21222,61,8,69,0,inf
21223,55,9,64,1,3.0592245294896188
21224,52,13,65,0,inf
21225,55,7,62,0,inf
21226,52,10,62,1,8.586196430916168
21227,63,11,74,0,inf
21228,66,8,74,0,inf
21229,66,13,79,1,9.380317270549881
21230,60,12,72,0,inf
21231,56,8,64,0,inf
21232,52,10,62,0,inf
21233,58,13,71,0,inf
21234,58,8,66,0,inf
21235,50,13,63,0,inf
21236,61,9,70,0,inf
21237,62,12,74,0,inf
21238,58,7,65,0,inf
21239,64,7,71,0,inf
21240,57,12,69,0,inf
21241,54,8,62,0,inf
21242,63,6,69,0,inf
21243,61,10,71,0,inf
21244,66,7,73,0,inf
21245,60,7,67,0,inf
21246,55,10,65,0,inf
21247,52,9,61,0,inf
21248,54,8,62,0,inf
21249,63,7,70,0,inf
21250,65,9,74,0,inf
21251,67,6,73,0,inf
21252,56,6,62,0,inf
21253,64,8,72,0,inf
21254,51,9,60,0,inf
21255,63,6,69,0,inf
21256,65,13,78,0,inf
21257,57,9,66,0,inf
21258,55,11,66,0,inf
21259,50,12,62,0,inf
21260,53,7,60,0,inf
21261,58,8,66,0,inf
21262,53,7,60,0,inf
21263,66,6,72,0,inf
21264,62,13,75,0,inf
21265,67,6,73,0,inf
21266,54,10,64,0,inf
21267,51,8,59,0,inf
21268,56,9,65,0,inf
21269,56,8,64,0,inf
21270,57,6,63,0,inf
21271,51,10,61,0,inf
21272,59,10,69,0,inf
21273,64,5,69,0,inf
21274,65,11,76,0,inf
21275,55,11,66,0,inf
21276,60,5,65,0,inf
21277,56,10,66,0,inf
21278,65,7,72,0,inf
21279,61,9,70,0,inf
21280,52,8,60,0,inf
21281,54,5,59,0,inf
21282,64,5,69,0,inf
21283,58,12,70,0,inf
21284,61,10,71,0,inf
21285,52,7,59,0,inf
21286,60,10,70,0,inf
21287,64,6,70,0,inf
21288,62,12,74,0,inf
21289,51,5,56,0,inf
21290,62,10,72,0,inf
21291,52,5,57,0,inf
21292,57,11,68,0,inf
21293,62,7,69,0,inf
21294,61,7,68,0,inf
21295,66,9,75,0,inf
21296,55,9,64,0,inf
21297,65,13,78,0,inf
21298,65,11,76,0,inf
21299,62,8,70,0,inf
21300,60,12,72,0,inf
21301,52,6,58,0,inf
21302,67,7,74,0,inf
21303,61,13,74,0,inf
21304,65,10,75,0,inf
21305,53,8,61,0,inf
21306,62,6,68,0,inf
21307,62,12,74,0,inf
21308,61,5,66,0,inf
21309,64,9,73,0,inf
21310,60,9,69,0,inf
21311,54,8,62,0,inf
21312,51,9,60,0,inf
21313,63,6,69,0,inf
21314,59,5,64,0,inf
21315,63,6,69,0,inf
21316,57,6,63,1,4.085472149081504
21317,56,13,69,0,inf
21318,56,10,66,0,inf
21319,55,6,61,0,inf
21320,64,6,70,0,inf
21321,63,12,75,0,inf
21322,59,12,71,0,inf
21323,52,12,64,0,inf
21324,51,6,57,0,inf
21325,60,8,68,0,inf
21326,60,8,68,0,inf
21327,64,10,74,0,inf
21328,61,13,74,0,inf
21329,62,13,75,0,inf
21330,62,6,68,0,inf
21331,64,9,73,0,inf
21332,61,7,68,0,inf
21333,62,11,73,0,inf
21334,51,5,56,0,inf
21335,59,10,69,0,inf
21336,50,7,57,0,inf
21337,51,6,57,0,inf
21338,66,5,71,0,inf
21339,59,13,72,0,inf
21340,52,8,60,0,inf
21341,67,12,79,0,inf
21342,67,12,79,0,inf
21343,54,9,63,0,inf
21344,53,9,62,0,inf
21345,62,6,68,0,inf
21346,51,11,62,0,inf
21347,58,13,71,0,inf
21348,52,10,62,0,inf
21349,63,7,70,0,inf
21350,53,8,61,0,inf
21351,66,12,78,0,inf
21352,54,6,60,0,inf
21353,55,9,64,0,inf
21354,60,7,67,0,inf
21355,64,12,76,0,inf
21356,55,12,67,0,inf
21357,60,8,68,0,inf
21358,53,13,66,0,inf
21359,57,12,69,0,inf
21360,52,7,59,0,inf
21361,65,9,74,0,inf
21362,56,10,66,0,inf
21363,64,6,70,0,inf
21364,57,8,65,0,inf
21365,52,7,59,0,inf
21366,58,9,67,0,inf
21367,67,12,79,0,inf
21368,52,5,57,0,inf
21369,65,10,75,0,inf
21370,64,12,76,0,inf
21371,51,5,56,0,inf
21372,59,12,71,0,inf
21373,59,12,71,0,inf
21374,62,7,69,0,inf
21375,58,8,66,0,inf
21376,55,12,67,0,inf
21377,63,10,73,0,inf
21378,65,8,73,0,inf
21379,59,9,68,0,inf
21380,55,8,63,0,inf
21381,57,5,62,0,inf
21382,57,13,70,0,inf
21383,55,9,64,0,inf
21384,66,13,79,0,inf
21385,66,8,74,0,inf
21386,62,6,68,0,inf
21387,51,5,56,0,inf
21388,59,10,69,0,inf
21389,51,8,59,0,inf
21390,51,7,58,0,inf
21391,58,10,68,0,inf
21392,66,6,72,0,inf
21393,57,13,70,0,inf
21394,53,11,64,0,inf
21395,59,5,64,0,inf
21396,66,13,79,0,inf
21397,55,13,68,1,4.544995317751059
21398,66,11,77,0,inf
21399,62,13,75,0,inf
21400,54,5,59,0,inf
21401,56,12,68,0,inf
21402,64,12,76,0,inf
21403,59,10,69,0,inf
21404,50,5,55,0,inf
21405,59,11,70,0,inf
21406,64,5,69,0,inf
21407,67,9,76,0,inf
21408,64,13,77,1,1.9682903992694634
21409,60,13,73,0,inf
21410,65,9,74,0,inf
21411,58,9,67,0,inf
21412,52,13,65,0,inf
21413,64,12,76,0,inf
21414,53,8,61,0,inf
21415,57,13,70,0,inf
21416,67,9,76,0,inf
21417,63,6,69,0,inf
21418,57,10,67,0,inf
21419,65,13,78,1,1.77286349197162
21420,50,7,57,0,inf
21421,66,12,78,0,inf
21422,62,7,69,0,inf
21423,64,10,74,0,inf
21424,59,12,71,0,inf
21425,65,7,72,0,inf
21426,53,13,66,0,inf
21427,65,8,73,0,inf
21428,66,11,77,0,inf
21429,60,13,73,0,inf
21430,58,8,66,0,inf
21431,60,11,71,0,inf
21432,52,13,65,0,inf
21433,63,6,69,0,inf
21434,58,10,68,0,inf
21435,58,6,64,0,inf
21436,67,6,73,0,inf
21437,51,9,60,0,inf
21438,66,12,78,0,inf
21439,52,11,63,0,inf
21440,58,5,63,0,inf
21441,61,13,74,0,inf
21442,53,10,63,1,7.519943174999007
21443,58,12,70,0,inf
21444,66,10,76,0,inf
21445,59,13,72,0,inf
21446,56,5,61,0,inf
21447,61,7,68,0,inf
21448,58,11,69,0,inf
21449,50,5,55,0,inf
21450,63,6,69,0,inf
21451,65,9,74,0,inf
21452,56,5,61,0,inf
21453,64,5,69,0,inf
21454,59,6,65,0,inf
21455,57,8,65,0,inf
21456,67,13,80,0,inf
21457,62,10,72,0,inf
21458,50,7,57,0,inf
21459,62,9,71,0,inf
21460,60,9,69,0,inf
21461,67,12,79,0,inf
21462,67,12,79,0,inf
21463,54,12,66,0,inf
21464,64,13,77,0,inf
21465,56,13,69,0,inf
21466,57,5,62,0,inf
21467,65,5,70,0,inf
21468,67,8,75,0,inf
21469,50,13,63,0,inf
21470,59,11,70,0,inf
21471,65,7,72,0,inf
21472,66,9,75,0,inf
21473,58,7,65,0,inf
21474,59,8,67,0,inf
21475,51,5,56,0,inf
21476,59,8,67,0,inf
21477,58,11,69,0,inf
21478,67,12,79,0,inf
21479,64,11,75,0,inf
21480,61,8,69,0,inf
21481,61,6,67,0,inf
21482,50,8,58,0,inf
21483,65,12,77,0,inf
21484,52,6,58,0,inf
21485,64,11,75,0,inf
21486,54,9,63,0,inf
21487,57,11,68,0,inf
21488,57,9,66,0,inf
21489,62,13,75,0,inf
21490,67,13,80,0,inf
21491,50,10,60,0,inf
21492,54,7,61,0,inf
21493,54,8,62,0,inf
21494,60,10,70,0,inf
21495,62,12,74,1,10.637265744549111
21496,53,11,64,0,inf
21497,61,11,72,0,inf
21498,63,9,72,0,inf
21499,63,11,74,0,inf
21500,62,12,74,0,inf
21501,60,9,69,0,inf
21502,60,11,71,0,inf
21503,67,9,76,0,inf
21504,56,10,66,0,inf
21505,51,12,63,0,inf
21506,53,11,64,0,inf
21507,63,5,68,0,inf
21508,58,6,64,0,inf
21509,55,12,67,0,inf
21510,57,5,62,0,inf
21511,67,12,79,0,inf
21512,63,7,70,0,inf
21513,50,7,57,0,inf
21514,52,12,64,0,inf
21515,66,11,77,0,inf
21516,59,10,69,0,inf
21517,54,13,67,0,inf
21518,64,9,73,0,inf
21519,50,10,60,0,inf
21520,58,11,69,0,inf
21521,57,13,70,0,inf
21522,65,10,75,0,inf
21523,50,13,63,0,inf
21524,53,8,61,0,inf
21525,55,12,67,0,inf
21526,62,5,67,0,inf
21527,58,12,70,0,inf
21528,61,11,72,0,inf
21529,60,12,72,0,inf
21530,51,8,59,0,inf
21531,55,11,66,0,inf
21532,58,9,67,0,inf
21533,53,11,64,0,inf
21534,55,5,60,0,inf
21535,57,8,65,0,inf
21536,66,5,71,1,2.8764727643248875
21537,61,10,71,0,inf
21538,58,6,64,0,inf
21539,50,11,61,0,inf
21540,53,13,66,0,inf
21541,51,12,63,0,inf
21542,65,12,77,0,inf
21543,61,8,69,0,inf
21544,50,11,61,0,inf
21545,58,5,63,0,inf
21546,54,6,60,0,inf
21547,63,13,76,0,inf
21548,61,12,73,0,inf
21549,64,8,72,0,inf
21550,55,9,64,0,inf
21551,50,8,58,0,inf
21552,52,6,58,0,inf
21553,50,9,59,0,inf
21554,67,5,72,0,inf
21555,50,8,58,0,inf
21556,63,9,72,0,inf
21557,57,10,67,0,inf
21558,54,8,62,0,inf
21559,59,7,66,0,inf
21560,51,7,58,0,inf
21561,50,8,58,0,inf
21562,58,11,69,0,inf
21563,67,9,76,0,inf
21564,54,9,63,0,inf
21565,58,10,68,0,inf
21566,51,11,62,0,inf
21567,58,5,63,0,inf
21568,57,5,62,1,0.4352351125433813
21569,67,6,73,0,inf
21570,66,10,76,0,inf
21571,50,7,57,0,inf
21572,50,11,61,0,inf
21573,52,5,57,0,inf
21574,56,11,67,0,inf
21575,65,9,74,0,inf
21576,59,12,71,0,inf
21577,66,7,73,0,inf
21578,62,11,73,0,inf
21579,67,7,74,0,inf
21580,62,12,74,0,inf
21581,59,5,64,0,inf
21582,52,13,65,0,inf
21583,65,5,70,0,inf
21584,54,11,65,0,inf
21585,61,9,70,0,inf
21586,54,8,62,0,inf
21587,54,5,59,0,inf
21588,64,10,74,0,inf
21589,54,11,65,0,inf
21590,58,8,66,0,inf
21591,53,11,64,0,inf
21592,60,8,68,0,inf
21593,58,8,66,0,inf
21594,54,9,63,0,inf
21595,57,13,70,0,inf
21596,67,11,78,0,inf
21597,59,5,64,0,inf
21598,63,10,73,0,inf
21599,51,12,63,0,inf
21600,56,9,65,0,inf
21601,62,12,74,0,inf
21602,52,9,61,0,inf
21603,58,7,65,0,inf
21604,64,9,73,0,inf
21605,63,7,70,0,inf
21606,59,13,72,0,inf
21607,61,13,74,0,inf
21608,51,8,59,0,inf
21609,64,5,69,0,inf
21610,51,7,58,0,inf
21611,55,9,64,0,inf
21612,65,12,77,0,inf
21613,51,13,64,0,inf
21614,63,7,70,0,inf
21615,63,10,73,0,inf
21616,60,5,65,0,inf
21617,57,8,65,0,inf
21618,62,7,69,0,inf
21619,66,9,75,0,inf
21620,50,12,62,0,inf
21621,58,13,71,0,inf
21622,56,12,68,0,inf
21623,56,8,64,0,inf
21624,53,7,60,0,inf
21625,55,9,64,0,inf
21626,64,8,72,0,inf
21627,52,12,64,0,inf
21628,62,9,71,0,inf
21629,51,10,61,0,inf
21630,64,11,75,0,inf
21631,67,6,73,0,inf
21632,64,7,71,0,inf
21633,50,13,63,0,inf
21634,59,11,70,0,inf
21635,63,5,68,0,inf
21636,62,7,69,1,6.843566200400346
21637,61,5,66,0,inf
21638,50,8,58,0,inf
21639,64,13,77,1,6.40069783553848
21640,52,8,60,0,inf
21641,62,13,75,0,inf
21642,66,13,79,0,inf
21643,65,12,77,0,inf
21644,52,11,63,0,inf
21645,64,7,71,0,inf
21646,64,5,69,0,inf
21647,65,9,74,0,inf
21648,63,10,73,0,inf
21649,63,9,72,0,inf
21650,67,10,77,0,inf
21651,58,12,70,0,inf
21652,61,6,67,0,inf
21653,61,13,74,0,inf
21654,51,8,59,0,inf
21655,61,8,69,0,inf
21656,51,12,63,0,inf
21657,51,12,63,0,inf
21658,62,9,71,0,inf
21659,65,5,70,0,inf
21660,67,5,72,0,inf
21661,52,7,59,0,inf
21662,62,11,73,0,inf
21663,54,6,60,0,inf
21664,55,6,61,0,inf
21665,59,9,68,0,inf
21666,64,9,73,0,inf
21667,64,13,77,0,inf
21668,56,10,66,0,inf
21669,50,11,61,0,inf
21670,57,9,66,0,inf
21671,66,8,74,0,inf
21672,59,5,64,0,inf
21673,51,9,60,0,inf
21674,54,13,67,0,inf
21675,64,5,69,0,inf
21676,64,11,75,0,inf
21677,66,9,75,0,inf
21678,54,8,62,0,inf
21679,53,9,62,0,inf
21680,55,6,61,0,inf
21681,56,8,64,0,inf
21682,59,11,70,0,inf
21683,58,12,70,0,inf
21684,63,6,69,0,inf
21685,60,12,72,0,inf
21686,62,8,70,0,inf
21687,56,6,62,0,inf
21688,65,11,76,0,inf
21689,60,6,66,0,inf
21690,63,5,68,0,inf
21691,57,13,70,0,inf
21692,53,10,63,0,inf
21693,59,11,70,0,inf
21694,66,11,77,0,inf
21695,59,10,69,0,inf
21696,65,11,76,0,inf
21697,54,12,66,0,inf
21698,54,7,61,0,inf
21699,60,11,71,1,0.7817824100520525
21700,54,12,66,0,inf
21701,62,11,73,0,inf
21702,56,6,62,0,inf
21703,50,13,63,0,inf
21704,50,5,55,0,inf
21705,66,9,75,1,3.088554844387076
21706,63,8,71,1,3.4931669211185863
21707,55,8,63,0,inf
21708,50,7,57,0,inf
21709,50,9,59,0,inf
21710,51,10,61,0,inf
21711,53,8,61,0,inf
21712,52,6,58,0,inf
21713,64,5,69,0,inf
21714,53,12,65,0,inf
21715,54,9,63,0,inf
21716,66,7,73,0,inf
21717,65,8,73,0,inf
21718,61,7,68,0,inf
21719,54,10,64,0,inf
21720,55,6,61,1,3.6938652490784563
21721,52,8,60,0,inf
21722,62,11,73,0,inf
21723,66,6,72,0,inf
21724,63,12,75,0,inf
21725,64,5,69,0,inf
21726,50,11,61,0,inf
21727,58,8,66,0,inf
21728,54,13,67,0,inf
21729,61,10,71,0,inf
21730,61,6,67,1,0.22569491056767532
21731,58,12,70,0,inf
21732,59,11,70,0,inf
21733,56,12,68,0,inf
21734,61,10,71,0,inf
21735,66,12,78,1,3.856917015921894
21736,56,6,62,0,inf
21737,52,7,59,0,inf
21738,58,5,63,0,inf
21739,52,11,63,0,inf
21740,54,7,61,0,inf
21741,51,12,63,0,inf
21742,65,6,71,0,inf
21743,67,11,78,0,inf
21744,63,11,74,0,inf
21745,52,5,57,0,inf
21746,54,11,65,0,inf
21747,54,6,60,0,inf
21748,56,12,68,0,inf
21749,67,5,72,0,inf
21750,58,5,63,0,inf
21751,66,6,72,0,inf
21752,64,8,72,0,inf
21753,50,5,55,0,inf
21754,60,7,67,0,inf
21755,65,6,71,0,inf
21756,61,12,73,0,inf
21757,52,13,65,0,inf
21758,67,8,75,0,inf
21759,63,5,68,0,inf
21760,60,5,65,0,inf
21761,61,9,70,0,inf
21762,51,12,63,0,inf
21763,65,9,74,0,inf
21764,65,10,75,0,inf
21765,50,11,61,0,inf
21766,52,5,57,0,inf
21767,61,6,67,0,inf
21768,53,9,62,0,inf
21769,55,9,64,0,inf
21770,50,7,57,0,inf
21771,52,5,57,0,inf
21772,59,12,71,0,inf
21773,57,7,64,0,inf
21774,54,10,64,0,inf
21775,60,9,69,0,inf
21776,58,7,65,0,inf
21777,61,6,67,0,inf
21778,59,5,64,0,inf
21779,65,6,71,0,inf
21780,56,9,65,0,inf
21781,59,9,68,0,inf
21782,65,12,77,0,inf
21783,58,13,71,0,inf
21784,62,12,74,0,inf
21785,67,6,73,0,inf
21786,56,6,62,0,inf
21787,61,7,68,0,inf
21788,63,5,68,0,inf
21789,54,13,67,0,inf
21790,63,9,72,0,inf
21791,58,8,66,0,inf
21792,66,7,73,0,inf
21793,61,10,71,0,inf
21794,51,5,56,0,inf
21795,66,13,79,0,inf
21796,64,10,74,0,inf
21797,50,9,59,1,3.7723767485984325
21798,65,10,75,0,inf
21799,52,6,58,0,inf
21800,53,10,63,0,inf
21801,52,6,58,0,inf
21802,58,13,71,0,inf
21803,50,8,58,0,inf
21804,56,6,62,0,inf
21805,52,10,62,0,inf
21806,54,6,60,0,inf
21807,52,11,63,0,inf
21808,50,7,57,0,inf
21809,52,11,63,0,inf
21810,59,8,67,0,inf
21811,63,7,70,0,inf
21812,54,8,62,0,inf
21813,56,7,63,0,inf
21814,58,7,65,0,inf
21815,62,13,75,0,inf
21816,54,12,66,0,inf
21817,50,11,61,0,inf
21818,59,9,68,0,inf
21819,67,10,77,0,inf
21820,62,13,75,0,inf
21821,55,12,67,0,inf
21822,60,13,73,0,inf
21823,53,12,65,0,inf
21824,58,11,69,0,inf
21825,56,8,64,0,inf
21826,64,5,69,0,inf
21827,64,10,74,0,inf
21828,51,7,58,0,inf
21829,64,8,72,0,inf
21830,65,7,72,0,inf
21831,63,8,71,0,inf
21832,63,8,71,0,inf
21833,52,9,61,0,inf
21834,62,6,68,0,inf
21835,50,12,62,0,inf
21836,59,11,70,0,inf
21837,61,10,71,0,inf
21838,67,13,80,0,inf
21839,50,7,57,0,inf
21840,56,10,66,0,inf
21841,50,5,55,0,inf
21842,60,6,66,0,inf
21843,67,10,77,0,inf
21844,66,11,77,0,inf
21845,64,13,77,0,inf
21846,60,6,66,0,inf
21847,56,11,67,0,inf
21848,54,11,65,0,inf
21849,66,7,73,0,inf
21850,53,12,65,0,inf
21851,55,9,64,0,inf
21852,60,7,67,0,inf
21853,65,5,70,0,inf
21854,66,12,78,0,inf
21855,59,12,71,0,inf
21856,64,13,77,0,inf
21857,60,12,72,1,8.52140084340732
21858,50,12,62,0,inf
21859,66,5,71,0,inf
21860,60,11,71,0,inf
21861,62,7,69,0,inf
21862,52,6,58,0,inf
21863,64,10,74,0,inf
21864,60,10,70,0,inf
21865,60,7,67,0,inf
21866,50,6,56,0,inf
21867,54,5,59,0,inf
21868,50,11,61,0,inf
21869,55,12,67,0,inf
21870,61,12,73,0,inf
21871,54,13,67,0,inf
21872,51,8,59,1,2.265990733257226
21873,67,9,76,0,inf
21874,56,7,63,0,inf
21875,65,13,78,0,inf
21876,55,9,64,0,inf
21877,54,5,59,0,inf
21878,65,9,74,0,inf
21879,57,7,64,0,inf
21880,53,12,65,0,inf
21881,56,12,68,0,inf
21882,57,10,67,0,inf
21883,60,8,68,0,inf
21884,51,11,62,0,inf
21885,61,9,70,0,inf
21886,65,7,72,0,inf
21887,54,8,62,0,inf
21888,52,6,58,0,inf
21889,52,12,64,0,inf
21890,52,9,61,0,inf
21891,55,7,62,0,inf
21892,63,11,74,0,inf
21893,64,11,75,0,inf
21894,58,7,65,0,inf
21895,58,12,70,0,inf
21896,60,11,71,0,inf
21897,57,13,70,0,inf
21898,52,8,60,0,inf
21899,65,6,71,0,inf
21900,55,5,60,0,inf
21901,66,5,71,0,inf
21902,64,10,74,0,inf
21903,54,12,66,0,inf
21904,65,7,72,0,inf
21905,66,5,71,0,inf
21906,57,12,69,0,inf
21907,50,13,63,0,inf
21908,54,9,63,0,inf
21909,54,11,65,0,inf
21910,54,12,66,0,inf
21911,60,13,73,0,inf
21912,51,6,57,0,inf
21913,67,8,75,0,inf
21914,53,9,62,0,inf
21915,52,10,62,1,2.023895997886079
21916,65,7,72,0,inf
21917,59,11,70,0,inf
21918,57,11,68,0,inf
21919,65,5,70,0,inf
21920,65,7,72,0,inf
21921,51,5,56,0,inf
21922,62,10,72,0,inf
21923,50,11,61,1,1.9062613695966846
21924,54,8,62,0,inf
21925,60,13,73,0,inf
21926,56,7,63,0,inf
21927,64,7,71,0,inf
21928,51,10,61,0,inf
21929,63,7,70,0,inf
21930,56,6,62,0,inf
21931,61,10,71,0,inf
21932,64,7,71,0,inf
21933,53,9,62,0,inf
21934,50,5,55,0,inf
21935,65,8,73,0,inf
21936,52,13,65,0,inf
21937,53,11,64,0,inf
21938,60,6,66,0,inf
21939,64,7,71,0,inf
21940,51,12,63,0,inf
21941,57,7,64,0,inf
21942,64,12,76,0,inf
21943,53,7,60,0,inf
21944,62,12,74,0,inf
21945,62,12,74,0,inf
21946,51,12,63,0,inf
21947,51,9,60,0,inf
21948,67,5,72,0,inf
21949,64,9,73,0,inf
21950,52,5,57,0,inf
21951,61,6,67,0,inf
21952,58,12,70,1,5.582195112743072
21953,64,7,71,0,inf
21954,54,9,63,0,inf
21955,56,12,68,0,inf
21956,59,5,64,0,inf
21957,55,8,63,1,1.6083055673478412
21958,51,6,57,0,inf
21959,57,6,63,0,inf
21960,60,7,67,0,inf
21961,59,5,64,0,inf
21962,61,5,66,0,inf
21963,59,5,64,0,inf
21964,67,7,74,0,inf
21965,63,12,75,0,inf
21966,57,13,70,0,inf
21967,62,11,73,0,inf
21968,61,8,69,0,inf
21969,51,8,59,0,inf
21970,52,12,64,0,inf
21971,65,13,78,0,inf
21972,65,7,72,0,inf
21973,59,6,65,0,inf
21974,64,5,69,0,inf
21975,50,10,60,0,inf
21976,53,7,60,0,inf
21977,56,12,68,0,inf
21978,64,9,73,0,inf
21979,63,13,76,0,inf
21980,50,5,55,0,inf
21981,60,8,68,0,inf
21982,58,5,63,0,inf
21983,60,7,67,0,inf
21984,65,12,77,1,2.613317319395236
21985,50,8,58,0,inf
21986,60,5,65,0,inf
21987,60,9,69,0,inf
21988,64,6,70,0,inf
21989,57,13,70,0,inf
21990,53,13,66,0,inf
21991,58,8,66,0,inf
21992,56,10,66,0,inf
21993,50,9,59,0,inf
21994,61,13,74,0,inf
21995,64,8,72,0,inf
21996,65,5,70,0,inf
21997,61,8,69,0,inf
21998,51,13,64,0,inf
21999,59,8,67,0,inf
22000,66,5,71,0,inf
22001,67,13,80,0,inf
22002,64,5,69,0,inf
22003,57,7,64,0,inf
22004,65,9,74,0,inf
22005,55,9,64,0,inf
22006,63,13,76,0,inf
22007,64,7,71,0,inf
22008,53,6,59,0,inf
22009,66,13,79,0,inf
22010,64,6,70,0,inf
22011,50,7,57,0,inf
22012,58,13,71,0,inf
22013,54,9,63,0,inf
22014,66,7,73,0,inf
22015,55,11,66,0,inf
22016,56,9,65,0,inf
22017,60,12,72,1,9.789376318307404
22018,64,11,75,0,inf
22019,64,13,77,0,inf
22020,54,7,61,0,inf
22021,60,13,73,0,inf
22022,54,5,59,0,inf
22023,63,12,75,0,inf
22024,50,7,57,0,inf
22025,64,12,76,1,10.72043501849545
22026,57,5,62,0,inf
22027,64,8,72,0,inf
22028,51,6,57,0,inf
22029,59,8,67,0,inf
22030,64,8,72,0,inf
22031,63,7,70,0,inf
22032,53,12,65,0,inf
22033,61,6,67,0,inf
22034,50,13,63,0,inf
22035,58,13,71,0,inf
22036,52,9,61,0,inf
22037,58,9,67,0,inf
22038,61,5,66,0,inf
22039,60,12,72,0,inf
22040,52,8,60,0,inf
22041,59,9,68,0,inf
22042,59,12,71,0,inf
22043,53,8,61,0,inf
22044,65,12,77,0,inf
22045,64,6,70,0,inf
22046,57,8,65,0,inf
22047,60,8,68,0,inf
22048,51,9,60,0,inf
22049,65,11,76,0,inf
22050,56,7,63,0,inf
22051,63,10,73,0,inf
22052,58,12,70,0,inf
22053,66,7,73,1,4.936323060077683
22054,57,7,64,0,inf
22055,59,11,70,0,inf
22056,66,9,75,0,inf
22057,66,12,78,0,inf
22058,56,6,62,0,inf
22059,67,12,79,0,inf
22060,56,10,66,0,inf
22061,52,11,63,0,inf
22062,64,11,75,0,inf
22063,67,13,80,0,inf
22064,63,10,73,0,inf
22065,51,13,64,0,inf
22066,64,11,75,1,5.49431242301327
22067,55,8,63,0,inf
22068,54,9,63,0,inf
22069,67,7,74,0,inf
22070,60,8,68,0,inf
22071,50,10,60,1,4.758908972109175
22072,61,9,70,0,inf
22073,55,12,67,0,inf
22074,60,11,71,0,inf
22075,57,6,63,0,inf
22076,63,6,69,0,inf
22077,67,8,75,0,inf
22078,52,6,58,0,inf
22079,67,5,72,0,inf
22080,60,7,67,0,inf
22081,63,10,73,0,inf
22082,52,7,59,0,inf
22083,52,6,58,0,inf
22084,63,8,71,0,inf
22085,51,5,56,0,inf
22086,62,12,74,0,inf
22087,56,9,65,0,inf
22088,50,6,56,0,inf
22089,63,7,70,0,inf
22090,52,6,58,0,inf
22091,62,7,69,0,inf
22092,67,5,72,0,inf
22093,67,9,76,0,inf
22094,58,10,68,0,inf
22095,62,9,71,0,inf
22096,58,11,69,0,inf
22097,61,9,70,0,inf
22098,53,13,66,0,inf
22099,56,5,61,0,inf
22100,59,6,65,0,inf
22101,59,12,71,0,inf
22102,53,13,66,0,inf
22103,65,13,78,1,9.300689637189691
22104,67,6,73,0,inf
22105,57,5,62,0,inf
22106,57,5,62,0,inf
22107,54,10,64,0,inf
22108,59,8,67,0,inf
22109,57,7,64,0,inf
22110,65,10,75,0,inf
22111,58,8,66,0,inf
22112,53,7,60,0,inf
22113,66,12,78,0,inf
22114,52,9,61,0,inf
22115,55,7,62,0,inf
22116,66,12,78,0,inf
22117,65,9,74,0,inf
22118,63,10,73,0,inf
22119,53,8,61,0,inf
22120,54,7,61,0,inf
22121,62,10,72,0,inf
22122,54,13,67,0,inf
22123,51,13,64,0,inf
22124,58,12,70,0,inf
22125,59,9,68,0,inf
22126,65,12,77,0,inf
22127,62,9,71,0,inf
22128,62,11,73,0,inf
22129,66,13,79,0,inf
22130,67,6,73,0,inf
22131,58,9,67,0,inf
22132,67,12,79,0,inf
22133,57,13,70,0,inf
22134,55,9,64,0,inf
22135,56,11,67,0,inf
22136,65,11,76,0,inf
22137,59,12,71,0,inf
22138,61,5,66,0,inf
22139,62,11,73,0,inf
22140,59,6,65,0,inf
22141,56,13,69,0,inf
22142,50,9,59,0,inf
22143,59,11,70,0,inf
22144,59,13,72,0,inf
22145,60,6,66,0,inf
22146,62,7,69,0,inf
22147,59,11,70,0,inf
22148,50,6,56,0,inf
22149,57,10,67,0,inf
22150,58,13,71,0,inf
22151,52,12,64,0,inf
22152,54,8,62,0,inf
22153,51,11,62,0,inf
22154,50,9,59,0,inf
22155,57,7,64,0,inf
22156,55,11,66,0,inf
22157,58,6,64,0,inf
22158,57,13,70,0,inf
22159,59,8,67,0,inf
22160,66,11,77,0,inf
22161,66,11,77,0,inf
22162,65,6,71,0,inf
22163,53,8,61,0,inf
22164,59,12,71,0,inf
22165,60,5,65,0,inf
22166,53,11,64,0,inf
22167,56,5,61,0,inf
22168,54,7,61,0,inf
22169,59,10,69,0,inf
22170,60,10,70,0,inf
22171,67,8,75,0,inf
22172,65,10,75,0,inf
22173,50,13,63,0,inf
22174,57,10,67,0,inf
22175,62,8,70,0,inf
22176,56,6,62,0,inf
22177,53,11,64,0,inf
22178,55,8,63,0,inf
22179,64,9,73,0,inf
22180,51,13,64,0,inf
22181,54,9,63,0,inf
22182,53,11,64,0,inf
22183,62,8,70,0,inf
22184,56,6,62,0,inf
22185,65,12,77,0,inf
22186,55,6,61,0,inf
22187,61,8,69,0,inf
22188,66,11,77,0,inf
22189,52,11,63,0,inf
22190,58,5,63,0,inf
22191,50,6,56,0,inf
22192,62,7,69,0,inf
22193,59,5,64,0,inf
22194,63,10,73,0,inf
22195,58,5,63,0,inf
22196,57,5,62,0,inf
22197,56,10,66,0,inf
22198,62,6,68,0,inf
22199,56,6,62,0,inf
22200,58,6,64,0,inf
22201,57,13,70,0,inf
22202,61,8,69,0,inf
22203,67,5,72,0,inf
22204,61,10,71,0,inf
22205,52,9,61,0,inf
22206,56,8,64,0,inf
22207,50,8,58,0,inf
22208,57,9,66,0,inf
22209,60,9,69,0,inf
22210,61,7,68,0,inf
22211,66,9,75,0,inf
22212,66,6,72,0,inf
22213,54,13,67,0,inf
22214,55,12,67,0,inf
22215,61,8,69,0,inf
22216,54,8,62,0,inf
22217,62,9,71,1,5.549014137301853
22218,55,7,62,0,inf
22219,65,5,70,0,inf
22220,57,5,62,0,inf
22221,67,10,77,0,inf
22222,58,6,64,0,inf
22223,53,10,63,1,4.4497226553381495
22224,62,6,68,0,inf
22225,62,6,68,0,inf
22226,59,11,70,0,inf
22227,54,9,63,0,inf
22228,61,13,74,0,inf
22229,57,13,70,0,inf
22230,53,10,63,0,inf
22231,57,5,62,0,inf
22232,66,11,77,0,inf
22233,58,8,66,0,inf
22234,52,8,60,0,inf
22235,64,11,75,0,inf
22236,54,11,65,0,inf
22237,66,6,72,0,inf
22238,58,13,71,0,inf
22239,51,10,61,0,inf
22240,61,10,71,0,inf
22241,57,5,62,0,inf
22242,61,12,73,0,inf
22243,58,12,70,0,inf
22244,62,5,67,0,inf
22245,55,5,60,0,inf
22246,60,11,71,0,inf
22247,52,7,59,0,inf
22248,53,10,63,0,inf
22249,59,9,68,0,inf
22250,67,13,80,0,inf
22251,65,10,75,0,inf
22252,53,9,62,0,inf
22253,57,7,64,0,inf
22254,60,9,69,0,inf
22255,59,13,72,0,inf
22256,56,8,64,0,inf
22257,60,7,67,0,inf
22258,57,6,63,0,inf
22259,55,12,67,0,inf
22260,60,13,73,0,inf
22261,62,9,71,0,inf
22262,50,5,55,1,2.862136535602133
22263,66,9,75,0,inf
22264,52,7,59,0,inf
22265,56,6,62,0,inf
22266,59,10,69,0,inf
22267,50,7,57,0,inf
22268,66,13,79,0,inf
22269,50,7,57,0,inf
22270,67,13,80,0,inf
22271,62,6,68,0,inf
22272,66,7,73,1,0.94711988624978
22273,65,11,76,0,inf
22274,58,5,63,0,inf
22275,53,5,58,0,inf
22276,62,11,73,0,inf
22277,63,7,70,0,inf
22278,58,7,65,0,inf
22279,61,6,67,0,inf
22280,51,7,58,0,inf
22281,60,6,66,0,inf
22282,55,5,60,0,inf
22283,59,8,67,0,inf
22284,50,13,63,0,inf
22285,51,9,60,0,inf
22286,60,6,66,0,inf
22287,50,9,59,0,inf
22288,65,6,71,0,inf
22289,56,13,69,0,inf
22290,52,11,63,0,inf
22291,50,7,57,0,inf
22292,51,9,60,0,inf
22293,66,13,79,0,inf
22294,58,11,69,0,inf
22295,62,9,71,0,inf
22296,66,11,77,0,inf
22297,67,13,80,0,inf
22298,52,7,59,0,inf
22299,65,13,78,0,inf
22300,51,13,64,0,inf
22301,63,10,73,0,inf
22302,55,6,61,0,inf
22303,61,6,67,0,inf
22304,60,7,67,0,inf
22305,67,13,80,1,6.309419753025367
22306,56,7,63,0,inf
22307,60,11,71,0,inf
22308,60,8,68,0,inf
22309,54,10,64,0,inf
22310,55,8,63,0,inf
22311,53,13,66,0,inf
22312,55,13,68,0,inf
22313,50,11,61,0,inf
22314,51,9,60,0,inf
22315,59,13,72,0,inf
22316,56,10,66,0,inf
22317,50,11,61,0,inf
22318,66,11,77,0,inf
22319,59,10,69,0,inf
22320,55,7,62,0,inf
22321,62,7,69,0,inf
22322,56,12,68,0,inf
22323,59,6,65,0,inf
22324,59,13,72,0,inf
22325,51,5,56,0,inf
22326,52,12,64,0,inf
22327,66,8,74,0,inf
22328,58,8,66,0,inf
22329,53,5,58,0,inf
22330,61,12,73,0,inf
22331,51,13,64,1,6.869678135298258
22332,53,11,64,0,inf
22333,64,7,71,0,inf
22334,64,13,77,0,inf
22335,66,8,74,0,inf
22336,50,8,58,0,inf
22337,61,5,66,0,inf
22338,62,11,73,0,inf
22339,64,8,72,0,inf
22340,58,7,65,0,inf
22341,66,13,79,0,inf
22342,62,5,67,0,inf
22343,53,9,62,0,inf
22344,59,7,66,0,inf
22345,62,8,70,0,inf
22346,57,7,64,0,inf
22347,62,8,70,0,inf
22348,50,5,55,0,inf
22349,54,6,60,0,inf
22350,63,11,74,0,inf
22351,53,9,62,0,inf
22352,54,11,65,0,inf
22353,56,11,67,0,inf
22354,58,6,64,0,inf
22355,58,5,63,0,inf
22356,61,8,69,0,inf
22357,61,12,73,0,inf
22358,64,11,75,0,inf
22359,51,10,61,0,inf
22360,62,6,68,1,0.742665112437848
22361,50,8,58,0,inf
22362,62,13,75,1,12.675635460810383
22363,65,8,73,0,inf
22364,64,7,71,0,inf
22365,55,5,60,0,inf
22366,60,10,70,0,inf
22367,59,6,65,0,inf
22368,52,9,61,0,inf
22369,67,6,73,0,inf
22370,59,13,72,0,inf
22371,52,8,60,0,inf
22372,60,5,65,0,inf
22373,61,9,70,0,inf
22374,67,7,74,0,inf
22375,56,13,69,0,inf
22376,50,6,56,0,inf
22377,57,6,63,0,inf
22378,50,12,62,0,inf
22379,55,7,62,0,inf
22380,66,5,71,0,inf
22381,54,5,59,0,inf
22382,67,8,75,0,inf
22383,61,5,66,0,inf
22384,62,10,72,0,inf
22385,58,8,66,0,inf
22386,51,8,59,0,inf
22387,53,5,58,0,inf
22388,57,6,63,0,inf
22389,58,6,64,0,inf
22390,59,5,64,0,inf
22391,56,8,64,0,inf
22392,59,8,67,0,inf
22393,58,12,70,0,inf
22394,52,7,59,0,inf
22395,51,12,63,0,inf
22396,55,10,65,0,inf
22397,54,5,59,0,inf
22398,64,9,73,0,inf
22399,60,12,72,0,inf
22400,56,9,65,0,inf
22401,56,9,65,0,inf
22402,55,12,67,0,inf
22403,59,8,67,0,inf
22404,61,6,67,0,inf
22405,59,8,67,0,inf
22406,66,9,75,0,inf
22407,51,7,58,0,inf
22408,57,8,65,0,inf
22409,60,8,68,0,inf
22410,61,11,72,0,inf
22411,57,8,65,0,inf
22412,57,6,63,0,inf
22413,67,6,73,0,inf
22414,52,6,58,0,inf
22415,61,12,73,0,inf
22416,64,10,74,0,inf
22417,55,10,65,0,inf
22418,57,9,66,0,inf
22419,65,10,75,0,inf
22420,62,5,67,0,inf
22421,54,11,65,0,inf
22422,52,10,62,0,inf
22423,52,8,60,0,inf
22424,58,6,64,0,inf
22425,58,13,71,0,inf
22426,61,12,73,0,inf
22427,50,10,60,0,inf
22428,56,5,61,0,inf
22429,59,6,65,0,inf
22430,64,12,76,0,inf
22431,64,11,75,1,8.035832267513698
22432,66,9,75,0,inf
22433,58,12,70,0,inf
22434,57,6,63,0,inf
22435,50,8,58,0,inf
22436,53,6,59,0,inf
22437,67,11,78,0,inf
22438,63,11,74,0,inf
22439,54,9,63,0,inf
22440,59,10,69,0,inf
22441,60,8,68,0,inf
22442,65,7,72,1,5.6736801813685105
22443,61,6,67,0,inf
22444,59,10,69,0,inf
22445,55,5,60,0,inf
22446,52,10,62,0,inf
22447,62,10,72,0,inf
22448,54,9,63,0,inf
22449,64,11,75,0,inf
22450,64,10,74,0,inf
22451,64,12,76,1,3.3305769949169246
22452,63,6,69,0,inf
22453,54,13,67,0,inf
22454,52,5,57,0,inf
22455,54,12,66,0,inf
22456,67,13,80,0,inf
22457,57,10,67,0,inf
22458,51,8,59,0,inf
22459,63,6,69,0,inf
22460,57,9,66,0,inf
22461,51,7,58,0,inf
22462,66,7,73,0,inf
22463,66,6,72,0,inf
22464,62,9,71,0,inf
22465,53,9,62,0,inf
22466,55,7,62,0,inf
22467,64,12,76,0,inf
22468,50,8,58,0,inf
22469,61,10,71,0,inf
22470,64,11,75,0,inf
22471,55,8,63,0,inf
22472,60,10,70,0,inf
22473,59,12,71,0,inf
22474,53,12,65,0,inf
22475,57,13,70,0,inf
22476,56,12,68,0,inf
22477,63,7,70,0,inf
22478,65,8,73,0,inf
22479,64,13,77,0,inf
22480,58,11,69,0,inf
22481,61,8,69,0,inf
22482,56,13,69,0,inf
22483,51,10,61,0,inf
22484,60,7,67,0,inf
22485,59,7,66,0,inf
22486,61,8,69,1,6.442863341583518
22487,63,6,69,0,inf
22488,57,8,65,0,inf
22489,50,5,55,0,inf
22490,55,8,63,0,inf
22491,63,9,72,0,inf
22492,56,9,65,0,inf
22493,55,5,60,0,inf
22494,64,7,71,0,inf
22495,52,6,58,0,inf
22496,60,8,68,0,inf
22497,67,6,73,0,inf
22498,64,6,70,0,inf
22499,67,10,77,0,inf
22500,52,8,60,0,inf
22501,55,7,62,0,inf
22502,66,7,73,0,inf
22503,57,7,64,0,inf
22504,56,11,67,0,inf
22505,53,7,60,1,4.766727525810481
22506,59,8,67,0,inf
22507,67,5,72,0,inf
22508,63,8,71,0,inf
22509,67,5,72,0,inf
22510,54,6,60,0,inf
22511,54,9,63,0,inf
22512,66,6,72,0,inf
22513,58,13,71,0,inf
22514,59,9,68,0,inf
22515,58,7,65,0,inf
22516,58,8,66,0,inf
22517,58,8,66,0,inf
22518,59,11,70,0,inf
22519,61,6,67,0,inf
22520,54,11,65,0,inf
22521,54,10,64,0,inf
22522,61,7,68,0,inf
22523,62,13,75,0,inf
22524,60,8,68,0,inf
22525,67,7,74,0,inf
22526,61,13,74,0,inf
22527,52,10,62,0,inf
22528,51,11,62,0,inf
22529,53,12,65,0,inf
22530,52,11,63,0,inf
22531,53,12,65,0,inf
22532,53,8,61,0,inf
22533,65,6,71,0,inf
22534,61,10,71,0,inf
22535,55,8,63,0,inf
22536,60,8,68,0,inf
22537,66,6,72,0,inf
22538,51,10,61,0,inf
22539,50,13,63,0,inf
22540,58,5,63,0,inf
22541,62,5,67,0,inf
22542,63,8,71,0,inf
22543,59,7,66,0,inf
22544,61,8,69,0,inf
22545,57,9,66,0,inf
22546,66,6,72,0,inf
22547,66,11,77,0,inf
22548,51,10,61,0,inf
22549,64,10,74,0,inf
22550,59,10,69,0,inf
22551,59,5,64,0,inf
22552,63,13,76,0,inf
22553,62,6,68,0,inf
22554,66,7,73,0,inf
22555,63,12,75,0,inf
22556,51,7,58,0,inf
22557,57,6,63,0,inf
22558,67,6,73,0,inf
22559,62,5,67,0,inf
22560,62,6,68,0,inf
22561,53,12,65,0,inf
22562,53,11,64,0,inf
22563,52,13,65,0,inf
22564,66,8,74,0,inf
22565,61,10,71,0,inf
22566,66,8,74,0,inf
22567,65,13,78,0,inf
22568,54,10,64,0,inf
22569,66,7,73,0,inf
22570,57,13,70,0,inf
22571,57,10,67,0,inf
22572,63,10,73,0,inf
22573,56,7,63,0,inf
22574,59,9,68,0,inf
22575,61,11,72,0,inf
22576,60,7,67,0,inf
22577,52,12,64,0,inf
22578,58,6,64,0,inf
22579,62,5,67,0,inf
22580,64,8,72,0,inf
22581,65,9,74,0,inf
22582,57,10,67,0,inf
22583,50,8,58,0,inf
22584,52,6,58,0,inf
22585,53,5,58,0,inf
22586,58,8,66,0,inf
22587,58,10,68,0,inf
22588,57,7,64,0,inf
22589,63,7,70,0,inf
22590,62,5,67,1,2.966825461204337
22591,62,10,72,0,inf
22592,65,7,72,0,inf
22593,62,13,75,0,inf
22594,64,7,71,0,inf
22595,52,11,63,0,inf
22596,61,9,70,0,inf
22597,61,10,71,0,inf
22598,55,13,68,0,inf
22599,65,10,75,0,inf
22600,53,9,62,0,inf
22601,59,7,66,0,inf
22602,53,8,61,0,inf
22603,55,10,65,0,inf
22604,53,10,63,0,inf
22605,60,13,73,0,inf
22606,59,6,65,0,inf
22607,59,7,66,0,inf
22608,67,6,73,0,inf
22609,55,13,68,0,inf
22610,58,13,71,0,inf
22611,62,13,75,0,inf
22612,66,8,74,0,inf
22613,53,6,59,0,inf
22614,57,10,67,0,inf
22615,56,7,63,0,inf
22616,64,12,76,0,inf
22617,62,12,74,0,inf
22618,55,7,62,0,inf
22619,54,11,65,0,inf
22620,64,11,75,0,inf
22621,54,6,60,0,inf
22622,60,13,73,0,inf
22623,57,7,64,0,inf
22624,50,7,57,0,inf
22625,63,5,68,0,inf
22626,65,5,70,0,inf
22627,65,13,78,0,inf
22628,62,8,70,0,inf
22629,52,5,57,0,inf
22630,66,11,77,0,inf
22631,67,11,78,1,7.9075313884754195
22632,64,13,77,0,inf
22633,66,12,78,1,6.95218679551995
22634,65,8,73,0,inf
22635,64,8,72,0,inf
22636,57,12,69,0,inf
22637,50,9,59,0,inf
22638,54,8,62,0,inf
22639,51,11,62,0,inf
22640,63,6,69,0,inf
22641,63,9,72,0,inf
22642,53,13,66,0,inf
22643,60,9,69,0,inf
22644,57,11,68,0,inf
22645,52,7,59,0,inf
22646,54,11,65,0,inf
22647,51,8,59,0,inf
22648,67,10,77,0,inf
22649,67,12,79,0,inf
22650,59,8,67,0,inf
22651,58,10,68,0,inf
22652,60,11,71,0,inf
22653,63,13,76,0,inf
22654,57,13,70,0,inf
22655,66,9,75,0,inf
22656,60,13,73,0,inf
22657,53,6,59,1,3.5628897636357166
22658,62,5,67,0,inf
22659,63,11,74,1,8.128663251792034
22660,66,12,78,0,inf
22661,63,7,70,0,inf
22662,56,11,67,0,inf
22663,60,5,65,0,inf
22664,58,7,65,0,inf
22665,53,5,58,0,inf
22666,58,12,70,0,inf
22667,60,10,70,0,inf
22668,66,9,75,0,inf
22669,53,12,65,0,inf
22670,59,7,66,0,inf
22671,58,5,63,0,inf
22672,53,7,60,0,inf
22673,54,10,64,0,inf
22674,54,12,66,0,inf
22675,60,7,67,0,inf
22676,67,13,80,0,inf
22677,59,9,68,0,inf
22678,54,6,60,0,inf
22679,65,12,77,0,inf
22680,60,13,73,1,10.280900068225193
22681,52,6,58,0,inf
22682,55,5,60,0,inf
22683,62,10,72,0,inf
22684,61,9,70,0,inf
22685,57,8,65,0,inf
22686,62,11,73,0,inf
22687,51,9,60,0,inf
22688,63,13,76,0,inf
22689,63,8,71,0,inf
22690,67,6,73,0,inf
22691,51,10,61,0,inf
22692,67,8,75,0,inf
22693,62,10,72,0,inf
22694,66,5,71,0,inf
22695,64,5,69,0,inf
22696,59,13,72,0,inf
22697,60,11,71,0,inf
22698,64,12,76,0,inf
22699,51,7,58,0,inf
22700,51,9,60,0,inf
22701,60,6,66,0,inf
22702,50,6,56,0,inf
22703,51,5,56,0,inf
22704,64,5,69,0,inf
22705,63,12,75,0,inf
22706,53,7,60,0,inf
22707,66,9,75,0,inf
22708,59,10,69,0,inf
22709,55,6,61,0,inf
22710,61,5,66,0,inf
22711,61,7,68,0,inf
22712,65,6,71,0,inf
22713,56,7,63,0,inf
22714,52,12,64,0,inf
22715,59,11,70,0,inf
22716,57,7,64,0,inf
22717,57,8,65,0,inf
22718,62,5,67,0,inf
22719,59,12,71,0,inf
22720,65,8,73,0,inf
22721,64,5,69,0,inf
22722,67,6,73,0,inf
22723,67,7,74,0,inf
22724,62,8,70,0,inf
22725,62,12,74,0,inf
22726,64,6,70,0,inf
22727,64,13,77,0,inf
22728,52,5,57,0,inf
22729,50,13,63,0,inf
22730,62,9,71,1,2.440201091265237
22731,64,5,69,0,inf
22732,59,7,66,0,inf
22733,57,5,62,0,inf
22734,59,8,67,0,inf
22735,52,11,63,0,inf
22736,65,6,71,0,inf
22737,51,7,58,0,inf
22738,53,12,65,0,inf
22739,59,11,70,0,inf
22740,61,12,73,1,8.103147456526855
22741,51,11,62,0,inf
22742,59,6,65,0,inf
22743,61,6,67,0,inf
22744,56,10,66,0,inf
22745,64,10,74,0,inf
22746,62,6,68,0,inf
22747,60,6,66,0,inf
22748,54,13,67,0,inf
22749,54,12,66,0,inf
22750,63,13,76,0,inf
22751,54,10,64,0,inf
22752,66,5,71,0,inf
22753,53,8,61,0,inf
22754,60,11,71,0,inf
22755,67,6,73,0,inf
22756,58,12,70,0,inf
22757,50,13,63,0,inf
22758,61,9,70,0,inf
22759,54,10,64,0,inf
22760,63,12,75,0,inf
22761,51,5,56,1,2.538984474849414
22762,67,9,76,0,inf
22763,61,7,68,0,inf
22764,61,8,69,0,inf
22765,67,5,72,0,inf
22766,65,11,76,0,inf
22767,50,13,63,0,inf
22768,51,7,58,0,inf
22769,57,8,65,0,inf
22770,56,13,69,0,inf
22771,50,9,59,0,inf
22772,62,10,72,0,inf
22773,64,10,74,0,inf
22774,57,13,70,0,inf
22775,60,8,68,0,inf
22776,65,8,73,1,6.337298922868129
22777,67,7,74,0,inf
22778,58,7,65,1,1.5520952697862285
22779,51,11,62,0,inf
22780,65,8,73,0,inf
22781,57,11,68,0,inf
22782,63,8,71,0,inf
22783,57,12,69,0,inf
22784,51,10,61,1,2.5196733737260573
22785,62,6,68,0,inf
22786,57,12,69,0,inf
22787,64,11,75,0,inf
22788,61,11,72,0,inf
22789,52,11,63,0,inf
22790,55,5,60,0,inf
22791,65,13,78,0,inf
22792,59,7,66,0,inf
22793,60,12,72,0,inf
22794,53,13,66,0,inf
22795,52,13,65,0,inf
22796,62,8,70,0,inf
22797,55,8,63,0,inf
22798,64,9,73,0,inf
22799,60,5,65,0,inf
22800,55,8,63,0,inf
22801,58,13,71,0,inf
22802,63,8,71,0,inf
22803,63,7,70,0,inf
22804,53,11,64,0,inf
22805,61,8,69,0,inf
22806,61,10,71,0,inf
22807,55,11,66,0,inf
22808,67,9,76,0,inf
22809,59,7,66,0,inf
22810,55,7,62,0,inf
22811,62,5,67,0,inf
22812,53,12,65,0,inf
22813,51,7,58,0,inf
22814,62,8,70,0,inf
22815,62,9,71,0,inf
22816,63,7,70,0,inf
22817,64,7,71,0,inf
22818,58,7,65,0,inf
22819,61,5,66,0,inf
22820,66,7,73,0,inf
22821,50,13,63,0,inf
22822,52,8,60,0,inf
22823,63,13,76,0,inf
22824,56,11,67,0,inf
22825,66,9,75,0,inf
22826,52,8,60,0,inf
22827,54,10,64,0,inf
22828,54,11,65,0,inf
22829,53,5,58,0,inf
22830,64,13,77,0,inf
22831,55,7,62,0,inf
22832,54,10,64,0,inf
22833,61,10,71,0,inf
22834,55,10,65,0,inf
22835,63,6,69,0,inf
22836,55,8,63,0,inf
22837,63,10,73,0,inf
22838,52,5,57,0,inf
22839,54,9,63,0,inf
22840,61,7,68,0,inf
22841,64,12,76,0,inf
22842,58,10,68,0,inf
22843,60,8,68,0,inf
22844,58,10,68,0,inf
22845,56,11,67,0,inf
22846,67,11,78,0,inf
22847,51,5,56,0,inf
22848,54,10,64,0,inf
22849,57,9,66,0,inf
22850,59,5,64,0,inf
22851,63,10,73,0,inf
22852,50,9,59,0,inf
22853,67,7,74,0,inf
22854,56,10,66,0,inf
22855,61,6,67,0,inf
22856,67,11,78,0,inf
22857,55,5,60,0,inf
22858,54,9,63,0,inf
22859,58,6,64,0,inf
22860,64,6,70,0,inf
22861,56,6,62,0,inf
22862,59,11,70,0,inf
22863,53,5,58,0,inf
22864,59,10,69,0,inf
22865,55,7,62,0,inf
22866,59,13,72,0,inf
22867,56,7,63,0,inf
22868,66,13,79,0,inf
22869,66,13,79,0,inf
22870,50,5,55,0,inf
22871,61,9,70,0,inf
22872,57,11,68,0,inf
22873,56,13,69,0,inf
22874,53,8,61,0,inf
22875,52,7,59,0,inf
22876,57,12,69,0,inf
22877,56,9,65,0,inf
22878,61,9,70,0,inf
22879,66,6,72,0,inf
22880,51,8,59,0,inf
22881,56,12,68,0,inf
22882,58,11,69,0,inf
22883,56,7,63,0,inf
22884,58,5,63,0,inf
22885,62,10,72,0,inf
22886,60,7,67,0,inf
22887,59,12,71,1,5.751964063444589
22888,61,7,68,0,inf
22889,53,6,59,0,inf
22890,58,12,70,0,inf
22891,55,7,62,0,inf
22892,62,10,72,0,inf
22893,63,9,72,0,inf
22894,50,12,62,1,7.408606201354026
22895,58,9,67,0,inf
22896,65,13,78,0,inf
22897,50,8,58,0,inf
22898,67,11,78,0,inf
22899,52,12,64,0,inf
22900,57,13,70,0,inf
22901,50,13,63,0,inf
22902,56,12,68,0,inf
22903,52,5,57,0,inf
22904,53,10,63,0,inf
22905,58,13,71,0,inf
22906,51,10,61,0,inf
22907,67,9,76,0,inf
22908,54,13,67,0,inf
22909,56,11,67,0,inf
22910,56,8,64,0,inf
22911,66,13,79,0,inf
22912,59,11,70,0,inf
22913,62,5,67,0,inf
22914,56,11,67,0,inf
22915,64,7,71,0,inf
22916,55,5,60,0,inf
22917,53,9,62,0,inf
22918,67,10,77,0,inf
22919,54,8,62,0,inf
22920,52,5,57,0,inf
22921,56,10,66,0,inf
22922,61,11,72,0,inf
22923,61,5,66,0,inf
22924,51,10,61,0,inf
22925,55,9,64,0,inf
22926,50,7,57,0,inf
22927,63,11,74,0,inf
22928,65,9,74,0,inf
22929,56,5,61,0,inf
22930,61,13,74,0,inf
22931,55,13,68,0,inf
22932,57,5,62,0,inf
22933,50,13,63,0,inf
22934,65,13,78,0,inf
22935,65,8,73,0,inf
22936,57,5,62,0,inf
22937,57,7,64,0,inf
22938,55,9,64,0,inf
22939,66,12,78,0,inf
22940,62,8,70,0,inf
22941,61,9,70,0,inf
22942,60,11,71,0,inf
22943,60,12,72,0,inf
22944,57,12,69,0,inf
22945,50,6,56,0,inf
22946,53,7,60,0,inf
22947,55,6,61,0,inf
22948,66,6,72,0,inf
22949,61,12,73,0,inf
22950,66,11,77,0,inf
22951,64,9,73,0,inf
22952,59,12,71,0,inf
22953,52,11,63,0,inf
22954,60,13,73,0,inf
22955,53,7,60,0,inf
22956,54,10,64,0,inf
22957,55,10,65,0,inf
22958,57,10,67,0,inf
22959,58,6,64,0,inf
22960,66,10,76,0,inf
22961,57,5,62,0,inf
22962,56,13,69,0,inf
22963,53,10,63,0,inf
22964,63,8,71,1,2.949336266928711
22965,59,5,64,0,inf
22966,54,8,62,0,inf
22967,64,13,77,0,inf
22968,66,6,72,0,inf
22969,55,10,65,0,inf
22970,64,6,70,0,inf
22971,55,13,68,0,inf
22972,66,12,78,0,inf
22973,63,11,74,0,inf
22974,57,11,68,0,inf
22975,60,6,66,0,inf
22976,57,8,65,0,inf
22977,63,5,68,0,inf
22978,61,9,70,0,inf
22979,50,8,58,0,inf
22980,66,12,78,1,10.282462445266574
22981,55,5,60,0,inf
22982,62,12,74,0,inf
22983,62,12,74,0,inf
22984,57,12,69,0,inf
22985,66,11,77,0,inf
22986,61,13,74,1,1.7109022667061708
22987,51,7,58,0,inf
22988,51,6,57,1,5.752254975249052
22989,59,7,66,0,inf
22990,63,5,68,0,inf
22991,57,6,63,0,inf
22992,59,11,70,0,inf
22993,67,9,76,0,inf
22994,57,5,62,0,inf
22995,54,5,59,1,1.4762101267508925
22996,56,7,63,0,inf
22997,64,8,72,0,inf
22998,50,9,59,0,inf
22999,58,13,71,0,inf
23000,51,6,57,1,1.7191392592006238
23001,65,11,76,1,7.390518188308491
23002,66,6,72,0,inf
23003,67,8,75,0,inf
23004,65,10,75,0,inf
23005,60,5,65,0,inf
23006,53,5,58,0,inf
23007,64,7,71,0,inf
23008,62,10,72,0,inf
23009,63,6,69,0,inf
23010,63,6,69,0,inf
23011,60,9,69,0,inf
23012,64,8,72,0,inf
23013,55,8,63,0,inf
23014,56,8,64,0,inf
23015,56,7,63,0,inf
23016,57,8,65,0,inf
23017,64,8,72,0,inf
23018,50,9,59,0,inf
23019,51,5,56,0,inf
23020,55,12,67,0,inf
23021,62,9,71,0,inf
23022,54,10,64,0,inf
23023,62,13,75,0,inf
23024,59,12,71,0,inf
23025,61,13,74,0,inf
23026,56,10,66,0,inf
23027,65,7,72,0,inf
23028,67,8,75,0,inf
23029,57,13,70,0,inf
23030,55,13,68,0,inf
23031,61,5,66,0,inf
23032,50,12,62,0,inf
23033,66,10,76,0,inf
23034,65,10,75,0,inf
23035,62,13,75,0,inf
23036,64,10,74,0,inf
23037,64,6,70,0,inf
23038,66,7,73,0,inf
23039,65,12,77,0,inf
23040,66,5,71,0,inf
23041,61,7,68,0,inf
23042,64,9,73,0,inf
23043,60,8,68,0,inf
23044,60,11,71,0,inf
23045,67,7,74,0,inf
23046,64,11,75,0,inf
23047,52,12,64,0,inf
23048,63,11,74,0,inf
23049,57,11,68,0,inf
23050,54,6,60,0,inf
23051,52,12,64,0,inf
23052,59,9,68,0,inf
23053,57,11,68,0,inf
23054,52,8,60,1,3.3993287407178414
23055,61,7,68,0,inf
23056,63,12,75,0,inf
23057,56,7,63,0,inf
23058,60,8,68,0,inf
23059,67,6,73,0,inf
23060,61,5,66,1,4.784898575834987
23061,64,13,77,0,inf
23062,62,13,75,0,inf
23063,64,7,71,0,inf
23064,52,10,62,0,inf
23065,61,11,72,0,inf
23066,65,9,74,0,inf
23067,57,13,70,0,inf
23068,50,8,58,0,inf
23069,67,5,72,0,inf
23070,53,12,65,1,7.5173512164763
23071,59,7,66,0,inf
23072,60,13,73,0,inf
23073,63,9,72,0,inf
23074,64,6,70,0,inf
23075,55,7,62,0,inf
23076,59,8,67,0,inf
23077,67,9,76,0,inf
23078,52,8,60,0,inf
23079,58,12,70,0,inf
23080,65,12,77,0,inf
23081,62,13,75,0,inf
23082,66,9,75,0,inf
23083,66,7,73,0,inf
23084,58,8,66,0,inf
23085,58,6,64,0,inf
23086,58,12,70,0,inf
23087,58,13,71,0,inf
23088,59,9,68,0,inf
23089,53,11,64,0,inf
23090,63,5,68,0,inf
23091,58,11,69,0,inf
23092,59,10,69,0,inf
23093,55,11,66,0,inf
23094,50,13,63,0,inf
23095,54,8,62,0,inf
23096,64,7,71,0,inf
23097,62,13,75,0,inf
23098,51,12,63,0,inf
23099,67,12,79,0,inf
23100,59,6,65,0,inf
23101,64,7,71,0,inf
23102,59,5,64,0,inf
23103,56,8,64,0,inf
23104,57,11,68,0,inf
23105,64,6,70,0,inf
23106,53,9,62,0,inf
23107,58,12,70,1,2.206666748419373
23108,64,8,72,0,inf
23109,66,5,71,0,inf
23110,65,13,78,0,inf
23111,66,6,72,0,inf
23112,66,6,72,0,inf
23113,51,5,56,0,inf
23114,54,10,64,0,inf
23115,59,7,66,0,inf
23116,52,5,57,0,inf
23117,67,5,72,0,inf
23118,55,13,68,0,inf
23119,54,6,60,0,inf
23120,52,6,58,0,inf
23121,58,5,63,0,inf
23122,62,5,67,0,inf
23123,63,12,75,0,inf
23124,50,7,57,0,inf
23125,62,13,75,0,inf
23126,67,6,73,0,inf
23127,64,10,74,0,inf
23128,65,8,73,0,inf
23129,56,5,61,0,inf
23130,55,6,61,0,inf
23131,57,12,69,0,inf
23132,63,12,75,0,inf
23133,55,10,65,0,inf
23134,56,8,64,0,inf
23135,54,9,63,1,5.168604424883377
23136,64,7,71,0,inf
23137,62,12,74,0,inf
23138,51,13,64,0,inf
23139,58,7,65,0,inf
23140,62,10,72,0,inf
23141,67,12,79,0,inf
23142,58,13,71,0,inf
23143,66,8,74,0,inf
23144,55,7,62,0,inf
23145,54,10,64,0,inf
23146,54,7,61,0,inf
23147,57,5,62,1,0.4068481108066351
23148,50,13,63,0,inf
23149,64,10,74,0,inf
23150,58,7,65,0,inf
23151,59,12,71,0,inf
23152,63,11,74,0,inf
23153,50,10,60,0,inf
23154,54,7,61,0,inf
23155,53,10,63,0,inf
23156,63,10,73,0,inf
23157,52,12,64,0,inf
23158,56,6,62,0,inf
23159,63,11,74,0,inf
23160,58,11,69,0,inf
23161,60,12,72,0,inf
23162,64,5,69,0,inf
23163,63,12,75,0,inf
23164,58,7,65,0,inf
23165,67,11,78,0,inf
23166,60,13,73,0,inf
23167,60,7,67,1,5.845446717745915
23168,50,12,62,0,inf
23169,50,9,59,0,inf
23170,51,9,60,0,inf
23171,64,7,71,0,inf
23172,67,7,74,0,inf
23173,67,10,77,0,inf
23174,64,6,70,0,inf
23175,58,12,70,0,inf
23176,52,12,64,0,inf
23177,57,11,68,0,inf
23178,62,9,71,0,inf
23179,51,12,63,0,inf
23180,60,13,73,0,inf
23181,58,8,66,0,inf
23182,60,7,67,0,inf
23183,56,10,66,0,inf
23184,62,5,67,0,inf
23185,55,12,67,0,inf
23186,56,5,61,0,inf
23187,60,5,65,0,inf
23188,63,11,74,0,inf
23189,50,11,61,0,inf
23190,56,13,69,0,inf
23191,62,13,75,0,inf
23192,66,13,79,0,inf
23193,56,10,66,0,inf
23194,64,7,71,0,inf
23195,64,7,71,0,inf
23196,61,10,71,0,inf
23197,58,5,63,0,inf
23198,63,11,74,0,inf
23199,61,5,66,0,inf
23200,54,6,60,0,inf
23201,59,13,72,0,inf
23202,62,7,69,0,inf
23203,55,5,60,0,inf
23204,57,11,68,0,inf
23205,53,5,58,0,inf
23206,62,7,69,0,inf
23207,62,6,68,0,inf
23208,67,5,72,0,inf
23209,51,13,64,0,inf
23210,61,8,69,0,inf
23211,67,13,80,0,inf
23212,61,5,66,0,inf
23213,55,9,64,0,inf
23214,53,5,58,0,inf
23215,65,7,72,0,inf
23216,57,8,65,0,inf
23217,66,8,74,0,inf
23218,61,6,67,0,inf
23219,63,7,70,0,inf
23220,54,9,63,0,inf
23221,53,11,64,0,inf
23222,60,8,68,0,inf
23223,64,5,69,0,inf
23224,54,8,62,0,inf
23225,61,5,66,0,inf
23226,50,9,59,0,inf
23227,52,13,65,0,inf
23228,65,12,77,0,inf
23229,67,5,72,0,inf
23230,61,7,68,0,inf
23231,57,13,70,0,inf
23232,65,8,73,0,inf
23233,55,7,62,0,inf
23234,66,10,76,0,inf
23235,58,6,64,0,inf
23236,61,13,74,0,inf
23237,57,11,68,0,inf
23238,52,10,62,0,inf
23239,59,7,66,0,inf
23240,58,13,71,0,inf
23241,58,11,69,0,inf
23242,61,7,68,0,inf
23243,60,12,72,0,inf
23244,50,12,62,0,inf
23245,66,6,72,0,inf
23246,52,13,65,0,inf
23247,59,12,71,0,inf
23248,64,13,77,0,inf
23249,54,9,63,0,inf
23250,61,6,67,0,inf
23251,54,8,62,0,inf
23252,60,12,72,0,inf
23253,56,9,65,0,inf
23254,53,7,60,0,inf
23255,51,11,62,0,inf
23256,64,10,74,0,inf
23257,61,13,74,0,inf
23258,64,11,75,0,inf
23259,60,13,73,0,inf
23260,67,9,76,0,inf
23261,67,5,72,0,inf
23262,56,12,68,0,inf
23263,60,11,71,0,inf
23264,52,8,60,0,inf
23265,60,11,71,0,inf
23266,65,11,76,0,inf
23267,56,9,65,0,inf
23268,56,7,63,0,inf
23269,63,5,68,0,inf
23270,62,10,72,1,2.4878747955685725
23271,61,12,73,0,inf
23272,57,6,63,0,inf
23273,60,9,69,0,inf
23274,58,12,70,0,inf
23275,52,11,63,0,inf
23276,53,9,62,0,inf
23277,64,11,75,0,inf
23278,53,9,62,0,inf
23279,58,7,65,0,inf
23280,64,7,71,0,inf
23281,58,8,66,0,inf
23282,57,11,68,0,inf
23283,65,7,72,0,inf
23284,55,10,65,0,inf
23285,51,7,58,0,inf
23286,67,11,78,0,inf
23287,52,5,57,0,inf
23288,59,6,65,0,inf
23289,50,7,57,0,inf
23290,54,8,62,0,inf
23291,62,12,74,0,inf
23292,55,9,64,0,inf
23293,54,7,61,0,inf
23294,63,10,73,0,inf
23295,52,7,59,0,inf
23296,63,5,68,0,inf
23297,51,11,62,0,inf
23298,61,5,66,0,inf
23299,63,6,69,0,inf
23300,50,11,61,0,inf
23301,58,13,71,0,inf
23302,55,8,63,0,inf
23303,57,13,70,0,inf
23304,62,9,71,0,inf
23305,57,8,65,0,inf
23306,50,9,59,0,inf
23307,55,5,60,0,inf
23308,65,5,70,0,inf
23309,51,9,60,0,inf
23310,50,13,63,0,inf
23311,66,6,72,0,inf
23312,62,5,67,0,inf
23313,67,5,72,0,inf
23314,65,11,76,0,inf
23315,58,13,71,0,inf
23316,66,9,75,0,inf
23317,62,9,71,0,inf
23318,54,8,62,0,inf
23319,52,6,58,0,inf
23320,66,9,75,0,inf
23321,53,10,63,0,inf
23322,65,12,77,0,inf
23323,66,9,75,0,inf
23324,56,6,62,0,inf
23325,51,9,60,0,inf
23326,66,5,71,0,inf
23327,61,11,72,0,inf
23328,52,10,62,0,inf
23329,60,7,67,0,inf
23330,56,12,68,0,inf
23331,62,5,67,0,inf
23332,61,11,72,0,inf
23333,66,11,77,0,inf
23334,56,12,68,0,inf
23335,50,7,57,0,inf
23336,66,10,76,0,inf
23337,52,7,59,0,inf
23338,64,13,77,0,inf
23339,54,6,60,0,inf
23340,61,8,69,0,inf
23341,51,9,60,0,inf
23342,56,11,67,0,inf
23343,55,7,62,0,inf
23344,53,5,58,0,inf
23345,50,11,61,0,inf
23346,51,8,59,0,inf
23347,65,8,73,0,inf
23348,63,12,75,0,inf
23349,60,6,66,0,inf
23350,50,12,62,0,inf
23351,55,13,68,0,inf
23352,62,9,71,0,inf
23353,50,10,60,0,inf
23354,57,7,64,0,inf
23355,55,5,60,0,inf
23356,64,11,75,0,inf
23357,50,6,56,0,inf
23358,51,11,62,0,inf
23359,59,10,69,0,inf
23360,58,5,63,0,inf
23361,57,8,65,0,inf
23362,65,10,75,0,inf
23363,67,7,74,0,inf
23364,62,10,72,0,inf
23365,67,8,75,0,inf
23366,59,7,66,0,inf
23367,67,7,74,0,inf
23368,58,10,68,0,inf
23369,61,13,74,0,inf
23370,66,13,79,0,inf
23371,57,13,70,0,inf
23372,56,11,67,0,inf
23373,53,9,62,0,inf
23374,64,7,71,0,inf
23375,57,13,70,0,inf
23376,59,7,66,0,inf
23377,67,7,74,0,inf
23378,52,11,63,0,inf
23379,62,13,75,0,inf
23380,56,8,64,0,inf
23381,52,5,57,0,inf
23382,58,12,70,0,inf
23383,59,9,68,0,inf
23384,58,9,67,0,inf
23385,55,9,64,0,inf
23386,64,12,76,0,inf
23387,65,12,77,0,inf
23388,55,5,60,0,inf
23389,59,8,67,0,inf
23390,51,13,64,0,inf
23391,60,11,71,0,inf
23392,63,9,72,0,inf
23393,55,11,66,0,inf
23394,60,9,69,0,inf
23395,55,10,65,0,inf
23396,59,11,70,0,inf
23397,65,7,72,0,inf
23398,63,8,71,0,inf
23399,64,12,76,0,inf
23400,66,11,77,0,inf
23401,66,6,72,0,inf
23402,53,5,58,0,inf
23403,61,12,73,0,inf
23404,56,10,66,0,inf
23405,60,5,65,0,inf
23406,60,9,69,1,6.781324500760803
23407,54,6,60,0,inf
23408,51,12,63,1,11.21536587599445
23409,60,9,69,0,inf
23410,53,6,59,0,inf
23411,63,8,71,0,inf
23412,63,11,74,0,inf
23413,57,8,65,0,inf
23414,59,7,66,0,inf
23415,61,6,67,0,inf
23416,55,7,62,0,inf
23417,58,8,66,0,inf
23418,66,12,78,0,inf
23419,65,12,77,0,inf
23420,66,9,75,0,inf
23421,61,9,70,0,inf
23422,57,8,65,0,inf
23423,51,10,61,0,inf
23424,56,11,67,0,inf
23425,65,10,75,0,inf
23426,58,9,67,0,inf
23427,61,10,71,0,inf
23428,53,6,59,0,inf
23429,53,7,60,0,inf
23430,59,8,67,0,inf
23431,58,10,68,0,inf
23432,56,8,64,0,inf
23433,57,9,66,0,inf
23434,58,8,66,0,inf
23435,54,6,60,0,inf
23436,58,9,67,0,inf
23437,52,13,65,0,inf
23438,50,9,59,0,inf
23439,62,11,73,1,7.797394805665547
23440,61,7,68,0,inf
23441,64,7,71,0,inf
23442,50,5,55,0,inf
23443,60,12,72,0,inf
23444,60,6,66,0,inf
23445,53,10,63,0,inf
23446,52,8,60,0,inf
23447,64,11,75,0,inf
23448,61,13,74,0,inf
23449,67,9,76,0,inf
23450,50,11,61,0,inf
23451,64,8,72,0,inf
23452,51,11,62,0,inf
23453,52,12,64,0,inf
23454,62,13,75,0,inf
23455,59,10,69,0,inf
23456,59,8,67,0,inf
23457,63,5,68,0,inf
23458,56,5,61,0,inf
23459,61,13,74,0,inf
23460,57,5,62,0,inf
23461,63,10,73,0,inf
23462,64,12,76,0,inf
23463,62,12,74,0,inf
23464,56,13,69,0,inf
23465,56,5,61,0,inf
23466,53,6,59,0,inf
23467,62,9,71,0,inf
23468,51,7,58,0,inf
23469,64,8,72,0,inf
23470,66,5,71,0,inf
23471,59,5,64,0,inf
23472,56,8,64,0,inf
23473,67,6,73,0,inf
23474,53,6,59,0,inf
23475,64,5,69,0,inf
23476,55,7,62,0,inf
23477,56,11,67,1,10.211877677787342
23478,62,11,73,0,inf
23479,53,8,61,0,inf
23480,58,10,68,0,inf
23481,57,11,68,0,inf
23482,67,9,76,0,inf
23483,54,13,67,0,inf
23484,67,8,75,0,inf
23485,59,10,69,0,inf
23486,56,12,68,0,inf
23487,56,9,65,0,inf
23488,61,7,68,0,inf
23489,50,12,62,0,inf
23490,56,5,61,0,inf
23491,64,6,70,0,inf
23492,53,8,61,0,inf
23493,66,9,75,0,inf
23494,55,12,67,0,inf
23495,59,5,64,0,inf
23496,50,10,60,0,inf
23497,53,12,65,0,inf
23498,61,10,71,0,inf
23499,65,7,72,0,inf
23500,66,12,78,0,inf
23501,52,11,63,0,inf
23502,64,5,69,0,inf
23503,62,11,73,0,inf
23504,56,7,63,0,inf
23505,64,6,70,0,inf
23506,61,7,68,0,inf
23507,54,10,64,0,inf
23508,63,13,76,0,inf
23509,63,10,73,1,6.233224987133397
23510,58,5,63,0,inf
23511,64,12,76,0,inf
23512,66,5,71,0,inf
23513,61,5,66,0,inf
23514,66,5,71,0,inf
23515,51,12,63,0,inf
23516,61,7,68,0,inf
23517,51,6,57,0,inf
23518,60,7,67,0,inf
23519,57,10,67,0,inf
23520,66,13,79,0,inf
23521,64,9,73,0,inf
23522,64,11,75,0,inf
23523,67,10,77,0,inf
23524,65,10,75,0,inf
23525,65,10,75,0,inf
23526,61,11,72,0,inf
23527,53,9,62,1,8.948462077754584
23528,52,11,63,0,inf
23529,50,11,61,0,inf
23530,58,5,63,0,inf
23531,65,7,72,0,inf
23532,56,12,68,0,inf
23533,65,7,72,0,inf
23534,55,13,68,0,inf
23535,59,9,68,0,inf
23536,51,6,57,0,inf
23537,57,6,63,0,inf
23538,55,13,68,0,inf
23539,58,13,71,0,inf
23540,59,6,65,0,inf
23541,63,5,68,0,inf
23542,50,12,62,0,inf
23543,67,7,74,0,inf
23544,60,11,71,0,inf
23545,58,8,66,0,inf
23546,55,7,62,0,inf
23547,59,5,64,0,inf
23548,67,9,76,0,inf
23549,56,9,65,0,inf
23550,55,7,62,0,inf
23551,60,10,70,0,inf
23552,55,5,60,0,inf
23553,63,12,75,0,inf
23554,67,8,75,0,inf
23555,52,7,59,0,inf
23556,50,6,56,0,inf
23557,67,9,76,0,inf
23558,51,8,59,0,inf
23559,53,13,66,0,inf
23560,50,12,62,0,inf
23561,56,9,65,0,inf
23562,56,13,69,1,12.297520624198114
23563,58,10,68,0,inf
23564,64,8,72,0,inf
23565,59,10,69,0,inf
23566,64,10,74,0,inf
23567,51,6,57,0,inf
23568,59,11,70,0,inf
23569,63,7,70,0,inf
23570,53,11,64,0,inf
23571,57,6,63,0,inf
23572,66,9,75,0,inf
23573,66,9,75,0,inf
23574,52,6,58,0,inf
23575,64,13,77,0,inf
23576,62,7,69,0,inf
23577,57,9,66,0,inf
23578,67,12,79,0,inf
23579,56,8,64,0,inf
23580,67,10,77,0,inf
23581,50,8,58,0,inf
23582,67,5,72,0,inf
23583,59,10,69,0,inf
23584,67,12,79,0,inf
23585,55,10,65,0,inf
23586,62,7,69,0,inf
23587,65,13,78,0,inf
23588,60,8,68,0,inf
23589,50,5,55,0,inf
23590,62,13,75,0,inf
23591,52,11,63,0,inf
23592,57,6,63,0,inf
23593,61,11,72,0,inf
23594,59,11,70,0,inf
23595,55,10,65,0,inf
23596,54,6,60,0,inf
23597,59,13,72,1,9.709801499760701
23598,57,11,68,0,inf
23599,55,12,67,1,5.9329682019130985
23600,59,11,70,0,inf
23601,52,9,61,0,inf
23602,55,8,63,0,inf
23603,66,8,74,0,inf
23604,61,10,71,0,inf
23605,59,10,69,0,inf
23606,67,7,74,0,inf
23607,60,13,73,0,inf
23608,50,12,62,0,inf
23609,57,7,64,0,inf
23610,55,10,65,0,inf
23611,56,11,67,0,inf
23612,58,10,68,0,inf
23613,64,7,71,0,inf
23614,55,9,64,0,inf
23615,57,6,63,0,inf
23616,56,8,64,0,inf
23617,61,5,66,0,inf
23618,66,11,77,0,inf
23619,53,6,59,0,inf
23620,59,5,64,0,inf
23621,60,11,71,0,inf
23622,51,11,62,1,6.828966135381876
23623,64,11,75,0,inf
23624,52,6,58,1,2.1696440328346043
23625,64,8,72,0,inf
23626,66,5,71,0,inf
23627,63,9,72,0,inf
23628,59,9,68,0,inf
23629,63,7,70,0,inf
23630,55,9,64,0,inf
23631,62,12,74,0,inf
23632,56,9,65,0,inf
23633,54,13,67,0,inf
23634,64,6,70,0,inf
23635,53,8,61,0,inf
23636,50,13,63,0,inf
23637,62,10,72,0,inf
23638,63,7,70,0,inf
23639,54,6,60,1,2.5880130273302413
23640,58,11,69,0,inf
23641,53,10,63,0,inf
23642,58,7,65,0,inf
23643,64,5,69,0,inf
23644,60,6,66,0,inf
23645,56,9,65,0,inf
23646,55,8,63,0,inf
23647,54,9,63,0,inf
23648,57,10,67,0,inf
23649,59,13,72,0,inf
23650,60,6,66,0,inf
23651,56,10,66,0,inf
23652,50,6,56,0,inf
23653,57,10,67,0,inf
23654,55,7,62,0,inf
23655,58,5,63,0,inf
23656,61,12,73,0,inf
23657,65,9,74,0,inf
23658,65,13,78,0,inf
23659,50,10,60,0,inf
23660,59,7,66,0,inf
23661,52,6,58,0,inf
23662,61,10,71,0,inf
23663,52,5,57,0,inf
23664,63,11,74,0,inf
23665,52,6,58,0,inf
23666,57,12,69,0,inf
23667,50,5,55,0,inf
23668,60,7,67,0,inf
23669,61,13,74,0,inf
23670,61,13,74,0,inf
23671,63,7,70,0,inf
23672,57,5,62,0,inf
23673,56,9,65,0,inf
23674,56,7,63,0,inf
23675,54,6,60,0,inf
23676,65,13,78,0,inf
23677,56,13,69,0,inf
23678,56,5,61,0,inf
23679,62,6,68,0,inf
23680,65,11,76,0,inf
23681,62,8,70,0,inf
23682,64,10,74,0,inf
23683,51,7,58,0,inf
23684,56,7,63,0,inf
23685,67,11,78,0,inf
23686,58,6,64,0,inf
23687,65,5,70,0,inf
23688,50,6,56,0,inf
23689,52,6,58,0,inf
23690,61,11,72,0,inf
23691,51,6,57,0,inf
23692,62,8,70,0,inf
23693,67,12,79,0,inf
23694,53,13,66,0,inf
23695,62,5,67,0,inf
23696,52,9,61,0,inf
23697,52,12,64,0,inf
23698,67,10,77,0,inf
23699,59,12,71,0,inf
23700,67,12,79,0,inf
23701,55,5,60,0,inf
23702,51,12,63,0,inf
23703,61,9,70,0,inf
23704,52,7,59,0,inf
23705,66,10,76,0,inf
23706,65,10,75,0,inf
23707,52,7,59,0,inf
23708,64,13,77,1,3.1160550712152997
23709,52,12,64,0,inf
23710,67,9,76,0,inf
23711,55,9,64,0,inf
23712,51,6,57,0,inf
23713,59,9,68,1,8.423500178782078
23714,50,7,57,0,inf
23715,67,7,74,0,inf
23716,59,9,68,0,inf
23717,58,7,65,0,inf
23718,65,6,71,0,inf
23719,67,9,76,0,inf
23720,60,10,70,0,inf
23721,62,6,68,0,inf
23722,50,10,60,0,inf
23723,65,9,74,0,inf
23724,52,9,61,0,inf
23725,56,13,69,0,inf
23726,57,5,62,0,inf
23727,58,6,64,0,inf
23728,55,5,60,1,3.685295126252541
23729,61,6,67,0,inf
23730,62,7,69,0,inf
23731,63,9,72,0,inf
23732,63,9,72,0,inf
23733,54,11,65,0,inf
23734,53,6,59,0,inf
23735,61,6,67,0,inf
23736,67,7,74,0,inf
23737,61,9,70,0,inf
23738,51,11,62,0,inf
23739,51,12,63,0,inf
23740,52,6,58,0,inf
23741,55,6,61,0,inf
23742,61,13,74,0,inf
23743,52,8,60,0,inf
23744,53,7,60,0,inf
23745,63,11,74,0,inf
23746,67,9,76,0,inf
23747,64,13,77,0,inf
23748,65,8,73,0,inf
23749,59,5,64,0,inf
23750,55,13,68,0,inf
23751,63,5,68,0,inf
23752,61,12,73,0,inf
23753,61,11,72,0,inf
23754,50,7,57,0,inf
23755,52,6,58,0,inf
23756,63,11,74,0,inf
23757,52,5,57,0,inf
23758,53,11,64,0,inf
23759,52,7,59,0,inf
23760,64,12,76,0,inf
23761,58,13,71,0,inf
23762,53,13,66,0,inf
23763,64,11,75,0,inf
23764,58,7,65,0,inf
23765,59,6,65,0,inf
23766,58,5,63,0,inf
23767,65,6,71,0,inf
23768,61,8,69,0,inf
23769,64,5,69,0,inf
23770,59,7,66,0,inf
23771,62,6,68,0,inf
23772,51,13,64,0,inf
23773,61,13,74,0,inf
23774,59,13,72,0,inf
23775,64,5,69,0,inf
23776,63,10,73,0,inf
23777,66,6,72,0,inf
23778,67,7,74,0,inf
23779,66,5,71,0,inf
23780,67,8,75,0,inf
23781,59,8,67,0,inf
23782,53,9,62,0,inf
23783,50,13,63,0,inf
23784,54,5,59,0,inf
23785,65,13,78,0,inf
23786,64,6,70,0,inf
23787,54,11,65,0,inf
23788,56,7,63,0,inf
23789,54,9,63,0,inf
23790,63,8,71,0,inf
23791,67,5,72,0,inf
23792,63,10,73,0,inf
23793,52,9,61,0,inf
23794,64,8,72,0,inf
23795,67,7,74,0,inf
23796,67,5,72,0,inf
23797,59,13,72,0,inf
23798,62,11,73,0,inf
23799,63,8,71,0,inf
23800,56,10,66,0,inf
23801,58,8,66,0,inf
23802,57,7,64,0,inf
23803,57,11,68,0,inf
23804,65,7,72,0,inf
23805,52,6,58,0,inf
23806,66,13,79,0,inf
23807,60,9,69,1,4.893078082795171
23808,63,11,74,0,inf
23809,59,10,69,0,inf
23810,59,6,65,0,inf
23811,56,11,67,0,inf
23812,58,8,66,0,inf
23813,64,5,69,0,inf
23814,59,13,72,0,inf
23815,53,10,63,0,inf
23816,65,8,73,0,inf
23817,65,12,77,0,inf
23818,59,13,72,0,inf
23819,65,10,75,0,inf
23820,61,10,71,0,inf
23821,51,6,57,0,inf
23822,64,12,76,0,inf
23823,57,9,66,0,inf
23824,61,11,72,0,inf
23825,63,6,69,0,inf
23826,56,13,69,0,inf
23827,66,13,79,1,2.7207491496649965
23828,63,7,70,0,inf
23829,57,9,66,0,inf
23830,65,5,70,0,inf
23831,58,9,67,0,inf
23832,60,7,67,0,inf
23833,53,8,61,0,inf
23834,53,13,66,0,inf
23835,67,12,79,0,inf
23836,64,6,70,0,inf
23837,50,11,61,0,inf
23838,59,5,64,0,inf
23839,51,10,61,0,inf
23840,62,6,68,0,inf
23841,52,7,59,0,inf
23842,66,6,72,0,inf
23843,53,11,64,0,inf
23844,60,9,69,0,inf
23845,64,12,76,0,inf
23846,54,9,63,0,inf
23847,59,9,68,0,inf
23848,65,9,74,0,inf
23849,65,10,75,0,inf
23850,51,11,62,0,inf
23851,59,8,67,0,inf
23852,59,6,65,0,inf
23853,50,8,58,0,inf
23854,62,8,70,1,6.285670887233536
23855,64,12,76,0,inf
23856,52,7,59,0,inf
23857,63,9,72,0,inf
23858,52,5,57,0,inf
23859,64,13,77,0,inf
23860,66,12,78,0,inf
23861,52,5,57,0,inf
23862,63,6,69,0,inf
23863,65,11,76,0,inf
23864,65,5,70,0,inf
23865,61,13,74,0,inf
23866,55,7,62,0,inf
23867,52,11,63,0,inf
23868,67,12,79,0,inf
23869,67,5,72,0,inf
23870,58,9,67,0,inf
23871,60,6,66,0,inf
23872,62,13,75,1,11.274567918564443
23873,58,8,66,0,inf
23874,63,10,73,0,inf
23875,67,6,73,0,inf
23876,62,7,69,0,inf
23877,61,8,69,0,inf
23878,55,9,64,0,inf
23879,59,7,66,0,inf
23880,53,13,66,0,inf
23881,62,13,75,0,inf
23882,61,11,72,0,inf
23883,66,12,78,0,inf
23884,50,13,63,0,inf
23885,61,13,74,0,inf
23886,53,7,60,0,inf
23887,59,10,69,0,inf
23888,67,7,74,0,inf
23889,53,10,63,0,inf
23890,53,12,65,0,inf
23891,53,9,62,0,inf
23892,56,11,67,0,inf
23893,64,11,75,0,inf
23894,60,13,73,0,inf
23895,56,6,62,0,inf
23896,50,6,56,0,inf
23897,67,11,78,0,inf
23898,51,13,64,0,inf
23899,58,8,66,0,inf
23900,60,7,67,0,inf
23901,62,7,69,0,inf
23902,66,8,74,0,inf
23903,50,12,62,0,inf
23904,55,13,68,0,inf
23905,64,7,71,0,inf
23906,54,8,62,0,inf
23907,63,7,70,0,inf
23908,54,12,66,0,inf
23909,58,10,68,0,inf
23910,64,12,76,0,inf
23911,55,9,64,0,inf
23912,66,11,77,0,inf
23913,63,13,76,0,inf
23914,66,8,74,0,inf
23915,59,12,71,0,inf
23916,62,8,70,0,inf
23917,61,12,73,0,inf
23918,56,10,66,0,inf
23919,53,12,65,0,inf
23920,56,13,69,0,inf
23921,63,9,72,0,inf
23922,50,7,57,0,inf
23923,64,11,75,0,inf
23924,62,13,75,1,3.076902791362869
23925,61,9,70,0,inf
23926,53,9,62,0,inf
23927,52,6,58,0,inf
23928,55,6,61,0,inf
23929,53,5,58,0,inf
23930,55,10,65,0,inf
23931,65,12,77,0,inf
23932,50,7,57,0,inf
23933,63,9,72,0,inf
23934,62,10,72,0,inf
23935,67,10,77,0,inf
23936,66,11,77,0,inf
23937,54,7,61,0,inf
23938,64,7,71,0,inf
23939,56,11,67,0,inf
23940,62,8,70,0,inf
23941,59,7,66,0,inf
23942,54,12,66,0,inf
23943,61,6,67,0,inf
23944,52,10,62,0,inf
23945,63,7,70,0,inf
23946,61,6,67,0,inf
23947,53,5,58,0,inf
23948,65,5,70,0,inf
23949,67,9,76,0,inf
23950,59,11,70,0,inf
23951,55,10,65,0,inf
23952,55,7,62,0,inf
23953,61,8,69,1,2.741148340961878
23954,63,8,71,0,inf
23955,57,11,68,0,inf
23956,55,5,60,0,inf
23957,55,13,68,0,inf
23958,56,7,63,0,inf
23959,61,11,72,0,inf
23960,52,9,61,0,inf
23961,52,7,59,0,inf
23962,67,6,73,0,inf
23963,59,9,68,0,inf
23964,59,7,66,0,inf
23965,61,8,69,0,inf
23966,60,10,70,0,inf
23967,62,13,75,0,inf
23968,55,8,63,0,inf
23969,63,11,74,0,inf
23970,65,8,73,0,inf
23971,57,6,63,0,inf
23972,64,6,70,0,inf
23973,53,8,61,0,inf
23974,55,12,67,0,inf
23975,52,8,60,0,inf
23976,60,8,68,0,inf
23977,64,9,73,0,inf
23978,55,5,60,0,inf
23979,55,6,61,0,inf
23980,56,6,62,0,inf
23981,50,13,63,0,inf
23982,60,7,67,0,inf
23983,62,11,73,0,inf
23984,56,6,62,0,inf
23985,57,7,64,0,inf
23986,65,13,78,0,inf
23987,55,11,66,0,inf
23988,54,6,60,0,inf
23989,57,7,64,0,inf
23990,56,12,68,0,inf
23991,63,7,70,0,inf
23992,58,7,65,0,inf
23993,62,7,69,0,inf
23994,63,10,73,0,inf
23995,52,8,60,0,inf
23996,63,12,75,0,inf
23997,67,11,78,0,inf
23998,50,6,56,0,inf
23999,64,6,70,0,inf
24000,61,11,72,0,inf
24001,66,10,76,0,inf
24002,62,6,68,0,inf
24003,57,8,65,0,inf
24004,59,7,66,0,inf
24005,51,9,60,0,inf
24006,50,6,56,0,inf
24007,56,10,66,1,0.7557820903744528
24008,63,6,69,0,inf
24009,58,9,67,0,inf
24010,64,13,77,0,inf
24011,61,7,68,0,inf
24012,63,13,76,0,inf
24013,51,6,57,0,inf
24014,56,8,64,0,inf
24015,66,5,71,1,0.25772430933956514
24016,55,8,63,0,inf
24017,51,10,61,0,inf
24018,61,9,70,0,inf
24019,58,7,65,0,inf
24020,56,12,68,0,inf
24021,66,10,76,0,inf
24022,59,10,69,0,inf
24023,60,10,70,0,inf
24024,52,8,60,0,inf
24025,60,6,66,0,inf
24026,60,7,67,0,inf
24027,63,5,68,0,inf
24028,57,5,62,0,inf
24029,57,7,64,0,inf
24030,50,7,57,0,inf
24031,64,11,75,0,inf
24032,56,9,65,0,inf
24033,57,5,62,0,inf
24034,64,9,73,0,inf
24035,62,5,67,0,inf
24036,59,13,72,0,inf
24037,56,6,62,0,inf
24038,62,7,69,0,inf
24039,51,9,60,0,inf
24040,55,13,68,0,inf
24041,63,12,75,0,inf
24042,52,11,63,0,inf
24043,57,9,66,0,inf
24044,60,9,69,0,inf
24045,53,11,64,0,inf
24046,57,12,69,0,inf
24047,62,8,70,0,inf
24048,53,11,64,0,inf
24049,58,7,65,0,inf
24050,55,6,61,0,inf
24051,64,11,75,0,inf
24052,56,8,64,0,inf
24053,59,6,65,0,inf
24054,53,8,61,0,inf
24055,53,8,61,0,inf
24056,53,13,66,0,inf
24057,56,11,67,1,2.9434665558330906
24058,55,9,64,0,inf
24059,62,7,69,0,inf
24060,51,12,63,0,inf
24061,66,5,71,0,inf
24062,50,9,59,0,inf
24063,51,7,58,0,inf
24064,50,11,61,0,inf
24065,55,8,63,0,inf
24066,50,9,59,0,inf
24067,53,9,62,0,inf
24068,60,7,67,0,inf
24069,55,7,62,0,inf
24070,59,9,68,0,inf
24071,64,7,71,0,inf
24072,54,7,61,1,0.06682187656038252
24073,53,9,62,0,inf
24074,51,6,57,0,inf
24075,53,6,59,0,inf
24076,65,9,74,0,inf
24077,55,6,61,0,inf
24078,61,8,69,0,inf
24079,61,13,74,0,inf
24080,52,5,57,0,inf
24081,58,10,68,0,inf
24082,53,12,65,0,inf
24083,56,12,68,0,inf
24084,67,13,80,0,inf
24085,65,7,72,0,inf
24086,64,12,76,0,inf
24087,50,8,58,0,inf
24088,64,9,73,1,6.997527325895973
24089,52,5,57,0,inf
24090,67,7,74,0,inf
24091,64,8,72,0,inf
24092,56,13,69,0,inf
24093,57,8,65,0,inf
24094,53,8,61,0,inf
24095,66,6,72,0,inf
24096,59,10,69,0,inf
24097,54,5,59,0,inf
24098,57,6,63,0,inf
24099,65,9,74,0,inf
24100,53,8,61,0,inf
24101,63,6,69,0,inf
24102,55,9,64,0,inf
24103,60,13,73,0,inf
24104,64,13,77,0,inf
24105,67,6,73,0,inf
24106,54,9,63,0,inf
24107,65,11,76,0,inf
24108,65,11,76,0,inf
24109,67,11,78,0,inf
24110,51,8,59,1,3.1772336804536963
24111,65,13,78,0,inf
24112,51,11,62,0,inf
24113,64,12,76,0,inf
24114,51,10,61,0,inf
24115,57,10,67,0,inf
24116,61,9,70,1,7.039408855801199
24117,60,11,71,0,inf
24118,63,13,76,0,inf
24119,57,7,64,0,inf
24120,58,7,65,0,inf
24121,50,12,62,0,inf
24122,52,11,63,0,inf
24123,52,5,57,0,inf
24124,52,7,59,0,inf
24125,65,10,75,0,inf
24126,54,8,62,0,inf
24127,55,13,68,0,inf
24128,57,6,63,0,inf
24129,63,8,71,0,inf
24130,66,8,74,0,inf
24131,60,6,66,0,inf
24132,54,13,67,0,inf
24133,56,12,68,0,inf
24134,59,11,70,0,inf
24135,63,5,68,0,inf
24136,57,11,68,0,inf
24137,58,7,65,0,inf
24138,52,9,61,0,inf
24139,64,7,71,0,inf
24140,59,11,70,1,9.511668621577343
24141,51,10,61,0,inf
24142,63,13,76,0,inf
24143,57,8,65,0,inf
24144,67,9,76,0,inf
24145,63,8,71,0,inf
24146,56,5,61,0,inf
24147,57,9,66,0,inf
24148,54,13,67,1,6.7593384620208
24149,58,7,65,0,inf
24150,58,9,67,0,inf
24151,56,11,67,0,inf
24152,61,7,68,0,inf
24153,64,11,75,0,inf
24154,62,11,73,0,inf
24155,59,5,64,0,inf
24156,64,9,73,0,inf
24157,58,11,69,0,inf
24158,56,13,69,0,inf
24159,63,9,72,0,inf
24160,61,10,71,0,inf
24161,65,12,77,0,inf
24162,51,8,59,0,inf
24163,53,11,64,0,inf
24164,61,9,70,0,inf
24165,65,10,75,0,inf
24166,64,11,75,0,inf
24167,55,13,68,0,inf
24168,62,12,74,0,inf
24169,64,11,75,0,inf
24170,60,5,65,0,inf
24171,67,11,78,0,inf
24172,61,12,73,0,inf
24173,50,7,57,0,inf
24174,57,11,68,0,inf
24175,63,10,73,0,inf
24176,54,12,66,0,inf
24177,56,10,66,0,inf
24178,66,5,71,0,inf
24179,55,8,63,0,inf
24180,55,9,64,0,inf
24181,54,7,61,0,inf
24182,66,11,77,0,inf
24183,53,13,66,0,inf
24184,53,11,64,0,inf
24185,62,9,71,0,inf
24186,58,7,65,0,inf
24187,62,12,74,0,inf
24188,52,6,58,0,inf
24189,50,7,57,0,inf
24190,67,9,76,0,inf
24191,58,9,67,0,inf
24192,61,13,74,0,inf
24193,50,5,55,0,inf
24194,63,7,70,0,inf
24195,67,7,74,0,inf
24196,60,6,66,0,inf
24197,58,7,65,0,inf
24198,54,5,59,0,inf
24199,61,6,67,0,inf
24200,57,7,64,0,inf
24201,52,12,64,0,inf
24202,59,12,71,0,inf
24203,51,9,60,0,inf
24204,56,6,62,0,inf
24205,66,7,73,0,inf
24206,53,11,64,0,inf
24207,55,11,66,0,inf
24208,63,8,71,0,inf
24209,64,10,74,0,inf
24210,53,9,62,0,inf
24211,56,6,62,0,inf
24212,53,12,65,0,inf
24213,54,13,67,0,inf
24214,61,13,74,0,inf
24215,59,9,68,0,inf
24216,51,6,57,0,inf
24217,67,9,76,0,inf
24218,56,9,65,0,inf
24219,52,6,58,0,inf
24220,52,6,58,0,inf
24221,65,10,75,0,inf
24222,56,12,68,0,inf
24223,60,5,65,0,inf
24224,50,10,60,0,inf
24225,60,12,72,0,inf
24226,50,6,56,0,inf
24227,67,8,75,0,inf
24228,61,6,67,0,inf
24229,67,6,73,0,inf
24230,56,12,68,0,inf
24231,67,8,75,0,inf
24232,55,12,67,0,inf
24233,56,5,61,0,inf
24234,60,10,70,0,inf
24235,54,13,67,0,inf
24236,58,10,68,0,inf
24237,55,8,63,0,inf
24238,54,13,67,1,3.970059942023326
24239,61,11,72,0,inf
24240,53,7,60,0,inf
24241,59,5,64,0,inf
24242,66,12,78,0,inf
24243,54,9,63,0,inf
24244,57,8,65,0,inf
24245,66,7,73,0,inf
24246,62,7,69,0,inf
24247,59,9,68,0,inf
24248,54,9,63,0,inf
24249,64,13,77,0,inf
24250,61,6,67,0,inf
24251,65,8,73,0,inf
24252,59,12,71,0,inf
24253,62,11,73,0,inf
24254,65,11,76,0,inf
24255,64,6,70,0,inf
24256,51,10,61,0,inf
24257,62,6,68,0,inf
24258,52,9,61,0,inf
24259,58,9,67,0,inf
24260,55,9,64,0,inf
24261,56,11,67,0,inf
24262,52,8,60,0,inf
24263,59,8,67,0,inf
24264,64,6,70,0,inf
24265,50,12,62,0,inf
24266,67,12,79,0,inf
24267,55,9,64,0,inf
24268,56,5,61,0,inf
24269,59,11,70,0,inf
24270,53,8,61,0,inf
24271,60,6,66,0,inf
24272,53,6,59,0,inf
24273,51,6,57,0,inf
24274,53,8,61,0,inf
24275,50,13,63,1,9.042738265051923
24276,56,10,66,0,inf
24277,60,10,70,0,inf
24278,53,8,61,0,inf
24279,55,8,63,0,inf
24280,53,8,61,0,inf
24281,65,11,76,0,inf
24282,67,11,78,0,inf
24283,59,6,65,0,inf
24284,61,7,68,0,inf
24285,60,10,70,0,inf
24286,60,5,65,0,inf
24287,64,8,72,0,inf
24288,50,8,58,0,inf
24289,53,13,66,0,inf
24290,61,9,70,0,inf
24291,57,7,64,0,inf
24292,65,5,70,0,inf
24293,56,8,64,0,inf
24294,67,13,80,0,inf
24295,60,7,67,0,inf
24296,51,11,62,1,1.1584435389178722
24297,57,11,68,0,inf
24298,54,12,66,0,inf
24299,53,12,65,0,inf
24300,64,11,75,0,inf
24301,67,7,74,0,inf
24302,59,11,70,0,inf
24303,50,9,59,0,inf
24304,54,10,64,0,inf
24305,56,6,62,0,inf
24306,61,7,68,0,inf
24307,60,6,66,0,inf
24308,51,11,62,1,1.7824422243847593
24309,54,9,63,0,inf
24310,63,9,72,0,inf
24311,54,5,59,0,inf
24312,63,13,76,0,inf
24313,60,11,71,0,inf
24314,57,13,70,0,inf
24315,51,7,58,0,inf
24316,61,12,73,1,5.869721137142065
24317,53,8,61,0,inf
24318,61,13,74,0,inf
24319,51,10,61,0,inf
24320,56,10,66,0,inf
24321,54,10,64,0,inf
24322,61,9,70,0,inf
24323,58,12,70,0,inf
24324,60,9,69,0,inf
24325,60,13,73,0,inf
24326,64,11,75,0,inf
24327,51,10,61,0,inf
24328,55,13,68,1,5.369084747779375
24329,65,8,73,0,inf
24330,54,9,63,0,inf
24331,56,13,69,0,inf
24332,64,11,75,0,inf
24333,61,12,73,0,inf
24334,65,5,70,0,inf
24335,55,6,61,0,inf
24336,57,8,65,0,inf
24337,67,5,72,0,inf
24338,54,12,66,0,inf
24339,58,11,69,0,inf
24340,53,8,61,0,inf
24341,62,11,73,1,10.783034699320467
24342,62,11,73,0,inf
24343,67,6,73,0,inf
24344,60,12,72,0,inf
24345,67,13,80,0,inf
24346,61,6,67,0,inf
24347,63,12,75,0,inf
24348,62,10,72,0,inf
24349,66,9,75,0,inf
24350,56,5,61,0,inf
24351,67,9,76,0,inf
24352,54,13,67,0,inf
24353,58,13,71,0,inf
24354,65,13,78,0,inf
24355,67,5,72,0,inf
24356,53,12,65,0,inf
24357,66,8,74,0,inf
24358,62,9,71,0,inf
24359,57,10,67,0,inf
24360,54,8,62,0,inf
24361,63,10,73,0,inf
24362,57,6,63,0,inf
24363,50,7,57,0,inf
24364,66,9,75,0,inf
24365,62,5,67,0,inf
24366,61,7,68,0,inf
24367,57,6,63,0,inf
24368,59,13,72,0,inf
24369,61,13,74,0,inf
24370,57,13,70,0,inf
24371,61,10,71,0,inf
24372,61,9,70,0,inf
24373,64,8,72,0,inf
24374,59,13,72,0,inf
24375,58,11,69,0,inf
24376,59,11,70,0,inf
24377,55,9,64,0,inf
24378,62,8,70,1,0.2554162913823461
24379,51,13,64,0,inf
24380,60,9,69,0,inf
24381,65,8,73,0,inf
24382,67,5,72,0,inf
24383,60,8,68,0,inf
24384,50,5,55,0,inf
24385,65,12,77,0,inf
24386,51,5,56,0,inf
24387,65,13,78,0,inf
24388,53,13,66,0,inf
24389,56,8,64,0,inf
24390,50,12,62,0,inf
24391,58,10,68,0,inf
24392,62,11,73,0,inf
24393,59,6,65,0,inf
24394,52,8,60,0,inf
24395,65,13,78,0,inf
24396,56,8,64,0,inf
24397,56,13,69,0,inf
24398,52,8,60,1,4.6496782369888905
24399,58,6,64,0,inf
24400,51,7,58,0,inf
24401,63,5,68,0,inf
24402,56,12,68,0,inf
24403,50,7,57,0,inf
24404,61,10,71,0,inf
24405,66,11,77,0,inf
24406,54,6,60,0,inf
24407,67,9,76,0,inf
24408,64,6,70,0,inf
24409,60,12,72,0,inf
24410,54,10,64,0,inf
24411,55,8,63,0,inf
24412,55,9,64,0,inf
24413,62,10,72,0,inf
24414,52,6,58,0,inf
24415,51,7,58,0,inf
24416,65,6,71,0,inf
24417,60,12,72,0,inf
24418,52,10,62,0,inf
24419,58,5,63,0,inf
24420,58,12,70,0,inf
24421,52,13,65,0,inf
24422,64,6,70,0,inf
24423,56,9,65,0,inf
24424,62,13,75,0,inf
24425,58,6,64,0,inf
24426,53,10,63,0,inf
24427,64,12,76,0,inf
24428,57,7,64,0,inf
24429,61,6,67,0,inf
24430,66,11,77,0,inf
24431,55,8,63,0,inf
24432,57,8,65,0,inf
24433,56,9,65,0,inf
24434,56,13,69,0,inf
24435,64,9,73,0,inf
24436,53,5,58,0,inf
24437,54,13,67,0,inf
24438,54,11,65,0,inf
24439,66,8,74,0,inf
24440,66,5,71,0,inf
24441,52,11,63,0,inf
24442,67,7,74,0,inf
24443,51,9,60,0,inf
24444,56,13,69,0,inf
24445,65,13,78,0,inf
24446,50,11,61,0,inf
24447,54,10,64,0,inf
24448,56,5,61,0,inf
24449,65,8,73,0,inf
24450,63,7,70,0,inf
24451,58,10,68,0,inf
24452,58,12,70,0,inf
24453,64,10,74,0,inf
24454,55,9,64,0,inf
24455,52,9,61,0,inf
24456,56,8,64,0,inf
24457,65,7,72,0,inf
24458,66,5,71,0,inf
24459,56,12,68,0,inf
24460,59,13,72,0,inf
24461,50,12,62,0,inf
24462,53,8,61,0,inf
24463,62,10,72,0,inf
24464,53,10,63,0,inf
24465,63,6,69,0,inf
24466,51,8,59,0,inf
24467,59,12,71,0,inf
24468,56,11,67,0,inf
24469,50,12,62,0,inf
24470,63,11,74,0,inf
24471,53,12,65,0,inf
24472,53,8,61,0,inf
24473,51,11,62,0,inf
24474,52,10,62,0,inf
24475,67,8,75,0,inf
24476,50,7,57,0,inf
24477,55,13,68,0,inf
24478,56,9,65,0,inf
24479,56,13,69,0,inf
24480,64,10,74,0,inf
24481,50,6,56,0,inf
24482,51,8,59,0,inf
24483,61,9,70,0,inf
24484,59,9,68,0,inf
24485,56,13,69,0,inf
24486,60,10,70,0,inf
24487,64,10,74,0,inf
24488,58,13,71,1,9.316095490179265
24489,65,7,72,0,inf
24490,64,12,76,0,inf
24491,66,9,75,0,inf
24492,61,13,74,0,inf
24493,64,7,71,0,inf
24494,62,12,74,0,inf
24495,63,12,75,0,inf
24496,50,7,57,0,inf
24497,56,8,64,0,inf
24498,54,9,63,0,inf
24499,65,13,78,0,inf
24500,64,5,69,0,inf
24501,64,8,72,0,inf
24502,63,11,74,0,inf
24503,64,13,77,0,inf
24504,50,8,58,0,inf
24505,52,9,61,0,inf
24506,67,12,79,0,inf
24507,55,9,64,0,inf
24508,63,11,74,0,inf
24509,53,12,65,0,inf
24510,65,6,71,0,inf
24511,56,12,68,0,inf
24512,60,5,65,1,3.803344317812119
24513,66,7,73,0,inf
24514,65,13,78,0,inf
24515,50,13,63,0,inf
24516,52,9,61,0,inf
24517,56,12,68,0,inf
24518,59,5,64,0,inf
24519,64,11,75,0,inf
24520,59,7,66,0,inf
24521,67,12,79,0,inf
24522,55,10,65,0,inf
24523,56,7,63,0,inf
24524,67,11,78,0,inf
24525,63,12,75,0,inf
24526,61,11,72,0,inf
24527,61,6,67,0,inf
24528,65,9,74,0,inf
24529,66,6,72,0,inf
24530,50,6,56,0,inf
24531,52,13,65,0,inf
24532,67,8,75,0,inf
24533,64,9,73,0,inf
24534,64,7,71,0,inf
24535,62,13,75,0,inf
24536,64,13,77,0,inf
24537,50,11,61,0,inf
24538,61,10,71,0,inf
24539,53,12,65,0,inf
24540,52,9,61,0,inf
24541,67,6,73,0,inf
24542,57,9,66,0,inf
24543,62,9,71,0,inf
24544,51,5,56,0,inf
24545,61,13,74,1,12.818438567284488
24546,58,9,67,0,inf
24547,57,8,65,0,inf
24548,65,12,77,0,inf
24549,66,7,73,0,inf
24550,56,8,64,0,inf
24551,58,11,69,0,inf
24552,53,8,61,0,inf
24553,50,8,58,0,inf
24554,67,12,79,0,inf
24555,60,11,71,0,inf
24556,66,12,78,0,inf
24557,65,5,70,0,inf
24558,62,5,67,1,4.849042934858588
24559,53,9,62,1,1.159324290176734
24560,59,6,65,0,inf
24561,57,12,69,0,inf
24562,57,6,63,0,inf
24563,59,10,69,0,inf
24564,56,7,63,0,inf
24565,54,9,63,0,inf
24566,59,10,69,0,inf
24567,60,13,73,0,inf
24568,62,6,68,0,inf
24569,60,12,72,0,inf
24570,53,7,60,0,inf
24571,53,9,62,0,inf
24572,57,9,66,0,inf
24573,66,9,75,0,inf
24574,55,6,61,0,inf
24575,57,10,67,0,inf
24576,56,10,66,0,inf
24577,65,12,77,0,inf
24578,63,6,69,0,inf
24579,54,11,65,0,inf
24580,57,9,66,0,inf
24581,63,12,75,0,inf
24582,51,12,63,0,inf
24583,54,8,62,0,inf
24584,60,8,68,0,inf
24585,51,9,60,0,inf
24586,51,9,60,0,inf
24587,51,7,58,0,inf
24588,55,12,67,0,inf
24589,62,11,73,0,inf
24590,67,7,74,0,inf
24591,63,13,76,0,inf
24592,64,9,73,0,inf
24593,59,9,68,0,inf
24594,51,9,60,0,inf
24595,66,13,79,0,inf
24596,67,13,80,0,inf
24597,65,11,76,0,inf
24598,51,8,59,0,inf
24599,54,7,61,0,inf
24600,56,13,69,0,inf
24601,63,7,70,0,inf
24602,54,13,67,0,inf
24603,51,6,57,0,inf
24604,58,12,70,0,inf
24605,62,8,70,0,inf
24606,64,10,74,0,inf
24607,61,11,72,0,inf
24608,67,10,77,0,inf
24609,58,7,65,0,inf
24610,60,11,71,0,inf
24611,52,9,61,0,inf
24612,66,11,77,0,inf
24613,52,10,62,0,inf
24614,57,5,62,0,inf
24615,51,11,62,0,inf
24616,52,13,65,0,inf
24617,56,10,66,1,5.399851040249409
24618,63,5,68,0,inf
24619,63,13,76,0,inf
24620,60,11,71,0,inf
24621,57,9,66,0,inf
24622,52,8,60,0,inf
24623,64,7,71,0,inf
24624,64,11,75,0,inf
24625,56,7,63,0,inf
24626,62,8,70,0,inf
24627,54,9,63,0,inf
24628,57,8,65,0,inf
24629,61,9,70,0,inf
24630,54,10,64,0,inf
24631,60,6,66,0,inf
24632,56,8,64,0,inf
24633,64,10,74,0,inf
24634,50,12,62,0,inf
24635,58,7,65,0,inf
24636,65,6,71,0,inf
24637,58,6,64,0,inf
24638,66,12,78,0,inf
24639,65,8,73,0,inf
24640,65,9,74,0,inf
24641,53,13,66,0,inf
24642,50,9,59,0,inf
24643,54,5,59,0,inf
24644,55,10,65,0,inf
24645,64,10,74,0,inf
24646,67,11,78,0,inf
24647,60,11,71,0,inf
24648,64,7,71,0,inf
24649,67,11,78,1,7.766618607521863
24650,66,11,77,1,9.034895079044688
24651,58,10,68,0,inf
24652,51,5,56,0,inf
24653,54,11,65,0,inf
24654,59,12,71,0,inf
24655,63,8,71,0,inf
24656,59,12,71,0,inf
24657,50,5,55,0,inf
24658,56,11,67,0,inf
24659,66,9,75,0,inf
24660,58,8,66,0,inf
24661,60,9,69,0,inf
24662,63,8,71,0,inf
24663,52,5,57,0,inf
24664,57,11,68,0,inf
24665,55,5,60,0,inf
24666,59,5,64,0,inf
24667,63,5,68,0,inf
24668,53,12,65,0,inf
24669,52,11,63,0,inf
24670,54,6,60,0,inf
24671,64,9,73,0,inf
24672,58,11,69,0,inf
24673,58,11,69,0,inf
24674,60,11,71,0,inf
24675,60,8,68,0,inf
24676,67,5,72,0,inf
24677,58,9,67,0,inf
24678,52,8,60,0,inf
24679,60,10,70,0,inf
24680,51,6,57,0,inf
24681,64,6,70,0,inf
24682,50,12,62,0,inf
24683,67,9,76,0,inf
24684,66,13,79,0,inf
24685,65,8,73,0,inf
24686,52,6,58,0,inf
24687,62,7,69,0,inf
24688,53,8,61,0,inf
24689,66,11,77,0,inf
24690,52,5,57,0,inf
24691,63,6,69,0,inf
24692,61,5,66,0,inf
24693,57,8,65,0,inf
24694,64,7,71,0,inf
24695,52,13,65,0,inf
24696,60,7,67,0,inf
24697,62,10,72,0,inf
24698,62,6,68,0,inf
24699,53,10,63,0,inf
24700,52,12,64,0,inf
24701,67,12,79,0,inf
24702,63,8,71,0,inf
24703,59,7,66,0,inf
24704,65,13,78,0,inf
24705,64,9,73,0,inf
24706,53,5,58,0,inf
24707,58,8,66,0,inf
24708,64,11,75,0,inf
24709,66,11,77,0,inf
24710,56,10,66,0,inf
24711,51,10,61,0,inf
24712,65,10,75,0,inf
24713,61,6,67,0,inf
24714,53,5,58,0,inf
24715,64,8,72,0,inf
24716,57,10,67,0,inf
24717,56,10,66,1,4.387608556162114
24718,51,12,63,0,inf
24719,67,5,72,0,inf
24720,64,8,72,0,inf
24721,59,13,72,0,inf
24722,58,6,64,0,inf
24723,65,5,70,0,inf
24724,60,6,66,0,inf
24725,66,12,78,0,inf
24726,63,11,74,0,inf
24727,55,9,64,0,inf
24728,50,8,58,0,inf
24729,66,10,76,0,inf
24730,55,13,68,0,inf
24731,55,10,65,0,inf
24732,54,10,64,0,inf
24733,67,11,78,0,inf
24734,55,12,67,0,inf
24735,61,10,71,0,inf
24736,67,11,78,0,inf
24737,54,11,65,0,inf
24738,60,12,72,0,inf
24739,62,6,68,0,inf
24740,64,11,75,0,inf
24741,60,11,71,0,inf
24742,52,9,61,0,inf
24743,56,10,66,0,inf
24744,50,11,61,0,inf
24745,65,8,73,0,inf
24746,55,7,62,1,5.56274837760801
24747,54,12,66,0,inf
24748,65,7,72,0,inf
24749,55,12,67,0,inf
24750,52,8,60,0,inf
24751,51,7,58,0,inf
24752,56,13,69,1,1.3602133914225973
24753,56,7,63,0,inf
24754,51,5,56,0,inf
24755,63,12,75,0,inf
24756,61,7,68,0,inf
24757,56,9,65,0,inf
24758,51,12,63,0,inf
24759,66,13,79,0,inf
24760,55,7,62,0,inf
24761,63,8,71,0,inf
24762,67,6,73,0,inf
24763,59,9,68,0,inf
24764,50,13,63,0,inf
24765,63,10,73,0,inf
24766,62,10,72,0,inf
24767,66,9,75,0,inf
24768,67,13,80,0,inf
24769,64,12,76,0,inf
24770,57,13,70,0,inf
24771,50,6,56,0,inf
24772,55,10,65,0,inf
24773,64,12,76,0,inf
24774,63,11,74,0,inf
24775,63,8,71,0,inf
24776,54,5,59,0,inf
24777,52,7,59,0,inf
24778,59,5,64,0,inf
24779,53,10,63,0,inf
24780,56,8,64,0,inf
24781,53,13,66,0,inf
24782,54,5,59,0,inf
24783,63,10,73,0,inf
24784,56,10,66,0,inf
24785,50,10,60,0,inf
24786,66,10,76,0,inf
24787,50,6,56,0,inf
24788,50,12,62,0,inf
24789,53,5,58,0,inf
24790,50,13,63,0,inf
24791,56,13,69,0,inf
24792,66,8,74,0,inf
24793,67,8,75,0,inf
24794,62,12,74,0,inf
24795,53,7,60,0,inf
24796,50,12,62,0,inf
24797,67,5,72,0,inf
24798,50,9,59,0,inf
24799,65,5,70,0,inf
24800,51,10,61,0,inf
24801,54,12,66,0,inf
24802,52,7,59,0,inf
24803,54,7,61,0,inf
24804,52,9,61,0,inf
24805,62,8,70,0,inf
24806,61,11,72,0,inf
24807,56,8,64,0,inf
24808,65,9,74,0,inf
24809,57,6,63,0,inf
24810,63,11,74,0,inf
24811,63,9,72,0,inf
24812,50,10,60,0,inf
24813,59,5,64,0,inf
24814,50,7,57,0,inf
24815,50,7,57,0,inf
24816,64,12,76,0,inf
24817,60,5,65,0,inf
24818,59,12,71,0,inf
24819,50,7,57,0,inf
24820,53,12,65,0,inf
24821,56,10,66,0,inf
24822,66,12,78,0,inf
24823,57,9,66,0,inf
24824,67,8,75,0,inf
24825,60,12,72,0,inf
24826,59,12,71,0,inf
24827,60,7,67,0,inf
24828,55,10,65,0,inf
24829,66,10,76,0,inf
24830,54,9,63,0,inf
24831,64,12,76,0,inf
24832,59,13,72,0,inf
24833,54,9,63,0,inf
24834,61,11,72,0,inf
24835,57,13,70,0,inf
24836,55,8,63,0,inf
24837,52,13,65,0,inf
24838,59,8,67,0,inf
24839,59,7,66,0,inf
24840,65,7,72,0,inf
24841,56,10,66,0,inf
24842,67,13,80,0,inf
24843,58,13,71,0,inf
24844,50,10,60,0,inf
24845,67,7,74,0,inf
24846,54,7,61,0,inf
24847,55,10,65,0,inf
24848,67,7,74,0,inf
24849,54,7,61,0,inf
24850,58,9,67,0,inf
24851,52,7,59,0,inf
24852,61,5,66,0,inf
24853,66,7,73,0,inf
24854,54,6,60,0,inf
24855,52,11,63,0,inf
24856,59,6,65,0,inf
24857,55,13,68,0,inf
24858,60,13,73,0,inf
24859,65,11,76,0,inf
24860,62,13,75,0,inf
24861,54,11,65,0,inf
24862,61,11,72,0,inf
24863,65,8,73,0,inf
24864,58,9,67,0,inf
24865,62,11,73,0,inf
24866,57,10,67,0,inf
24867,57,13,70,0,inf
24868,58,13,71,0,inf
24869,51,10,61,0,inf
24870,52,5,57,0,inf
24871,50,9,59,0,inf
24872,51,10,61,0,inf
24873,53,8,61,0,inf
24874,62,5,67,1,4.874186086591408
24875,65,12,77,0,inf
24876,63,6,69,0,inf
24877,55,8,63,0,inf
24878,67,12,79,0,inf
24879,57,7,64,0,inf
24880,55,6,61,0,inf
24881,50,5,55,0,inf
24882,54,6,60,0,inf
24883,56,9,65,0,inf
24884,64,12,76,0,inf
24885,53,13,66,0,inf
24886,56,5,61,0,inf
24887,54,6,60,0,inf
24888,63,10,73,0,inf
24889,62,8,70,0,inf
24890,66,5,71,0,inf
24891,50,9,59,0,inf
24892,67,10,77,0,inf
24893,67,13,80,0,inf
24894,51,13,64,0,inf
24895,52,9,61,0,inf
24896,52,8,60,0,inf
24897,59,8,67,0,inf
24898,67,10,77,0,inf
24899,50,6,56,0,inf
24900,53,13,66,0,inf
24901,52,7,59,0,inf
24902,55,11,66,0,inf
24903,61,7,68,0,inf
24904,59,5,64,0,inf
24905,67,13,80,0,inf
24906,66,6,72,0,inf
24907,55,6,61,0,inf
24908,52,7,59,0,inf
24909,60,9,69,0,inf
24910,64,13,77,1,12.400541612243359
24911,65,11,76,0,inf
24912,64,9,73,0,inf
24913,57,9,66,0,inf
24914,50,9,59,0,inf
24915,54,12,66,0,inf
24916,56,8,64,0,inf
24917,52,10,62,0,inf
24918,57,7,64,0,inf
24919,57,9,66,0,inf
24920,65,10,75,0,inf
24921,54,13,67,0,inf
24922,64,11,75,0,inf
24923,54,12,66,0,inf
24924,61,12,73,0,inf
24925,67,9,76,0,inf
24926,64,9,73,0,inf
24927,58,8,66,0,inf
24928,63,7,70,0,inf
24929,54,10,64,0,inf
24930,59,12,71,0,inf
24931,57,9,66,0,inf
24932,65,5,70,0,inf
24933,56,7,63,0,inf
24934,66,7,73,0,inf
24935,66,6,72,0,inf
24936,57,12,69,0,inf
24937,52,13,65,0,inf
24938,55,5,60,0,inf
24939,53,12,65,0,inf
24940,51,11,62,0,inf
24941,53,12,65,0,inf
24942,59,7,66,0,inf
24943,60,10,70,0,inf
24944,50,10,60,0,inf
24945,58,10,68,0,inf
24946,61,11,72,0,inf
24947,61,13,74,0,inf
24948,63,9,72,0,inf
24949,53,6,59,0,inf
24950,61,10,71,0,inf
24951,61,7,68,0,inf
24952,65,13,78,0,inf
24953,51,12,63,0,inf
24954,61,12,73,0,inf
24955,58,5,63,0,inf
24956,64,12,76,0,inf
24957,60,8,68,0,inf
24958,57,11,68,0,inf
24959,56,11,67,0,inf
24960,62,6,68,0,inf
24961,54,13,67,0,inf
24962,55,8,63,0,inf
24963,60,10,70,0,inf
24964,66,13,79,1,6.535057992777368
24965,65,11,76,0,inf
24966,53,12,65,0,inf
24967,67,6,73,0,inf
24968,62,10,72,0,inf
24969,65,5,70,0,inf
24970,54,5,59,0,inf
24971,66,13,79,0,inf
24972,59,13,72,0,inf
24973,65,9,74,0,inf
24974,60,12,72,0,inf
24975,66,13,79,0,inf
24976,54,9,63,0,inf
24977,64,11,75,0,inf
24978,59,13,72,0,inf
24979,54,13,67,0,inf
24980,65,11,76,0,inf
24981,56,13,69,0,inf
24982,67,11,78,0,inf
24983,57,9,66,0,inf
24984,51,11,62,0,inf
24985,57,6,63,0,inf
24986,60,8,68,0,inf
24987,55,8,63,0,inf
24988,54,13,67,0,inf
24989,67,6,73,0,inf
24990,52,13,65,0,inf
24991,50,5,55,0,inf
24992,51,13,64,0,inf
24993,55,10,65,0,inf
24994,52,12,64,0,inf
24995,57,10,67,0,inf
24996,61,9,70,0,inf
24997,57,13,70,0,inf
24998,52,12,64,0,inf
24999,57,12,69,0,inf
25000,66,6,72,0,inf
25001,56,11,67,0,inf
25002,57,8,65,0,inf
25003,65,7,72,0,inf
25004,59,5,64,0,inf
25005,54,7,61,1,1.200418454996992
25006,60,11,71,0,inf
25007,51,13,64,0,inf
25008,64,9,73,0,inf
25009,58,5,63,0,inf
25010,60,13,73,0,inf
25011,58,6,64,0,inf
25012,60,10,70,0,inf
25013,55,6,61,0,inf
25014,57,7,64,0,inf
25015,67,12,79,0,inf
25016,56,13,69,0,inf
25017,65,8,73,0,inf
25018,50,7,57,0,inf
25019,55,9,64,0,inf
25020,60,8,68,0,inf
25021,56,13,69,0,inf
25022,55,11,66,0,inf
25023,58,11,69,0,inf
25024,57,10,67,0,inf
25025,58,6,64,0,inf
25026,65,13,78,0,inf
25027,52,6,58,0,inf
25028,57,12,69,0,inf
25029,64,9,73,0,inf
25030,60,5,65,0,inf
25031,57,8,65,0,inf
25032,53,6,59,0,inf
25033,55,11,66,0,inf
25034,62,7,69,0,inf
25035,59,8,67,0,inf
25036,67,12,79,0,inf
25037,53,13,66,0,inf
25038,57,8,65,0,inf
25039,56,6,62,0,inf
25040,60,5,65,0,inf
25041,63,10,73,0,inf
25042,51,11,62,0,inf
25043,62,11,73,0,inf
25044,62,8,70,0,inf
25045,62,10,72,0,inf
25046,65,7,72,0,inf
25047,64,5,69,0,inf
25048,53,13,66,1,11.94739391561805
25049,57,5,62,0,inf
25050,61,5,66,0,inf
25051,60,7,67,0,inf
25052,61,5,66,0,inf
25053,66,5,71,0,inf
25054,63,12,75,0,inf
25055,53,12,65,0,inf
25056,52,13,65,0,inf
25057,50,7,57,0,inf
25058,53,9,62,0,inf
25059,63,12,75,0,inf
25060,62,6,68,0,inf
25061,61,12,73,0,inf
25062,64,7,71,0,inf
25063,59,5,64,0,inf
25064,61,12,73,0,inf
25065,61,9,70,0,inf
25066,61,8,69,0,inf
25067,58,6,64,0,inf
25068,59,5,64,0,inf
25069,55,7,62,0,inf
25070,65,10,75,0,inf
25071,59,11,70,0,inf
25072,65,6,71,0,inf
25073,55,6,61,0,inf
25074,50,5,55,0,inf
25075,60,11,71,0,inf
25076,55,8,63,0,inf
25077,59,10,69,0,inf
25078,53,10,63,0,inf
25079,55,5,60,0,inf
25080,54,8,62,0,inf
25081,65,9,74,0,inf
25082,66,5,71,0,inf
25083,61,12,73,0,inf
25084,60,11,71,0,inf
25085,61,9,70,0,inf
25086,56,8,64,0,inf
25087,52,10,62,0,inf
25088,54,8,62,0,inf
25089,61,10,71,0,inf
25090,56,7,63,0,inf
25091,63,8,71,0,inf
25092,67,9,76,0,inf
25093,56,9,65,0,inf
25094,56,11,67,0,inf
25095,51,9,60,0,inf
25096,59,7,66,0,inf
25097,64,8,72,0,inf
25098,52,7,59,0,inf
25099,62,10,72,0,inf
25100,50,13,63,0,inf
25101,64,6,70,0,inf
25102,51,9,60,0,inf
25103,63,10,73,0,inf
25104,67,6,73,0,inf
25105,65,5,70,0,inf
25106,60,9,69,0,inf
25107,54,7,61,0,inf
25108,63,13,76,0,inf
25109,57,13,70,0,inf
25110,55,11,66,0,inf
25111,53,5,58,0,inf
25112,66,12,78,0,inf
25113,58,9,67,0,inf
25114,51,5,56,0,inf
25115,55,11,66,0,inf
25116,65,9,74,1,4.062679970217658
25117,54,12,66,0,inf
25118,61,10,71,0,inf
25119,64,8,72,0,inf
25120,54,7,61,0,inf
25121,55,12,67,0,inf
25122,66,13,79,0,inf
25123,58,6,64,0,inf
25124,51,11,62,0,inf
25125,56,10,66,0,inf
25126,50,6,56,0,inf
25127,55,12,67,0,inf
25128,58,6,64,0,inf
25129,57,6,63,0,inf
25130,63,6,69,0,inf
25131,52,6,58,0,inf
25132,67,13,80,0,inf
25133,50,11,61,0,inf
25134,56,11,67,0,inf
25135,55,6,61,0,inf
25136,54,10,64,0,inf
25137,57,11,68,0,inf
25138,54,5,59,0,inf
25139,58,12,70,0,inf
25140,66,13,79,0,inf
25141,50,13,63,0,inf
25142,65,6,71,0,inf
25143,54,8,62,0,inf
25144,54,10,64,0,inf
25145,66,6,72,0,inf
25146,64,7,71,0,inf
25147,61,6,67,0,inf
25148,54,11,65,0,inf
25149,56,13,69,0,inf
25150,64,9,73,0,inf
25151,50,7,57,0,inf
25152,61,13,74,0,inf
25153,63,11,74,0,inf
25154,50,13,63,0,inf
25155,67,13,80,0,inf
25156,55,5,60,0,inf
25157,61,10,71,0,inf
25158,64,8,72,0,inf
25159,61,8,69,0,inf
25160,50,13,63,0,inf
25161,63,13,76,0,inf
25162,64,5,69,0,inf
25163,66,7,73,0,inf
25164,67,8,75,0,inf
25165,57,8,65,0,inf
25166,55,7,62,0,inf
25167,63,6,69,0,inf
25168,63,7,70,0,inf
25169,51,12,63,0,inf
25170,50,7,57,0,inf
25171,67,10,77,0,inf
25172,50,12,62,0,inf
25173,54,13,67,0,inf
25174,59,11,70,0,inf
25175,61,13,74,0,inf
25176,59,11,70,0,inf
25177,51,13,64,0,inf
25178,50,5,55,0,inf
25179,56,12,68,0,inf
25180,52,7,59,0,inf
25181,52,10,62,0,inf
25182,55,7,62,0,inf
25183,61,7,68,0,inf
25184,56,6,62,0,inf
25185,64,6,70,0,inf
25186,66,7,73,0,inf
25187,62,11,73,0,inf
25188,62,10,72,0,inf
25189,67,7,74,0,inf
25190,62,11,73,0,inf
25191,54,8,62,0,inf
25192,66,6,72,0,inf
25193,66,10,76,0,inf
25194,51,8,59,0,inf
25195,50,11,61,0,inf
25196,63,9,72,0,inf
25197,60,7,67,0,inf
25198,51,5,56,0,inf
25199,52,11,63,0,inf
25200,51,8,59,0,inf
25201,55,6,61,0,inf
25202,58,5,63,0,inf
25203,55,6,61,0,inf
25204,57,12,69,0,inf
25205,65,6,71,0,inf
25206,55,7,62,0,inf
25207,50,5,55,0,inf
25208,54,9,63,0,inf
25209,51,9,60,0,inf
25210,53,10,63,0,inf
25211,61,11,72,0,inf
25212,63,13,76,0,inf
25213,63,13,76,0,inf
25214,67,13,80,0,inf
25215,54,6,60,0,inf
25216,58,11,69,0,inf
25217,57,9,66,0,inf
25218,63,6,69,0,inf
25219,50,8,58,0,inf
25220,53,9,62,0,inf
25221,61,11,72,0,inf
25222,56,5,61,0,inf
25223,66,13,79,0,inf
25224,61,8,69,0,inf
25225,60,7,67,0,inf
25226,63,13,76,0,inf
25227,64,11,75,0,inf
25228,59,12,71,0,inf
25229,60,11,71,0,inf
25230,65,10,75,0,inf
25231,56,9,65,0,inf
25232,51,9,60,0,inf
25233,55,10,65,0,inf
25234,63,8,71,0,inf
25235,55,12,67,0,inf
25236,61,6,67,0,inf
25237,63,6,69,0,inf
25238,63,10,73,0,inf
25239,66,5,71,0,inf
25240,51,13,64,0,inf
25241,56,13,69,0,inf
25242,56,9,65,0,inf
25243,53,12,65,0,inf
25244,66,10,76,0,inf
25245,58,7,65,0,inf
25246,56,11,67,0,inf
25247,64,13,77,0,inf
25248,64,11,75,0,inf
25249,55,13,68,0,inf
25250,62,8,70,0,inf
25251,64,6,70,0,inf
25252,54,8,62,0,inf
25253,56,12,68,0,inf
25254,64,13,77,0,inf
25255,58,7,65,0,inf
25256,63,7,70,0,inf
25257,59,12,71,0,inf
25258,57,6,63,0,inf
25259,50,12,62,0,inf
25260,61,8,69,0,inf
25261,58,7,65,0,inf
25262,51,8,59,0,inf
25263,58,7,65,0,inf
25264,56,6,62,0,inf
25265,55,13,68,0,inf
25266,57,8,65,0,inf
25267,52,6,58,0,inf
25268,62,9,71,0,inf
25269,51,10,61,0,inf
25270,52,9,61,0,inf
25271,60,6,66,0,inf
25272,63,11,74,0,inf
25273,51,6,57,0,inf
25274,51,6,57,0,inf
25275,57,9,66,0,inf
25276,55,6,61,0,inf
25277,64,6,70,0,inf
25278,58,9,67,0,inf
25279,61,7,68,0,inf
25280,53,13,66,0,inf
25281,64,11,75,0,inf
25282,57,7,64,0,inf
25283,52,9,61,0,inf
25284,57,6,63,0,inf
25285,62,5,67,0,inf
25286,58,5,63,0,inf
25287,61,10,71,0,inf
25288,63,13,76,0,inf
25289,60,6,66,0,inf
25290,62,6,68,0,inf
25291,67,11,78,0,inf
25292,55,12,67,0,inf
25293,62,10,72,0,inf
25294,62,11,73,0,inf
25295,62,13,75,0,inf
25296,56,11,67,0,inf
25297,54,7,61,0,inf
25298,63,9,72,0,inf
25299,51,10,61,0,inf
25300,53,10,63,0,inf
25301,61,9,70,0,inf
25302,61,13,74,0,inf
25303,63,12,75,0,inf
25304,52,13,65,0,inf
25305,63,6,69,0,inf
25306,60,9,69,0,inf
25307,55,5,60,0,inf
25308,59,10,69,0,inf
25309,52,5,57,0,inf
25310,57,8,65,0,inf
25311,61,13,74,0,inf
25312,66,7,73,0,inf
25313,56,8,64,0,inf
25314,64,8,72,0,inf
25315,63,8,71,0,inf
25316,51,5,56,0,inf
25317,55,12,67,1,5.527044026787934
25318,61,5,66,0,inf
25319,61,8,69,0,inf
25320,54,9,63,0,inf
25321,53,10,63,0,inf
25322,57,13,70,0,inf
25323,63,11,74,0,inf
25324,51,9,60,0,inf
25325,54,8,62,1,0.7354873428628679
25326,62,13,75,0,inf
25327,66,5,71,0,inf
25328,53,7,60,0,inf
25329,64,10,74,0,inf
25330,55,9,64,0,inf
25331,62,5,67,0,inf
25332,61,13,74,0,inf
25333,67,13,80,0,inf
25334,55,12,67,0,inf
25335,62,10,72,0,inf
25336,51,9,60,0,inf
25337,63,8,71,0,inf
25338,54,5,59,0,inf
25339,63,8,71,0,inf
25340,60,7,67,0,inf
25341,52,7,59,0,inf
25342,53,10,63,0,inf
25343,63,6,69,0,inf
25344,51,8,59,0,inf
25345,50,13,63,0,inf
25346,60,13,73,0,inf
25347,51,6,57,0,inf
25348,53,12,65,0,inf
25349,56,12,68,0,inf
25350,67,9,76,0,inf
25351,63,10,73,0,inf
25352,59,9,68,0,inf
25353,63,5,68,0,inf
25354,60,9,69,0,inf
25355,60,8,68,0,inf
25356,50,9,59,0,inf
25357,64,11,75,0,inf
25358,60,9,69,0,inf
25359,66,6,72,0,inf
25360,59,13,72,0,inf
25361,50,10,60,0,inf
25362,64,5,69,0,inf
25363,65,6,71,0,inf
25364,66,13,79,0,inf
25365,50,5,55,0,inf
25366,56,5,61,0,inf
25367,53,10,63,0,inf
25368,59,8,67,0,inf
25369,61,10,71,0,inf
25370,51,13,64,0,inf
25371,64,5,69,0,inf
25372,56,9,65,0,inf
25373,65,10,75,0,inf
25374,64,12,76,0,inf
25375,59,10,69,0,inf
25376,66,8,74,0,inf
25377,51,13,64,0,inf
25378,61,13,74,0,inf
25379,61,13,74,0,inf
25380,64,12,76,1,9.968517926412133
25381,52,10,62,0,inf
25382,67,6,73,0,inf
25383,55,7,62,0,inf
25384,63,13,76,0,inf
25385,54,12,66,0,inf
25386,60,13,73,0,inf
25387,56,10,66,0,inf
25388,66,6,72,0,inf
25389,62,10,72,0,inf
25390,60,13,73,0,inf
25391,55,12,67,1,7.419685957629689
25392,55,8,63,0,inf
25393,65,11,76,0,inf
25394,51,8,59,0,inf
25395,57,13,70,0,inf
25396,57,9,66,0,inf
25397,65,11,76,0,inf
25398,64,5,69,0,inf
25399,61,11,72,0,inf
25400,51,11,62,0,inf
25401,66,9,75,0,inf
25402,52,9,61,0,inf
25403,58,9,67,0,inf
25404,53,8,61,0,inf
25405,60,7,67,0,inf
25406,66,11,77,0,inf
25407,54,7,61,0,inf
25408,55,8,63,0,inf
25409,53,7,60,0,inf
25410,57,9,66,0,inf
25411,50,5,55,0,inf
25412,53,6,59,0,inf
25413,54,5,59,0,inf
25414,64,6,70,0,inf
25415,64,11,75,0,inf
25416,52,12,64,0,inf
25417,52,13,65,0,inf
25418,55,7,62,0,inf
25419,59,7,66,0,inf
25420,62,8,70,0,inf
25421,67,9,76,0,inf
25422,52,8,60,0,inf
25423,50,12,62,0,inf
25424,54,10,64,0,inf
25425,56,11,67,0,inf
25426,61,11,72,0,inf
25427,64,6,70,0,inf
25428,57,12,69,0,inf
25429,51,9,60,0,inf
25430,50,13,63,0,inf
25431,66,6,72,0,inf
25432,51,7,58,0,inf
25433,51,6,57,0,inf
25434,53,10,63,0,inf
25435,52,9,61,0,inf
25436,57,8,65,0,inf
25437,65,13,78,0,inf
25438,50,10,60,0,inf
25439,63,7,70,0,inf
25440,64,11,75,0,inf
25441,61,11,72,0,inf
25442,61,8,69,0,inf
25443,64,12,76,0,inf
25444,62,12,74,0,inf
25445,63,12,75,1,1.4046814926221458
25446,51,11,62,0,inf
25447,60,8,68,0,inf
25448,62,13,75,0,inf
25449,64,7,71,0,inf
25450,53,12,65,0,inf
25451,62,7,69,0,inf
25452,58,6,64,0,inf
25453,67,10,77,0,inf
25454,51,11,62,0,inf
25455,64,5,69,0,inf
25456,52,10,62,0,inf
25457,51,13,64,0,inf
25458,64,5,69,0,inf
25459,54,11,65,0,inf
25460,54,12,66,0,inf
25461,62,9,71,0,inf
25462,59,5,64,0,inf
25463,57,13,70,0,inf
25464,58,7,65,0,inf
25465,54,12,66,0,inf
25466,63,6,69,0,inf
25467,67,7,74,0,inf
25468,53,7,60,0,inf
25469,56,5,61,0,inf
25470,67,8,75,0,inf
25471,50,7,57,0,inf
25472,54,9,63,0,inf
25473,62,13,75,0,inf
25474,67,5,72,0,inf
25475,50,13,63,0,inf
25476,64,11,75,0,inf
25477,60,11,71,0,inf
25478,61,8,69,0,inf
25479,62,9,71,0,inf
25480,66,13,79,0,inf
25481,59,13,72,0,inf
25482,64,9,73,0,inf
25483,61,9,70,0,inf
25484,56,11,67,0,inf
25485,64,8,72,0,inf
25486,64,12,76,0,inf
25487,58,13,71,0,inf
25488,58,13,71,0,inf
25489,66,12,78,0,inf
25490,55,10,65,0,inf
25491,53,11,64,0,inf
25492,64,8,72,0,inf
25493,60,7,67,0,inf
25494,60,13,73,0,inf
25495,50,13,63,0,inf
25496,55,5,60,0,inf
25497,58,11,69,0,inf
25498,62,6,68,0,inf
25499,62,8,70,0,inf
25500,54,10,64,0,inf
25501,59,6,65,0,inf
25502,50,8,58,0,inf
25503,57,13,70,0,inf
25504,62,12,74,0,inf
25505,58,13,71,0,inf
25506,66,10,76,0,inf
25507,67,7,74,0,inf
25508,54,12,66,1,0.838683302505828
25509,59,8,67,0,inf
25510,57,10,67,0,inf
25511,67,7,74,0,inf
25512,62,10,72,0,inf
25513,63,7,70,0,inf
25514,54,6,60,0,inf
25515,53,13,66,0,inf
25516,50,5,55,0,inf
25517,60,10,70,0,inf
25518,63,5,68,0,inf
25519,51,10,61,0,inf
25520,64,10,74,0,inf
25521,50,8,58,0,inf
25522,63,6,69,0,inf
25523,55,11,66,0,inf
25524,50,12,62,0,inf
25525,52,8,60,0,inf
25526,67,7,74,0,inf
25527,61,6,67,0,inf
25528,59,12,71,0,inf
25529,50,8,58,0,inf
25530,53,6,59,0,inf
25531,52,10,62,0,inf
25532,52,5,57,0,inf
25533,51,11,62,0,inf
25534,61,12,73,0,inf
25535,58,9,67,0,inf
25536,54,6,60,0,inf
25537,59,5,64,0,inf
25538,66,10,76,0,inf
25539,55,10,65,0,inf
25540,63,9,72,0,inf
25541,54,6,60,0,inf
25542,62,9,71,0,inf
25543,60,13,73,0,inf
25544,61,5,66,0,inf
25545,56,8,64,0,inf
25546,66,10,76,0,inf
25547,57,6,63,0,inf
25548,64,5,69,0,inf
25549,58,5,63,0,inf
25550,60,12,72,0,inf
25551,61,10,71,0,inf
25552,53,9,62,0,inf
25553,63,6,69,0,inf
25554,63,11,74,0,inf
25555,59,8,67,0,inf
25556,53,6,59,0,inf
25557,64,12,76,0,inf
25558,59,9,68,0,inf
25559,52,12,64,0,inf
25560,54,8,62,0,inf
25561,62,12,74,0,inf
25562,52,5,57,0,inf
25563,56,5,61,0,inf
25564,59,10,69,0,inf
25565,56,9,65,0,inf
25566,63,9,72,0,inf
25567,56,10,66,0,inf
25568,52,5,57,0,inf
25569,60,8,68,0,inf
25570,64,8,72,0,inf
25571,50,7,57,0,inf
25572,52,9,61,0,inf
25573,60,10,70,0,inf
25574,52,5,57,0,inf
25575,58,9,67,0,inf
25576,60,11,71,0,inf
25577,63,12,75,0,inf
25578,61,7,68,0,inf
25579,63,8,71,0,inf
25580,67,7,74,0,inf
25581,54,7,61,0,inf
25582,58,8,66,0,inf
25583,61,13,74,0,inf
25584,58,11,69,0,inf
25585,57,10,67,0,inf
25586,52,13,65,0,inf
25587,58,11,69,0,inf
25588,50,9,59,0,inf
25589,67,12,79,1,1.3428198439863905
25590,62,12,74,0,inf
25591,64,10,74,0,inf
25592,63,6,69,0,inf
25593,55,13,68,0,inf
25594,50,7,57,0,inf
25595,57,9,66,0,inf
25596,51,13,64,0,inf
25597,50,8,58,0,inf
25598,63,6,69,0,inf
25599,52,6,58,1,5.842095486161725
25600,59,11,70,0,inf
25601,64,12,76,0,inf
25602,63,8,71,0,inf
25603,55,9,64,0,inf
25604,52,8,60,0,inf
25605,63,5,68,0,inf
25606,59,7,66,0,inf
25607,59,13,72,0,inf
25608,56,13,69,0,inf
25609,61,10,71,0,inf
25610,67,8,75,0,inf
25611,62,10,72,0,inf
25612,50,5,55,0,inf
25613,56,10,66,0,inf
25614,64,7,71,0,inf
25615,53,5,58,0,inf
25616,60,12,72,0,inf
25617,66,10,76,1,3.4365256445036323
25618,52,6,58,0,inf
25619,58,10,68,0,inf
25620,61,7,68,0,inf
25621,56,11,67,0,inf
25622,57,9,66,0,inf
25623,60,12,72,0,inf
25624,58,9,67,0,inf
25625,57,12,69,0,inf
25626,52,7,59,0,inf
25627,52,11,63,0,inf
25628,66,8,74,0,inf
25629,58,8,66,0,inf
25630,55,11,66,0,inf
25631,53,12,65,0,inf
25632,62,11,73,0,inf
25633,61,10,71,0,inf
25634,53,10,63,0,inf
25635,57,11,68,0,inf
25636,55,10,65,0,inf
25637,52,8,60,0,inf
25638,61,13,74,1,9.843265331028533
25639,56,10,66,0,inf
25640,66,9,75,0,inf
25641,51,9,60,0,inf
25642,53,13,66,0,inf
25643,65,11,76,1,2.216704223893089
25644,53,13,66,0,inf
25645,65,12,77,0,inf
25646,66,9,75,0,inf
25647,58,7,65,0,inf
25648,50,5,55,0,inf
25649,58,6,64,0,inf
25650,52,7,59,0,inf
25651,60,10,70,0,inf
25652,59,8,67,0,inf
25653,53,7,60,0,inf
25654,66,11,77,0,inf
25655,53,9,62,0,inf
25656,65,6,71,0,inf
25657,57,9,66,0,inf
25658,67,7,74,0,inf
25659,65,9,74,0,inf
25660,50,5,55,0,inf
25661,67,13,80,0,inf
25662,63,13,76,0,inf
25663,61,12,73,0,inf
25664,61,5,66,0,inf
25665,50,9,59,0,inf
25666,62,7,69,0,inf
25667,58,11,69,0,inf
25668,51,10,61,0,inf
25669,51,11,62,0,inf
25670,61,9,70,0,inf
25671,58,8,66,0,inf
25672,64,6,70,0,inf
25673,61,5,66,0,inf
25674,54,5,59,0,inf
25675,52,10,62,0,inf
25676,63,12,75,0,inf
25677,62,8,70,0,inf
25678,65,9,74,0,inf
25679,51,6,57,0,inf
25680,56,11,67,0,inf
25681,52,12,64,0,inf
25682,55,12,67,0,inf
25683,63,10,73,0,inf
25684,67,13,80,0,inf
25685,64,8,72,0,inf
25686,52,9,61,0,inf
25687,53,13,66,0,inf
25688,67,8,75,0,inf
25689,65,13,78,0,inf
25690,50,9,59,0,inf
25691,62,8,70,0,inf
25692,52,8,60,0,inf
25693,63,7,70,0,inf
25694,67,12,79,0,inf
25695,63,9,72,0,inf
25696,63,9,72,0,inf
25697,67,10,77,0,inf
25698,57,12,69,0,inf
25699,55,9,64,0,inf
25700,65,5,70,0,inf
25701,64,12,76,1,6.195755669447635
25702,61,10,71,0,inf
25703,60,7,67,0,inf
25704,58,8,66,0,inf
25705,57,8,65,0,inf
25706,65,12,77,0,inf
25707,56,8,64,0,inf
25708,67,7,74,0,inf
25709,60,6,66,0,inf
25710,58,6,64,0,inf
25711,65,9,74,0,inf
25712,57,5,62,0,inf
25713,64,11,75,0,inf
25714,56,7,63,0,inf
25715,62,9,71,0,inf
25716,64,12,76,0,inf
25717,51,6,57,0,inf
25718,57,13,70,0,inf
25719,58,8,66,0,inf
25720,52,9,61,0,inf
25721,59,8,67,0,inf
25722,58,11,69,0,inf
25723,54,6,60,0,inf
25724,55,8,63,0,inf
25725,56,12,68,0,inf
25726,53,5,58,0,inf
25727,59,13,72,0,inf
25728,67,5,72,0,inf
25729,54,8,62,0,inf
25730,56,13,69,0,inf
25731,67,9,76,0,inf
25732,50,7,57,0,inf
25733,58,8,66,0,inf
25734,58,12,70,0,inf
25735,61,9,70,0,inf
25736,61,6,67,0,inf
25737,61,12,73,0,inf
25738,50,12,62,0,inf
25739,62,5,67,0,inf
25740,55,10,65,0,inf
25741,62,11,73,0,inf
25742,56,11,67,0,inf
25743,63,9,72,0,inf
25744,52,9,61,0,inf
25745,64,8,72,0,inf
25746,62,11,73,0,inf
25747,56,9,65,0,inf
25748,51,12,63,0,inf
25749,56,13,69,1,7.617828459230481
25750,52,7,59,0,inf
25751,53,13,66,0,inf
25752,54,9,63,0,inf
25753,59,5,64,0,inf
25754,63,9,72,0,inf
25755,53,10,63,0,inf
25756,54,12,66,0,inf
25757,61,6,67,0,inf
25758,67,8,75,0,inf
25759,59,12,71,0,inf
25760,64,9,73,0,inf
25761,57,13,70,0,inf
25762,56,13,69,0,inf
25763,59,5,64,0,inf
25764,67,13,80,0,inf
25765,53,13,66,0,inf
25766,63,13,76,0,inf
25767,57,8,65,0,inf
25768,63,7,70,0,inf
25769,62,9,71,0,inf
25770,62,11,73,0,inf
25771,58,12,70,0,inf
25772,65,12,77,1,0.7450801978601476
25773,51,7,58,0,inf
25774,50,6,56,0,inf
25775,53,5,58,0,inf
25776,67,10,77,0,inf
25777,66,12,78,0,inf
25778,61,7,68,0,inf
25779,59,10,69,0,inf
25780,55,9,64,0,inf
25781,64,10,74,0,inf
25782,54,11,65,0,inf
25783,55,10,65,0,inf
25784,64,12,76,0,inf
25785,52,9,61,0,inf
25786,63,8,71,0,inf
25787,62,12,74,0,inf
25788,63,13,76,0,inf
25789,67,12,79,0,inf
25790,58,13,71,0,inf
25791,60,7,67,0,inf
25792,55,6,61,0,inf
25793,56,9,65,0,inf
25794,54,8,62,0,inf
25795,53,6,59,0,inf
25796,61,9,70,0,inf
25797,61,5,66,0,inf
25798,64,7,71,0,inf
25799,64,12,76,0,inf
25800,59,7,66,0,inf
25801,54,13,67,0,inf
25802,64,11,75,0,inf
25803,59,11,70,0,inf
25804,53,6,59,0,inf
25805,50,12,62,0,inf
25806,60,5,65,0,inf
25807,67,11,78,0,inf
25808,53,6,59,0,inf
25809,60,12,72,0,inf
25810,62,11,73,0,inf
25811,59,5,64,0,inf
25812,50,5,55,0,inf
25813,58,7,65,0,inf
25814,65,6,71,0,inf
25815,53,8,61,0,inf
25816,64,7,71,0,inf
25817,59,10,69,0,inf
25818,59,8,67,0,inf
25819,50,13,63,0,inf
25820,60,5,65,0,inf
25821,59,9,68,0,inf
25822,56,7,63,0,inf
25823,62,6,68,0,inf
25824,61,6,67,0,inf
25825,60,10,70,0,inf
25826,61,5,66,0,inf
25827,64,9,73,0,inf
25828,58,13,71,0,inf
25829,66,8,74,0,inf
25830,60,9,69,0,inf
25831,63,5,68,0,inf
25832,50,13,63,0,inf
25833,66,9,75,0,inf
25834,55,12,67,0,inf
25835,54,5,59,0,inf
25836,67,7,74,0,inf
25837,56,11,67,0,inf
25838,59,5,64,0,inf
25839,52,6,58,0,inf
25840,50,5,55,0,inf
25841,63,5,68,0,inf
25842,56,5,61,0,inf
25843,60,10,70,0,inf
25844,64,8,72,0,inf
25845,63,11,74,0,inf
25846,57,8,65,1,7.803891531882755
25847,52,8,60,0,inf
25848,51,13,64,0,inf
25849,63,6,69,0,inf
25850,50,11,61,0,inf
25851,66,5,71,0,inf
25852,57,7,64,0,inf
25853,54,7,61,0,inf
25854,50,12,62,0,inf
25855,63,13,76,0,inf
25856,50,9,59,0,inf
25857,50,7,57,0,inf
25858,56,7,63,0,inf
25859,65,7,72,0,inf
25860,59,6,65,0,inf
25861,51,9,60,0,inf
25862,65,10,75,0,inf
25863,61,7,68,0,inf
25864,63,12,75,0,inf
25865,50,8,58,0,inf
25866,54,10,64,0,inf
25867,51,11,62,0,inf
25868,67,6,73,0,inf
25869,59,7,66,0,inf
25870,60,8,68,0,inf
25871,56,11,67,0,inf
25872,53,13,66,0,inf
25873,61,12,73,0,inf
25874,63,5,68,0,inf
25875,50,8,58,0,inf
25876,59,10,69,0,inf
25877,56,8,64,0,inf
25878,53,10,63,0,inf
25879,66,9,75,0,inf
25880,57,7,64,0,inf
25881,63,5,68,0,inf
25882,56,9,65,0,inf
25883,66,10,76,0,inf
25884,63,12,75,0,inf
25885,52,11,63,0,inf
25886,50,7,57,0,inf
25887,54,11,65,0,inf
25888,66,5,71,0,inf
25889,55,6,61,0,inf
25890,55,8,63,0,inf
25891,67,11,78,0,inf
25892,61,8,69,0,inf
25893,60,6,66,0,inf
25894,52,11,63,0,inf
25895,65,10,75,0,inf
25896,66,6,72,0,inf
25897,60,12,72,0,inf
25898,54,5,59,0,inf
25899,51,8,59,0,inf
25900,67,7,74,0,inf
25901,50,7,57,0,inf
25902,52,5,57,0,inf
25903,56,8,64,0,inf
25904,59,11,70,0,inf
25905,64,9,73,0,inf
25906,62,8,70,0,inf
25907,62,10,72,0,inf
25908,62,13,75,0,inf
25909,51,5,56,0,inf
25910,63,10,73,0,inf
25911,60,13,73,0,inf
25912,60,7,67,0,inf
25913,53,9,62,0,inf
25914,55,10,65,0,inf
25915,57,6,63,0,inf
25916,55,12,67,0,inf
25917,63,13,76,0,inf
25918,63,12,75,0,inf
25919,56,10,66,0,inf
25920,54,7,61,0,inf
25921,66,13,79,0,inf
25922,65,6,71,0,inf
25923,52,12,64,0,inf
25924,63,7,70,0,inf
25925,55,8,63,0,inf
25926,54,9,63,0,inf
25927,67,7,74,0,inf
25928,64,11,75,0,inf
25929,56,7,63,0,inf
25930,63,10,73,0,inf
25931,67,10,77,0,inf
25932,67,5,72,0,inf
25933,65,11,76,0,inf
25934,54,12,66,0,inf
25935,66,7,73,0,inf
25936,57,9,66,0,inf
25937,58,5,63,0,inf
25938,61,8,69,0,inf
25939,63,7,70,0,inf
25940,55,12,67,0,inf
25941,64,7,71,0,inf
25942,66,13,79,0,inf
25943,52,13,65,0,inf
25944,51,13,64,0,inf
25945,65,6,71,0,inf
25946,67,11,78,0,inf
25947,55,12,67,0,inf
25948,59,11,70,0,inf
25949,55,6,61,0,inf
25950,67,5,72,0,inf
25951,57,8,65,0,inf
25952,60,9,69,0,inf
25953,56,7,63,0,inf
25954,52,12,64,0,inf
25955,51,9,60,0,inf
25956,54,8,62,0,inf
25957,60,9,69,0,inf
25958,50,10,60,0,inf
25959,51,12,63,0,inf
25960,64,13,77,0,inf
25961,55,13,68,0,inf
25962,50,7,57,0,inf
25963,61,13,74,0,inf
25964,67,12,79,0,inf
25965,51,13,64,0,inf
25966,54,5,59,0,inf
25967,58,11,69,1,3.296866400306037
25968,54,6,60,0,inf
25969,67,6,73,0,inf
25970,58,12,70,0,inf
25971,51,10,61,0,inf
25972,54,10,64,1,7.826078725162297
25973,62,5,67,0,inf
25974,61,11,72,0,inf
25975,53,12,65,0,inf
25976,57,6,63,0,inf
25977,64,6,70,0,inf
25978,51,13,64,0,inf
25979,58,6,64,0,inf
25980,56,13,69,0,inf
25981,52,12,64,0,inf
25982,56,12,68,0,inf
25983,66,10,76,0,inf
25984,65,12,77,0,inf
25985,51,13,64,0,inf
25986,64,6,70,0,inf
25987,55,5,60,0,inf
25988,60,11,71,0,inf
25989,64,13,77,0,inf
25990,65,13,78,0,inf
25991,59,9,68,0,inf
25992,54,11,65,0,inf
25993,53,6,59,0,inf
25994,54,10,64,0,inf
25995,64,8,72,0,inf
25996,58,10,68,0,inf
25997,51,8,59,0,inf
25998,56,9,65,1,4.519652992219683
25999,59,7,66,0,inf
26000,62,13,75,0,inf
26001,59,6,65,0,inf
26002,51,6,57,0,inf
26003,61,7,68,0,inf
26004,61,11,72,0,inf
26005,60,7,67,0,inf
26006,51,11,62,0,inf
26007,57,10,67,0,inf
26008,55,7,62,0,inf
26009,63,6,69,0,inf
26010,60,8,68,0,inf
26011,60,10,70,0,inf
26012,58,5,63,0,inf
26013,50,13,63,0,inf
26014,52,10,62,0,inf
26015,65,7,72,0,inf
26016,67,7,74,0,inf
26017,53,8,61,0,inf
26018,62,8,70,0,inf
26019,67,11,78,0,inf
26020,64,5,69,0,inf
26021,56,13,69,0,inf
26022,61,8,69,0,inf
26023,62,6,68,0,inf
26024,52,9,61,1,7.854015129257803
26025,55,7,62,0,inf
26026,56,13,69,0,inf
26027,54,6,60,0,inf
26028,65,13,78,0,inf
26029,63,9,72,0,inf
26030,57,8,65,0,inf
26031,67,10,77,0,inf
26032,50,11,61,0,inf
26033,58,9,67,0,inf
26034,56,5,61,0,inf
26035,56,12,68,0,inf
26036,63,10,73,0,inf
26037,51,9,60,0,inf
26038,66,13,79,0,inf
26039,66,9,75,0,inf
26040,67,10,77,0,inf
26041,64,11,75,0,inf
26042,50,5,55,0,inf
26043,59,8,67,0,inf
26044,62,6,68,0,inf
26045,54,9,63,0,inf
26046,57,12,69,0,inf
26047,52,6,58,0,inf
26048,51,9,60,0,inf
26049,62,7,69,0,inf
26050,63,6,69,0,inf
26051,54,11,65,0,inf
26052,64,9,73,0,inf
26053,53,13,66,0,inf
26054,57,6,63,0,inf
26055,64,7,71,0,inf
26056,56,11,67,0,inf
26057,52,5,57,0,inf
26058,62,10,72,0,inf
26059,54,13,67,0,inf
26060,66,8,74,0,inf
26061,64,11,75,0,inf
26062,50,5,55,0,inf
26063,59,11,70,0,inf
26064,61,7,68,0,inf
26065,50,9,59,0,inf
26066,59,7,66,0,inf
26067,60,6,66,0,inf
26068,66,10,76,0,inf
26069,55,10,65,0,inf
26070,54,6,60,0,inf
26071,55,12,67,0,inf
26072,63,7,70,0,inf
26073,67,6,73,0,inf
26074,54,10,64,0,inf
26075,53,11,64,0,inf
26076,53,6,59,0,inf
26077,59,6,65,0,inf
26078,66,11,77,0,inf
26079,55,5,60,0,inf
26080,61,6,67,0,inf
26081,50,7,57,0,inf
26082,67,12,79,0,inf
26083,59,11,70,0,inf
26084,60,7,67,0,inf
26085,66,12,78,0,inf
26086,51,9,60,0,inf
26087,59,11,70,0,inf
26088,62,5,67,0,inf
26089,65,13,78,0,inf
26090,66,10,76,0,inf
26091,50,8,58,0,inf
26092,50,12,62,0,inf
26093,63,5,68,0,inf
26094,60,11,71,0,inf
26095,64,8,72,0,inf
26096,50,5,55,0,inf
26097,64,6,70,0,inf
26098,53,12,65,0,inf
26099,56,11,67,0,inf
26100,58,8,66,0,inf
26101,53,11,64,0,inf
26102,56,13,69,0,inf
26103,64,11,75,0,inf
26104,64,10,74,0,inf
26105,51,11,62,0,inf
26106,60,9,69,0,inf
26107,52,6,58,0,inf
26108,61,5,66,0,inf
26109,56,9,65,0,inf
26110,66,8,74,0,inf
26111,59,7,66,0,inf
26112,65,6,71,0,inf
26113,54,9,63,0,inf
26114,59,12,71,0,inf
26115,57,5,62,0,inf
26116,66,13,79,0,inf
26117,51,10,61,0,inf
26118,64,9,73,0,inf
26119,52,9,61,0,inf
26120,60,5,65,0,inf
26121,56,10,66,0,inf
26122,50,5,55,0,inf
26123,66,13,79,0,inf
26124,65,9,74,0,inf
26125,56,8,64,0,inf
26126,64,6,70,0,inf
26127,64,8,72,0,inf
26128,57,12,69,0,inf
26129,58,6,64,0,inf
26130,64,5,69,0,inf
26131,56,7,63,0,inf
26132,66,12,78,0,inf
26133,67,13,80,0,inf
26134,56,11,67,0,inf
26135,65,6,71,0,inf
26136,59,6,65,0,inf
26137,59,12,71,0,inf
26138,67,7,74,0,inf
26139,52,6,58,0,inf
26140,51,10,61,0,inf
26141,66,13,79,0,inf
26142,52,10,62,0,inf
26143,50,7,57,0,inf
26144,52,6,58,0,inf
26145,50,13,63,0,inf
26146,51,11,62,0,inf
26147,56,9,65,0,inf
26148,59,10,69,0,inf
26149,67,6,73,0,inf
26150,53,5,58,0,inf
26151,55,10,65,0,inf
26152,54,5,59,0,inf
26153,58,11,69,0,inf
26154,59,8,67,0,inf
26155,55,9,64,0,inf
26156,50,12,62,0,inf
26157,60,12,72,0,inf
26158,50,13,63,0,inf
26159,53,7,60,0,inf
26160,59,10,69,0,inf
26161,56,13,69,0,inf
26162,64,6,70,0,inf
26163,67,10,77,0,inf
26164,51,6,57,0,inf
26165,50,9,59,0,inf
26166,64,11,75,0,inf
26167,61,7,68,0,inf
26168,63,7,70,0,inf
26169,66,7,73,1,5.550901512227199
26170,52,7,59,0,inf
26171,51,12,63,0,inf
26172,60,12,72,0,inf
26173,58,9,67,0,inf
26174,63,11,74,0,inf
26175,57,12,69,0,inf
26176,53,12,65,1,2.6309262961205846
26177,57,11,68,0,inf
26178,53,10,63,0,inf
26179,65,5,70,0,inf
26180,56,6,62,0,inf
26181,54,9,63,0,inf
26182,56,11,67,0,inf
26183,57,11,68,0,inf
26184,55,13,68,0,inf
26185,50,11,61,0,inf
26186,57,6,63,0,inf
26187,62,12,74,0,inf
26188,57,13,70,0,inf
26189,62,6,68,0,inf
26190,63,6,69,0,inf
26191,50,6,56,0,inf
26192,50,11,61,0,inf
26193,60,13,73,0,inf
26194,62,12,74,0,inf
26195,53,12,65,0,inf
26196,53,11,64,0,inf
26197,52,10,62,0,inf
26198,61,9,70,1,3.539012893653023
26199,52,13,65,0,inf
26200,59,10,69,0,inf
26201,58,11,69,0,inf
26202,61,10,71,0,inf
26203,50,11,61,0,inf
26204,60,12,72,0,inf
26205,66,11,77,0,inf
26206,57,5,62,0,inf
26207,57,10,67,0,inf
26208,62,10,72,0,inf
26209,60,6,66,0,inf
26210,60,12,72,0,inf
26211,56,13,69,0,inf
26212,63,6,69,0,inf
26213,55,8,63,0,inf
26214,59,6,65,0,inf
26215,67,12,79,0,inf
26216,54,12,66,0,inf
26217,63,12,75,0,inf
26218,64,10,74,0,inf
26219,62,10,72,0,inf
26220,56,7,63,0,inf
26221,50,5,55,0,inf
26222,58,10,68,0,inf
26223,50,12,62,0,inf
26224,60,10,70,0,inf
26225,62,6,68,0,inf
26226,58,5,63,0,inf
26227,57,6,63,0,inf
26228,64,9,73,0,inf
26229,58,13,71,0,inf
26230,52,12,64,0,inf
26231,65,10,75,0,inf
26232,62,13,75,0,inf
26233,52,9,61,0,inf
26234,65,5,70,0,inf
26235,55,5,60,0,inf
26236,54,13,67,0,inf
26237,58,5,63,0,inf
26238,52,6,58,0,inf
26239,62,12,74,0,inf
26240,62,11,73,0,inf
26241,59,11,70,0,inf
26242,50,5,55,0,inf
26243,60,7,67,0,inf
26244,50,10,60,0,inf
26245,54,8,62,0,inf
26246,56,5,61,0,inf
26247,63,7,70,0,inf
26248,64,6,70,0,inf
26249,65,12,77,0,inf
26250,67,13,80,0,inf
26251,66,10,76,0,inf
26252,51,5,56,0,inf
26253,55,12,67,0,inf
26254,62,8,70,0,inf
26255,61,6,67,0,inf
26256,65,5,70,1,1.6413841858015843
26257,62,11,73,0,inf
26258,57,6,63,0,inf
26259,67,8,75,0,inf
26260,61,13,74,0,inf
26261,54,7,61,0,inf
26262,60,12,72,0,inf
26263,63,6,69,0,inf
26264,58,8,66,0,inf
26265,58,7,65,0,inf
26266,51,8,59,0,inf
26267,66,13,79,0,inf
26268,54,5,59,0,inf
26269,66,12,78,0,inf
26270,56,11,67,0,inf
26271,52,6,58,0,inf
26272,66,11,77,0,inf
26273,50,6,56,0,inf
26274,59,7,66,0,inf
26275,55,6,61,0,inf
26276,54,6,60,0,inf
26277,52,11,63,0,inf
26278,52,7,59,0,inf
26279,50,9,59,0,inf
26280,55,7,62,0,inf
26281,62,9,71,0,inf
26282,64,7,71,0,inf
26283,65,7,72,0,inf
26284,56,11,67,0,inf
26285,61,6,67,0,inf
26286,61,8,69,0,inf
26287,60,8,68,0,inf
26288,52,9,61,0,inf
26289,61,5,66,0,inf
26290,55,8,63,0,inf
26291,60,13,73,0,inf
26292,51,7,58,0,inf
26293,50,10,60,0,inf
26294,61,11,72,0,inf
26295,67,9,76,0,inf
26296,67,10,77,0,inf
26297,55,11,66,0,inf
26298,52,11,63,0,inf
26299,55,9,64,0,inf
26300,53,6,59,0,inf
26301,55,9,64,0,inf
26302,61,9,70,0,inf
26303,53,8,61,0,inf
26304,66,9,75,0,inf
26305,65,9,74,0,inf
26306,66,10,76,0,inf
26307,59,5,64,0,inf
26308,66,13,79,0,inf
26309,64,9,73,1,0.4349000448833493
26310,54,12,66,0,inf
26311,59,9,68,0,inf
26312,64,8,72,0,inf
26313,61,10,71,0,inf
26314,59,11,70,0,inf
26315,58,6,64,1,2.0534880061673917
26316,56,8,64,0,inf
26317,59,5,64,0,inf
26318,56,6,62,0,inf
26319,63,5,68,0,inf
26320,67,11,78,0,inf
26321,58,10,68,0,inf
26322,61,10,71,0,inf
26323,61,12,73,0,inf
26324,50,6,56,0,inf
26325,56,7,63,0,inf
26326,56,5,61,0,inf
26327,65,11,76,0,inf
26328,56,5,61,0,inf
26329,51,12,63,0,inf
26330,67,10,77,0,inf
26331,51,7,58,0,inf
26332,56,12,68,0,inf
26333,51,7,58,0,inf
26334,65,9,74,1,3.0019378763989835
26335,53,5,58,0,inf
26336,63,12,75,0,inf
26337,58,8,66,0,inf
26338,55,5,60,0,inf
26339,63,11,74,0,inf
26340,60,13,73,0,inf
26341,51,8,59,0,inf
26342,54,13,67,0,inf
26343,65,12,77,1,11.263876197025297
26344,55,12,67,0,inf
26345,56,10,66,0,inf
26346,50,10,60,0,inf
26347,61,6,67,0,inf
26348,53,8,61,0,inf
26349,55,13,68,0,inf
26350,53,13,66,0,inf
26351,56,6,62,0,inf
26352,50,11,61,0,inf
26353,58,12,70,0,inf
26354,60,12,72,0,inf
26355,50,8,58,0,inf
26356,61,6,67,0,inf
26357,57,5,62,0,inf
26358,53,13,66,0,inf
26359,61,12,73,0,inf
26360,53,10,63,0,inf
26361,52,12,64,0,inf
26362,60,11,71,0,inf
26363,55,11,66,0,inf
26364,61,8,69,0,inf
26365,63,11,74,0,inf
26366,64,13,77,0,inf
26367,62,7,69,1,6.125253227450088
26368,61,5,66,0,inf
26369,55,13,68,0,inf
26370,54,11,65,0,inf
26371,52,12,64,0,inf
26372,58,6,64,0,inf
26373,65,10,75,1,3.5003255710572034
26374,54,9,63,0,inf
26375,58,13,71,0,inf
26376,62,8,70,0,inf
26377,55,8,63,0,inf
26378,61,10,71,0,inf
26379,62,9,71,0,inf
26380,52,8,60,0,inf
26381,62,5,67,0,inf
26382,67,7,74,0,inf
26383,54,7,61,0,inf
26384,60,5,65,0,inf
26385,50,9,59,0,inf
26386,60,6,66,0,inf
26387,61,6,67,0,inf
26388,50,9,59,0,inf
26389,63,8,71,0,inf
26390,56,12,68,0,inf
26391,52,13,65,0,inf
26392,53,9,62,0,inf
26393,64,12,76,0,inf
26394,59,7,66,0,inf
26395,67,7,74,0,inf
26396,56,8,64,0,inf
26397,52,13,65,0,inf
26398,64,9,73,0,inf
26399,59,5,64,0,inf
26400,53,13,66,0,inf
26401,53,7,60,0,inf
26402,66,8,74,0,inf
26403,58,12,70,0,inf
26404,64,11,75,0,inf
26405,50,12,62,0,inf
26406,52,9,61,0,inf
26407,65,10,75,0,inf
26408,57,10,67,0,inf
26409,56,7,63,0,inf
26410,66,6,72,0,inf
26411,67,6,73,0,inf
26412,54,13,67,0,inf
26413,55,8,63,0,inf
26414,50,11,61,0,inf
26415,66,12,78,0,inf
26416,60,10,70,0,inf
26417,55,5,60,0,inf
26418,60,5,65,0,inf
26419,56,10,66,0,inf
26420,52,5,57,0,inf
26421,64,10,74,0,inf
26422,52,7,59,0,inf
26423,61,11,72,0,inf
26424,65,6,71,0,inf
26425,64,6,70,0,inf
26426,67,8,75,0,inf
26427,59,9,68,0,inf
26428,50,8,58,0,inf
26429,53,13,66,0,inf
26430,57,9,66,0,inf
26431,52,13,65,0,inf
26432,57,8,65,0,inf
26433,67,10,77,0,inf
26434,61,12,73,0,inf
26435,52,12,64,0,inf
26436,61,7,68,1,6.668721249953819
26437,66,9,75,0,inf
26438,58,9,67,0,inf
26439,55,11,66,0,inf
26440,63,12,75,0,inf
26441,58,7,65,0,inf
26442,58,9,67,0,inf
26443,51,13,64,0,inf
26444,58,5,63,0,inf
26445,51,6,57,0,inf
26446,64,10,74,0,inf
26447,53,5,58,0,inf
26448,67,13,80,0,inf
26449,57,12,69,0,inf
26450,55,5,60,1,4.317590381806035
26451,58,8,66,0,inf
26452,51,11,62,0,inf
26453,60,10,70,0,inf
26454,60,9,69,0,inf
26455,66,10,76,0,inf
26456,57,6,63,0,inf
26457,52,13,65,0,inf
26458,51,11,62,0,inf
26459,66,11,77,0,inf
26460,60,11,71,0,inf
26461,54,13,67,0,inf
26462,55,13,68,0,inf
26463,57,13,70,0,inf
26464,58,12,70,0,inf
26465,53,9,62,0,inf
26466,50,13,63,0,inf
26467,60,13,73,0,inf
26468,51,11,62,0,inf
26469,51,7,58,0,inf
26470,59,7,66,0,inf
26471,59,7,66,0,inf
26472,50,7,57,0,inf
26473,67,13,80,0,inf
26474,61,11,72,0,inf
26475,50,7,57,0,inf
26476,51,7,58,0,inf
26477,67,10,77,0,inf
26478,57,6,63,0,inf
26479,61,8,69,0,inf
26480,65,11,76,0,inf
26481,65,7,72,0,inf
26482,61,8,69,0,inf
26483,55,10,65,0,inf
26484,59,10,69,0,inf
26485,53,11,64,1,10.3759106835994
26486,57,8,65,0,inf
26487,60,12,72,0,inf
26488,67,8,75,0,inf
26489,57,11,68,0,inf
26490,56,12,68,0,inf
26491,58,6,64,0,inf
26492,64,10,74,0,inf
26493,58,8,66,0,inf
26494,51,7,58,0,inf
26495,56,8,64,0,inf
26496,61,10,71,0,inf
26497,60,10,70,0,inf
26498,67,12,79,0,inf
26499,62,5,67,0,inf
26500,59,8,67,0,inf
26501,63,13,76,1,0.9058750482310813
26502,61,9,70,0,inf
26503,55,13,68,0,inf
26504,61,10,71,0,inf
26505,52,8,60,0,inf
26506,59,12,71,0,inf
26507,63,5,68,0,inf
26508,58,12,70,0,inf
26509,56,8,64,0,inf
26510,61,7,68,0,inf
26511,61,6,67,0,inf
26512,53,5,58,0,inf
26513,56,5,61,0,inf
26514,50,10,60,0,inf
26515,65,10,75,0,inf
26516,59,10,69,0,inf
26517,51,9,60,0,inf
26518,65,8,73,0,inf
26519,58,7,65,0,inf
26520,52,9,61,0,inf
26521,52,5,57,0,inf
26522,67,12,79,0,inf
26523,62,10,72,0,inf
26524,67,10,77,0,inf
26525,56,11,67,0,inf
26526,58,11,69,0,inf
26527,60,11,71,0,inf
26528,52,6,58,0,inf
26529,56,5,61,0,inf
26530,54,11,65,0,inf
26531,56,10,66,0,inf
26532,61,12,73,0,inf
26533,67,10,77,0,inf
26534,63,5,68,0,inf
26535,64,10,74,0,inf
26536,51,7,58,0,inf
26537,56,11,67,0,inf
26538,52,11,63,0,inf
26539,57,13,70,0,inf
26540,61,9,70,0,inf
26541,55,7,62,0,inf
26542,65,11,76,0,inf
26543,52,5,57,0,inf
26544,64,9,73,0,inf
26545,65,5,70,0,inf
26546,67,5,72,0,inf
26547,64,8,72,0,inf
26548,52,6,58,0,inf
26549,63,10,73,0,inf
26550,66,7,73,0,inf
26551,52,7,59,0,inf
26552,56,9,65,0,inf
26553,54,10,64,0,inf
26554,53,8,61,0,inf
26555,50,11,61,0,inf
26556,67,13,80,0,inf
26557,60,10,70,0,inf
26558,50,6,56,0,inf
26559,51,8,59,0,inf
26560,52,6,58,0,inf
26561,55,11,66,0,inf
26562,60,10,70,0,inf
26563,59,13,72,0,inf
26564,60,7,67,0,inf
26565,53,12,65,0,inf
26566,57,6,63,0,inf
26567,53,7,60,0,inf
26568,50,13,63,0,inf
26569,57,10,67,0,inf
26570,62,7,69,0,inf
26571,64,8,72,0,inf
26572,62,10,72,0,inf
26573,65,5,70,0,inf
26574,63,13,76,0,inf
26575,55,12,67,0,inf
26576,61,13,74,0,inf
26577,50,10,60,0,inf
26578,50,6,56,0,inf
26579,57,9,66,0,inf
26580,58,9,67,0,inf
26581,58,13,71,0,inf
26582,54,8,62,0,inf
26583,64,11,75,0,inf
26584,54,13,67,0,inf
26585,62,8,70,0,inf
26586,63,6,69,0,inf
26587,64,10,74,0,inf
26588,54,8,62,0,inf
26589,67,7,74,0,inf
26590,58,8,66,0,inf
26591,64,8,72,0,inf
26592,55,11,66,0,inf
26593,54,8,62,0,inf
26594,50,7,57,0,inf
26595,57,13,70,0,inf
26596,56,9,65,1,0.8036340831239599
26597,59,8,67,0,inf
26598,60,13,73,0,inf
26599,62,9,71,0,inf
26600,63,9,72,0,inf
26601,59,13,72,0,inf
26602,60,6,66,0,inf
26603,59,11,70,0,inf
26604,51,7,58,0,inf
26605,59,13,72,0,inf
26606,56,9,65,0,inf
26607,60,5,65,0,inf
26608,56,5,61,0,inf
26609,57,10,67,0,inf
26610,65,12,77,0,inf
26611,57,5,62,0,inf
26612,67,10,77,0,inf
26613,50,13,63,0,inf
26614,56,13,69,0,inf
26615,59,11,70,0,inf
26616,65,12,77,0,inf
26617,64,6,70,0,inf
26618,53,11,64,0,inf
26619,59,8,67,0,inf
26620,66,13,79,0,inf
26621,56,6,62,1,1.4722137408240599
26622,67,6,73,0,inf
26623,56,11,67,0,inf
26624,66,8,74,0,inf
26625,52,5,57,0,inf
26626,59,9,68,0,inf
26627,51,9,60,0,inf
26628,57,9,66,0,inf
26629,56,13,69,0,inf
26630,56,6,62,0,inf
26631,52,6,58,0,inf
26632,67,13,80,0,inf
26633,52,11,63,0,inf
26634,62,13,75,0,inf
26635,52,8,60,0,inf
26636,67,9,76,0,inf
26637,55,5,60,0,inf
26638,50,9,59,0,inf
26639,50,5,55,0,inf
26640,60,10,70,0,inf
26641,52,10,62,0,inf
26642,50,5,55,0,inf
26643,52,10,62,0,inf
26644,56,12,68,0,inf
26645,64,9,73,0,inf
26646,61,9,70,0,inf
26647,62,12,74,0,inf
26648,52,5,57,0,inf
26649,64,10,74,0,inf
26650,58,13,71,0,inf
26651,50,5,55,0,inf
26652,58,12,70,0,inf
26653,55,9,64,0,inf
26654,51,12,63,0,inf
26655,66,10,76,0,inf
26656,51,8,59,0,inf
26657,57,11,68,0,inf
26658,61,8,69,0,inf
26659,61,7,68,0,inf
26660,54,12,66,0,inf
26661,51,11,62,0,inf
26662,64,5,69,0,inf
26663,54,5,59,0,inf
26664,64,8,72,0,inf
26665,58,12,70,0,inf
26666,56,13,69,0,inf
26667,66,10,76,0,inf
26668,51,10,61,0,inf
26669,65,13,78,0,inf
26670,54,8,62,0,inf
26671,64,11,75,0,inf
26672,55,11,66,0,inf
26673,51,9,60,0,inf
26674,60,9,69,0,inf
26675,54,10,64,0,inf
26676,53,5,58,0,inf
26677,56,5,61,0,inf
26678,57,5,62,0,inf
26679,63,10,73,0,inf
26680,60,7,67,0,inf
26681,51,8,59,0,inf
26682,54,10,64,0,inf
26683,64,12,76,0,inf
26684,64,7,71,0,inf
26685,60,7,67,0,inf
26686,51,7,58,0,inf
26687,51,10,61,0,inf
26688,63,8,71,0,inf
26689,67,8,75,0,inf
26690,53,13,66,0,inf
26691,53,5,58,0,inf
26692,53,8,61,0,inf
26693,53,13,66,0,inf
26694,67,11,78,0,inf
26695,58,11,69,0,inf
26696,63,9,72,0,inf
26697,52,6,58,0,inf
26698,66,6,72,0,inf
26699,51,7,58,0,inf
26700,61,10,71,0,inf
26701,53,5,58,0,inf
26702,62,6,68,0,inf
26703,58,7,65,0,inf
26704,62,7,69,0,inf
26705,53,8,61,0,inf
26706,63,5,68,0,inf
26707,66,13,79,0,inf
26708,56,7,63,0,inf
26709,51,9,60,0,inf
26710,64,5,69,0,inf
26711,66,12,78,0,inf
26712,62,10,72,0,inf
26713,56,6,62,0,inf
26714,64,12,76,0,inf
26715,61,13,74,0,inf
26716,59,8,67,0,inf
26717,56,9,65,0,inf
26718,55,6,61,0,inf
26719,63,8,71,0,inf
26720,54,7,61,0,inf
26721,66,7,73,0,inf
26722,66,6,72,0,inf
26723,50,11,61,0,inf
26724,67,13,80,0,inf
26725,52,13,65,0,inf
26726,67,6,73,0,inf
26727,52,8,60,0,inf
26728,63,5,68,0,inf
26729,66,12,78,0,inf
26730,55,11,66,0,inf
26731,60,12,72,0,inf
26732,66,10,76,0,inf
26733,64,8,72,0,inf
26734,61,11,72,0,inf
26735,65,12,77,0,inf
26736,50,7,57,0,inf
26737,56,5,61,0,inf
26738,65,12,77,0,inf
26739,51,5,56,0,inf
26740,61,11,72,0,inf
26741,60,10,70,0,inf
26742,67,5,72,0,inf
26743,53,5,58,0,inf
26744,52,5,57,0,inf
26745,58,10,68,0,inf
26746,65,10,75,0,inf
26747,52,12,64,0,inf
26748,60,12,72,0,inf
26749,57,6,63,0,inf
26750,55,5,60,0,inf
26751,63,7,70,0,inf
26752,53,10,63,0,inf
26753,67,5,72,0,inf
26754,57,9,66,0,inf
26755,54,9,63,0,inf
26756,53,8,61,0,inf
26757,56,11,67,0,inf
26758,66,5,71,0,inf
26759,66,5,71,0,inf
26760,66,5,71,0,inf
26761,62,6,68,0,inf
26762,53,7,60,0,inf
26763,61,13,74,0,inf
26764,66,11,77,0,inf
26765,61,10,71,0,inf
26766,51,8,59,0,inf
26767,50,7,57,0,inf
26768,59,12,71,0,inf
26769,58,8,66,0,inf
26770,58,9,67,0,inf
26771,61,11,72,0,inf
26772,57,13,70,0,inf
26773,55,11,66,0,inf
26774,65,5,70,0,inf
26775,66,13,79,0,inf
26776,65,5,70,0,inf
26777,52,7,59,0,inf
26778,61,9,70,0,inf
26779,64,6,70,0,inf
26780,57,10,67,0,inf
26781,56,9,65,0,inf
26782,57,9,66,0,inf
26783,51,13,64,1,12.249849046426753
26784,58,10,68,0,inf
26785,60,6,66,0,inf
26786,60,7,67,0,inf
26787,64,13,77,0,inf
26788,51,7,58,0,inf
26789,57,10,67,0,inf
26790,59,13,72,0,inf
26791,60,9,69,0,inf
26792,62,8,70,0,inf
26793,59,13,72,0,inf
26794,51,8,59,0,inf
26795,50,7,57,0,inf
26796,67,10,77,0,inf
26797,66,7,73,0,inf
26798,54,7,61,0,inf
26799,56,9,65,0,inf
26800,57,11,68,0,inf
26801,61,10,71,0,inf
26802,56,11,67,0,inf
26803,50,9,59,0,inf
26804,67,11,78,0,inf
26805,55,9,64,0,inf
26806,52,7,59,0,inf
26807,50,10,60,0,inf
26808,56,5,61,0,inf
26809,61,12,73,0,inf
26810,60,8,68,0,inf
26811,52,11,63,0,inf
26812,64,12,76,0,inf
26813,55,12,67,0,inf
26814,57,13,70,0,inf
26815,63,8,71,0,inf
26816,51,10,61,1,3.6333482143376514
26817,55,6,61,0,inf
26818,57,9,66,1,8.608101382488215
26819,59,12,71,0,inf
26820,60,11,71,0,inf
26821,57,10,67,0,inf
26822,55,12,67,0,inf
26823,51,12,63,0,inf
26824,63,9,72,0,inf
26825,64,6,70,0,inf
26826,56,12,68,0,inf
26827,59,12,71,0,inf
26828,62,5,67,0,inf
26829,63,11,74,0,inf
26830,64,6,70,0,inf
26831,63,6,69,0,inf
26832,59,7,66,0,inf
26833,66,6,72,0,inf
26834,53,5,58,0,inf
26835,50,7,57,0,inf
26836,50,7,57,0,inf
26837,67,8,75,0,inf
26838,62,11,73,0,inf
26839,50,11,61,0,inf
26840,61,7,68,0,inf
26841,53,7,60,0,inf
26842,66,10,76,0,inf
26843,66,12,78,0,inf
26844,50,13,63,0,inf
26845,54,12,66,0,inf
26846,67,13,80,0,inf
26847,53,7,60,0,inf
26848,62,6,68,0,inf
26849,67,6,73,0,inf
26850,54,10,64,0,inf
26851,56,9,65,0,inf
26852,53,5,58,0,inf
26853,66,8,74,0,inf
26854,63,5,68,0,inf
26855,67,10,77,1,4.641929782908846
26856,52,5,57,0,inf
26857,57,12,69,0,inf
26858,59,7,66,0,inf
26859,54,12,66,0,inf
26860,58,11,69,0,inf
26861,59,6,65,0,inf
26862,67,5,72,0,inf
26863,54,12,66,0,inf
26864,63,6,69,0,inf
26865,51,13,64,0,inf
26866,56,6,62,0,inf
26867,67,8,75,0,inf
26868,54,8,62,0,inf
26869,65,11,76,0,inf
26870,52,6,58,0,inf
26871,65,13,78,0,inf
26872,55,8,63,0,inf
26873,60,5,65,0,inf
26874,60,11,71,0,inf
26875,53,10,63,0,inf
26876,59,12,71,0,inf
26877,54,10,64,0,inf
26878,63,13,76,0,inf
26879,63,11,74,0,inf
26880,59,6,65,0,inf
26881,59,6,65,0,inf
26882,62,8,70,0,inf
26883,61,5,66,0,inf
26884,61,9,70,0,inf
26885,55,5,60,0,inf
26886,62,7,69,0,inf
26887,58,5,63,0,inf
26888,62,9,71,0,inf
26889,62,8,70,0,inf
26890,58,12,70,0,inf
26891,66,11,77,0,inf
26892,62,11,73,0,inf
26893,65,7,72,0,inf
26894,51,9,60,0,inf
26895,50,5,55,0,inf
26896,64,8,72,0,inf
26897,63,6,69,0,inf
26898,63,12,75,0,inf
26899,56,10,66,0,inf
26900,58,13,71,0,inf
26901,58,6,64,0,inf
26902,57,9,66,0,inf
26903,62,10,72,0,inf
26904,54,9,63,0,inf
26905,60,11,71,0,inf
26906,64,10,74,1,2.6442948564193216
26907,57,5,62,0,inf
26908,51,7,58,0,inf
26909,65,6,71,0,inf
26910,62,11,73,0,inf
26911,58,7,65,0,inf
26912,58,11,69,0,inf
26913,66,11,77,0,inf
26914,58,12,70,0,inf
26915,61,8,69,0,inf
26916,55,5,60,0,inf
26917,63,7,70,0,inf
26918,64,10,74,0,inf
26919,54,12,66,0,inf
26920,62,13,75,0,inf
26921,57,11,68,0,inf
26922,66,7,73,0,inf
26923,62,7,69,0,inf
26924,59,5,64,0,inf
26925,60,5,65,0,inf
26926,64,9,73,0,inf
26927,50,7,57,0,inf
26928,58,6,64,0,inf
26929,57,6,63,0,inf
26930,62,8,70,0,inf
26931,50,8,58,0,inf
26932,60,11,71,0,inf
26933,53,11,64,0,inf
26934,64,13,77,0,inf
26935,65,8,73,0,inf
26936,63,6,69,1,2.3965467210847464
26937,64,10,74,0,inf
26938,64,7,71,0,inf
26939,63,9,72,0,inf
26940,52,5,57,0,inf
26941,53,8,61,0,inf
26942,66,6,72,0,inf
26943,64,6,70,0,inf
26944,59,13,72,0,inf
26945,59,9,68,0,inf
26946,50,8,58,0,inf
26947,66,7,73,0,inf
26948,60,6,66,0,inf
26949,63,11,74,0,inf
26950,58,13,71,0,inf
26951,67,11,78,0,inf
26952,50,13,63,0,inf
26953,65,10,75,0,inf
26954,56,12,68,0,inf
26955,67,10,77,0,inf
26956,60,10,70,0,inf
26957,67,5,72,0,inf
26958,61,5,66,0,inf
26959,56,9,65,0,inf
26960,57,6,63,0,inf
26961,53,12,65,0,inf
26962,57,11,68,0,inf
26963,67,10,77,0,inf
26964,59,6,65,0,inf
26965,57,11,68,0,inf
26966,66,12,78,0,inf
26967,54,10,64,0,inf
26968,65,6,71,0,inf
26969,56,7,63,0,inf
26970,67,10,77,0,inf
26971,63,7,70,0,inf
26972,51,11,62,0,inf
26973,63,6,69,0,inf
26974,63,12,75,0,inf
26975,64,13,77,0,inf
26976,67,10,77,0,inf
26977,50,10,60,0,inf
26978,53,13,66,0,inf
26979,56,5,61,0,inf
26980,65,13,78,0,inf
26981,57,10,67,0,inf
26982,61,11,72,0,inf
26983,59,10,69,0,inf
26984,61,5,66,0,inf
26985,50,6,56,0,inf
26986,64,6,70,0,inf
26987,67,13,80,0,inf
26988,54,11,65,0,inf
26989,54,7,61,0,inf
26990,59,9,68,0,inf
26991,60,10,70,0,inf
26992,67,6,73,0,inf
26993,60,12,72,0,inf
26994,67,7,74,0,inf
26995,67,7,74,0,inf
26996,59,12,71,0,inf
26997,52,6,58,0,inf
26998,63,9,72,0,inf
26999,65,12,77,0,inf
27000,64,5,69,0,inf
27001,64,5,69,0,inf
27002,51,7,58,0,inf
27003,55,11,66,0,inf
27004,56,7,63,0,inf
27005,64,11,75,0,inf
27006,53,5,58,0,inf
27007,65,5,70,0,inf
27008,58,13,71,0,inf
27009,66,13,79,0,inf
27010,58,8,66,0,inf
27011,67,13,80,0,inf
27012,63,9,72,0,inf
27013,61,12,73,0,inf
27014,61,12,73,0,inf
27015,60,12,72,0,inf
27016,61,6,67,0,inf
27017,62,6,68,0,inf
27018,64,8,72,1,0.7248400795645722
27019,62,9,71,0,inf
27020,65,12,77,0,inf
27021,66,7,73,0,inf
27022,52,7,59,0,inf
27023,54,6,60,0,inf
27024,56,9,65,0,inf
27025,53,11,64,0,inf
27026,55,5,60,0,inf
27027,66,12,78,0,inf
27028,65,11,76,0,inf
27029,58,7,65,0,inf
27030,64,9,73,0,inf
27031,54,5,59,0,inf
27032,57,5,62,0,inf
27033,59,5,64,0,inf
27034,61,13,74,0,inf
27035,52,13,65,0,inf
27036,58,5,63,0,inf
27037,63,8,71,0,inf
27038,56,13,69,0,inf
27039,51,7,58,0,inf
27040,59,8,67,1,0.715524715552462
27041,59,10,69,1,9.530803430375727
27042,65,6,71,0,inf
27043,64,7,71,0,inf
27044,58,8,66,0,inf
27045,64,12,76,1,0.4062819702877505
27046,64,5,69,0,inf
27047,54,6,60,0,inf
27048,67,5,72,0,inf
27049,50,6,56,0,inf
27050,61,7,68,0,inf
27051,50,8,58,0,inf
27052,50,13,63,0,inf
27053,58,6,64,0,inf
27054,56,6,62,0,inf
27055,59,10,69,0,inf
27056,66,10,76,0,inf
27057,50,12,62,0,inf
27058,67,13,80,0,inf
27059,60,7,67,0,inf
27060,54,8,62,0,inf
27061,63,13,76,0,inf
27062,67,7,74,0,inf
27063,58,5,63,0,inf
27064,58,5,63,0,inf
27065,59,9,68,0,inf
27066,62,7,69,0,inf
27067,56,9,65,0,inf
27068,51,7,58,0,inf
27069,63,11,74,0,inf
27070,66,7,73,0,inf
27071,50,10,60,0,inf
27072,57,12,69,0,inf
27073,63,8,71,1,5.005522000479488
27074,63,13,76,0,inf
27075,50,10,60,0,inf
27076,64,5,69,0,inf
27077,63,5,68,0,inf
27078,55,9,64,0,inf
27079,61,8,69,0,inf
27080,66,9,75,0,inf
27081,54,11,65,0,inf
27082,51,13,64,0,inf
27083,62,7,69,1,2.782820088395084
27084,57,5,62,1,4.8523237717055
27085,57,8,65,0,inf
27086,57,10,67,0,inf
27087,66,9,75,0,inf
27088,60,7,67,0,inf
27089,52,12,64,0,inf
27090,60,6,66,0,inf
27091,56,5,61,0,inf
27092,52,11,63,0,inf
27093,64,9,73,0,inf
27094,51,8,59,0,inf
27095,55,6,61,0,inf
27096,56,7,63,0,inf
27097,60,12,72,0,inf
27098,57,11,68,0,inf
27099,65,10,75,0,inf
27100,64,6,70,0,inf
27101,62,11,73,0,inf
27102,64,10,74,0,inf
27103,60,7,67,0,inf
27104,57,7,64,0,inf
27105,56,7,63,0,inf
27106,59,7,66,0,inf
27107,65,12,77,1,8.56116792398808
27108,67,5,72,0,inf
27109,65,11,76,0,inf
27110,53,12,65,0,inf
27111,61,9,70,0,inf
27112,51,8,59,0,inf
27113,64,7,71,0,inf
27114,64,5,69,0,inf
27115,54,11,65,0,inf
27116,56,11,67,0,inf
27117,65,12,77,0,inf
27118,57,5,62,1,3.4658627566717612
27119,55,5,60,0,inf
27120,54,9,63,0,inf
27121,60,6,66,0,inf
27122,57,6,63,0,inf
27123,64,12,76,0,inf
27124,60,13,73,0,inf
27125,51,9,60,0,inf
27126,57,6,63,0,inf
27127,57,12,69,0,inf
27128,56,8,64,0,inf
27129,67,12,79,0,inf
27130,61,5,66,0,inf
27131,50,6,56,0,inf
27132,61,7,68,0,inf
27133,66,11,77,0,inf
27134,65,9,74,0,inf
27135,54,10,64,0,inf
27136,63,5,68,0,inf
27137,53,12,65,0,inf
27138,51,9,60,0,inf
27139,51,13,64,0,inf
27140,59,13,72,0,inf
27141,55,10,65,0,inf
27142,50,9,59,0,inf
27143,58,8,66,0,inf
27144,53,11,64,0,inf
27145,58,12,70,0,inf
27146,60,11,71,0,inf
27147,63,12,75,0,inf
27148,53,8,61,0,inf
27149,59,5,64,0,inf
27150,55,11,66,0,inf
27151,57,12,69,0,inf
27152,55,10,65,0,inf
27153,67,5,72,0,inf
27154,58,7,65,0,inf
27155,63,13,76,0,inf
27156,66,8,74,0,inf
27157,51,11,62,0,inf
27158,55,6,61,0,inf
27159,65,13,78,0,inf
27160,50,5,55,0,inf
27161,55,10,65,0,inf
27162,63,12,75,0,inf
27163,59,9,68,0,inf
27164,63,11,74,0,inf
27165,57,7,64,0,inf
27166,60,10,70,0,inf
27167,58,7,65,0,inf
27168,62,8,70,0,inf
27169,51,10,61,0,inf
27170,50,10,60,0,inf
27171,58,12,70,0,inf
27172,56,11,67,0,inf
27173,54,11,65,0,inf
27174,50,5,55,0,inf
27175,65,10,75,0,inf
27176,63,10,73,1,6.423161994940131
27177,63,12,75,0,inf
27178,59,10,69,0,inf
27179,57,11,68,0,inf
27180,52,10,62,0,inf
27181,59,5,64,0,inf
27182,59,12,71,0,inf
27183,53,11,64,0,inf
27184,55,8,63,0,inf
27185,52,11,63,0,inf
27186,53,13,66,1,10.062444930998353
27187,50,5,55,0,inf
27188,52,12,64,0,inf
27189,65,8,73,0,inf
27190,53,9,62,0,inf
27191,61,6,67,0,inf
27192,57,8,65,0,inf
27193,57,12,69,0,inf
27194,65,6,71,0,inf
27195,61,7,68,0,inf
27196,61,12,73,0,inf
27197,53,13,66,0,inf
27198,56,5,61,0,inf
27199,57,7,64,0,inf
27200,52,5,57,0,inf
27201,54,13,67,0,inf
27202,60,13,73,0,inf
27203,58,5,63,0,inf
27204,50,8,58,0,inf
27205,55,8,63,0,inf
27206,50,12,62,0,inf
27207,63,8,71,0,inf
27208,55,10,65,0,inf
27209,52,6,58,0,inf
27210,63,7,70,0,inf
27211,51,12,63,0,inf
27212,67,10,77,0,inf
27213,59,8,67,0,inf
27214,54,13,67,0,inf
27215,61,13,74,0,inf
27216,61,7,68,0,inf
27217,53,10,63,0,inf
27218,53,12,65,0,inf
27219,55,7,62,0,inf
27220,51,5,56,0,inf
27221,63,11,74,0,inf
27222,67,8,75,0,inf
27223,56,12,68,0,inf
27224,57,9,66,0,inf
27225,63,12,75,0,inf
27226,66,7,73,0,inf
27227,60,13,73,0,inf
27228,66,13,79,0,inf
27229,62,8,70,0,inf
27230,60,6,66,0,inf
27231,61,6,67,0,inf
27232,51,8,59,0,inf
27233,65,10,75,0,inf
27234,57,5,62,0,inf
27235,58,6,64,0,inf
27236,55,7,62,0,inf
27237,64,11,75,0,inf
27238,52,10,62,0,inf
27239,52,7,59,0,inf
27240,56,10,66,0,inf
27241,56,12,68,0,inf
27242,56,5,61,0,inf
27243,65,13,78,0,inf
27244,62,12,74,0,inf
27245,60,8,68,0,inf
27246,64,13,77,0,inf
27247,59,13,72,0,inf
27248,54,5,59,0,inf
27249,55,6,61,0,inf
27250,52,11,63,0,inf
27251,56,9,65,0,inf
27252,52,7,59,0,inf
27253,62,11,73,0,inf
27254,52,9,61,0,inf
27255,65,6,71,0,inf
27256,65,6,71,0,inf
27257,58,8,66,0,inf
27258,63,9,72,0,inf
27259,53,13,66,0,inf
27260,57,11,68,0,inf
27261,60,12,72,0,inf
27262,52,13,65,0,inf
27263,50,11,61,0,inf
27264,64,11,75,0,inf
27265,61,10,71,0,inf
27266,62,8,70,0,inf
27267,58,8,66,0,inf
27268,60,8,68,0,inf
27269,56,8,64,0,inf
27270,52,5,57,0,inf
27271,61,11,72,0,inf
27272,63,5,68,0,inf
27273,57,5,62,0,inf
27274,50,12,62,0,inf
27275,64,13,77,0,inf
27276,62,6,68,0,inf
27277,63,5,68,0,inf
27278,55,5,60,0,inf
27279,54,9,63,0,inf
27280,61,12,73,0,inf
27281,64,12,76,0,inf
27282,51,9,60,0,inf
27283,67,7,74,0,inf
27284,61,9,70,0,inf
27285,54,10,64,0,inf
27286,61,5,66,1,3.250104786114008
27287,51,7,58,0,inf
27288,51,10,61,0,inf
27289,52,9,61,0,inf
27290,61,13,74,0,inf
27291,64,5,69,0,inf
27292,64,5,69,0,inf
27293,63,6,69,0,inf
27294,66,9,75,0,inf
27295,51,11,62,0,inf
27296,64,12,76,1,1.701346312448237
27297,54,12,66,1,5.643882275317793
27298,63,13,76,0,inf
27299,51,13,64,0,inf
27300,63,13,76,0,inf
27301,60,5,65,0,inf
27302,52,7,59,0,inf
27303,58,13,71,0,inf
27304,65,9,74,0,inf
27305,65,7,72,0,inf
27306,65,9,74,0,inf
27307,66,12,78,1,8.240121050348293
27308,58,13,71,0,inf
27309,65,13,78,0,inf
27310,61,12,73,0,inf
27311,57,11,68,0,inf
27312,56,5,61,0,inf
27313,50,12,62,0,inf
27314,51,13,64,0,inf
27315,52,6,58,0,inf
27316,61,5,66,0,inf
27317,52,12,64,0,inf
27318,64,13,77,0,inf
27319,50,5,55,0,inf
27320,62,6,68,0,inf
27321,62,10,72,0,inf
27322,66,5,71,0,inf
27323,56,11,67,0,inf
27324,60,8,68,0,inf
27325,62,11,73,0,inf
27326,67,10,77,0,inf
27327,64,9,73,0,inf
27328,54,13,67,0,inf
27329,57,8,65,0,inf
27330,53,8,61,0,inf
27331,53,11,64,0,inf
27332,55,6,61,0,inf
27333,61,8,69,0,inf
27334,51,12,63,0,inf
27335,67,7,74,0,inf
27336,66,11,77,0,inf
27337,63,11,74,0,inf
27338,51,10,61,0,inf
27339,52,8,60,0,inf
27340,60,11,71,1,7.245925599945778
27341,66,8,74,0,inf
27342,51,11,62,0,inf
27343,61,7,68,0,inf
27344,52,6,58,0,inf
27345,55,9,64,0,inf
27346,59,12,71,0,inf
27347,52,12,64,1,11.356682155269354
27348,56,7,63,0,inf
27349,66,8,74,0,inf
27350,59,12,71,0,inf
27351,60,7,67,0,inf
27352,53,11,64,0,inf
27353,54,10,64,0,inf
27354,51,8,59,0,inf
27355,55,7,62,0,inf
27356,59,5,64,0,inf
27357,59,9,68,0,inf
27358,65,10,75,0,inf
27359,55,7,62,0,inf
27360,60,12,72,0,inf
27361,55,12,67,0,inf
27362,54,12,66,0,inf
27363,66,5,71,0,inf
27364,61,12,73,0,inf
27365,59,9,68,0,inf
27366,56,10,66,0,inf
27367,52,8,60,0,inf
27368,57,11,68,0,inf
27369,60,7,67,0,inf
27370,60,10,70,0,inf
27371,66,11,77,0,inf
27372,66,11,77,0,inf
27373,60,6,66,0,inf
27374,50,5,55,0,inf
27375,54,11,65,0,inf
27376,66,11,77,0,inf
27377,50,8,58,0,inf
27378,65,12,77,0,inf
27379,65,8,73,0,inf
27380,64,8,72,0,inf
27381,62,8,70,0,inf
27382,59,13,72,0,inf
27383,61,12,73,0,inf
27384,63,7,70,0,inf
27385,53,10,63,0,inf
27386,60,11,71,0,inf
27387,56,7,63,0,inf
27388,58,10,68,0,inf
27389,55,6,61,0,inf
27390,64,5,69,0,inf
27391,64,8,72,0,inf
27392,50,12,62,0,inf
27393,65,13,78,0,inf
27394,62,5,67,0,inf
27395,50,13,63,0,inf
27396,55,10,65,0,inf
27397,51,13,64,0,inf
27398,54,6,60,0,inf
27399,52,11,63,0,inf
27400,63,10,73,0,inf
27401,63,7,70,0,inf
27402,54,6,60,0,inf
27403,50,9,59,0,inf
27404,60,8,68,0,inf
27405,59,7,66,0,inf
27406,65,6,71,0,inf
27407,56,8,64,0,inf
27408,59,12,71,0,inf
27409,51,12,63,0,inf
27410,55,10,65,0,inf
27411,64,12,76,0,inf
27412,63,6,69,0,inf
27413,67,5,72,0,inf
27414,50,11,61,0,inf
27415,54,10,64,0,inf
27416,62,10,72,0,inf
27417,63,13,76,0,inf
27418,63,10,73,0,inf
27419,64,13,77,0,inf
27420,59,10,69,0,inf
27421,51,6,57,0,inf
27422,66,11,77,0,inf
27423,65,5,70,0,inf
27424,61,6,67,0,inf
27425,60,10,70,0,inf
27426,59,11,70,0,inf
27427,63,11,74,0,inf
27428,64,6,70,0,inf
27429,52,6,58,0,inf
27430,60,13,73,0,inf
27431,61,7,68,0,inf
27432,58,12,70,0,inf
27433,53,8,61,0,inf
27434,52,11,63,0,inf
27435,65,5,70,0,inf
27436,58,8,66,0,inf
27437,67,13,80,0,inf
27438,65,6,71,0,inf
27439,63,8,71,0,inf
27440,64,7,71,0,inf
27441,61,8,69,0,inf
27442,65,11,76,0,inf
27443,60,5,65,0,inf
27444,64,5,69,0,inf
27445,53,6,59,1,0.6514759151074259
27446,55,9,64,0,inf
27447,58,13,71,0,inf
27448,50,10,60,0,inf
27449,65,11,76,0,inf
27450,61,10,71,0,inf
27451,52,7,59,0,inf
27452,66,12,78,0,inf
27453,62,7,69,0,inf
27454,60,7,67,0,inf
27455,58,11,69,0,inf
27456,54,9,63,0,inf
27457,52,5,57,0,inf
27458,61,9,70,0,inf
27459,66,13,79,0,inf
27460,62,7,69,0,inf
27461,58,12,70,0,inf
27462,55,13,68,0,inf
27463,57,5,62,0,inf
27464,50,5,55,0,inf
27465,61,5,66,0,inf
27466,58,6,64,0,inf
27467,51,13,64,0,inf
27468,61,6,67,0,inf
27469,64,9,73,0,inf
27470,57,10,67,0,inf
27471,65,8,73,0,inf
27472,56,12,68,0,inf
27473,52,5,57,0,inf
27474,53,5,58,0,inf
27475,53,5,58,0,inf
27476,51,12,63,0,inf
27477,63,13,76,0,inf
27478,54,13,67,0,inf
27479,54,6,60,0,inf
27480,54,8,62,0,inf
27481,55,11,66,0,inf
27482,54,11,65,0,inf
27483,67,13,80,0,inf
27484,65,10,75,0,inf
27485,51,8,59,1,4.827507899816645
27486,57,13,70,0,inf
27487,54,5,59,0,inf
27488,52,6,58,0,inf
27489,61,12,73,0,inf
27490,56,12,68,0,inf
27491,66,6,72,0,inf
27492,64,5,69,0,inf
27493,57,11,68,0,inf
27494,56,5,61,0,inf
27495,63,9,72,0,inf
27496,52,9,61,0,inf
27497,62,7,69,0,inf
27498,63,6,69,0,inf
27499,60,13,73,0,inf
27500,67,7,74,0,inf
27501,53,12,65,0,inf
27502,51,13,64,0,inf
27503,67,8,75,0,inf
27504,62,9,71,0,inf
27505,62,12,74,0,inf
27506,53,9,62,0,inf
27507,60,12,72,0,inf
27508,55,13,68,0,inf
27509,50,5,55,0,inf
27510,66,12,78,0,inf
27511,51,8,59,0,inf
27512,60,6,66,0,inf
27513,58,11,69,0,inf
27514,50,7,57,0,inf
27515,63,6,69,0,inf
27516,64,7,71,0,inf
27517,64,9,73,0,inf
27518,54,9,63,0,inf
27519,53,9,62,0,inf
27520,64,5,69,0,inf
27521,60,7,67,0,inf
27522,53,7,60,0,inf
27523,66,10,76,0,inf
27524,50,10,60,0,inf
27525,62,5,67,0,inf
27526,57,7,64,0,inf
27527,52,8,60,0,inf
27528,60,7,67,0,inf
27529,62,10,72,0,inf
27530,64,5,69,0,inf
27531,52,5,57,0,inf
27532,53,6,59,0,inf
27533,64,12,76,0,inf
27534,61,7,68,0,inf
27535,53,12,65,0,inf
27536,54,13,67,0,inf
27537,67,12,79,0,inf
27538,63,6,69,0,inf
27539,57,6,63,0,inf
27540,57,8,65,0,inf
27541,64,6,70,0,inf
27542,64,11,75,1,8.528717918962528
27543,55,8,63,0,inf
27544,58,13,71,0,inf
27545,66,13,79,0,inf
27546,50,13,63,0,inf
27547,56,6,62,0,inf
27548,67,6,73,0,inf
27549,63,10,73,0,inf
27550,53,8,61,0,inf
27551,54,9,63,0,inf
27552,63,5,68,0,inf
27553,53,5,58,0,inf
27554,61,13,74,0,inf
27555,55,7,62,0,inf
27556,61,8,69,0,inf
27557,60,7,67,0,inf
27558,58,7,65,0,inf
27559,53,10,63,0,inf
27560,66,11,77,0,inf
27561,64,8,72,0,inf
27562,59,11,70,0,inf
27563,65,6,71,0,inf
27564,56,12,68,0,inf
27565,61,6,67,0,inf
27566,65,11,76,0,inf
27567,56,11,67,0,inf
27568,50,12,62,0,inf
27569,60,13,73,0,inf
27570,59,6,65,0,inf
27571,60,6,66,0,inf
27572,53,6,59,0,inf
27573,67,9,76,0,inf
27574,53,11,64,0,inf
27575,61,12,73,0,inf
27576,50,13,63,0,inf
27577,52,5,57,0,inf
27578,62,5,67,0,inf
27579,67,10,77,0,inf
27580,65,8,73,0,inf
27581,59,12,71,0,inf
27582,56,10,66,0,inf
27583,60,6,66,1,2.3817046486839004
27584,66,9,75,0,inf
27585,52,5,57,1,2.826296915540837
27586,61,9,70,0,inf
27587,51,5,56,0,inf
27588,67,8,75,0,inf
27589,50,10,60,0,inf
27590,60,11,71,0,inf
27591,61,6,67,0,inf
27592,55,13,68,0,inf
27593,53,12,65,0,inf
27594,55,9,64,0,inf
27595,50,7,57,0,inf
27596,57,9,66,0,inf
27597,52,10,62,0,inf
27598,63,10,73,0,inf
27599,66,13,79,1,1.9943412995608298
27600,60,12,72,0,inf
27601,55,6,61,0,inf
27602,59,12,71,0,inf
27603,62,12,74,0,inf
27604,55,10,65,0,inf
27605,58,8,66,0,inf
27606,55,6,61,0,inf
27607,61,6,67,0,inf
27608,66,6,72,0,inf
27609,58,6,64,1,5.682256663262507
27610,52,12,64,0,inf
27611,52,9,61,0,inf
27612,51,13,64,0,inf
27613,64,11,75,0,inf
27614,61,13,74,0,inf
27615,56,10,66,0,inf
27616,51,11,62,0,inf
27617,62,5,67,0,inf
27618,50,6,56,0,inf
27619,50,13,63,0,inf
27620,56,12,68,0,inf
27621,58,5,63,0,inf
27622,63,10,73,0,inf
27623,66,12,78,0,inf
27624,66,7,73,0,inf
27625,66,5,71,0,inf
27626,61,5,66,1,1.6057971422555113
27627,54,8,62,0,inf
27628,52,10,62,0,inf
27629,57,7,64,0,inf
27630,52,9,61,0,inf
27631,59,6,65,0,inf
27632,60,10,70,0,inf
27633,61,9,70,0,inf
27634,61,13,74,0,inf
27635,53,12,65,0,inf
27636,66,8,74,0,inf
27637,67,9,76,0,inf
27638,64,12,76,0,inf
27639,62,8,70,0,inf
27640,52,7,59,0,inf
27641,58,5,63,0,inf
27642,62,5,67,0,inf
27643,64,5,69,0,inf
27644,55,12,67,0,inf
27645,58,10,68,0,inf
27646,65,13,78,1,7.077549988943815
27647,65,13,78,0,inf
27648,50,9,59,0,inf
27649,53,8,61,0,inf
27650,66,5,71,0,inf
27651,55,5,60,0,inf
27652,66,6,72,0,inf
27653,58,8,66,0,inf
27654,67,9,76,0,inf
27655,60,12,72,0,inf
27656,54,6,60,0,inf
27657,57,11,68,0,inf
27658,55,5,60,0,inf
27659,55,5,60,0,inf
27660,52,10,62,0,inf
27661,61,5,66,0,inf
27662,58,10,68,0,inf
27663,57,8,65,0,inf
27664,57,11,68,0,inf
27665,61,6,67,0,inf
27666,59,6,65,0,inf
27667,51,9,60,0,inf
27668,62,5,67,0,inf
27669,62,13,75,0,inf
27670,63,12,75,0,inf
27671,57,13,70,0,inf
27672,53,10,63,0,inf
27673,50,10,60,0,inf
27674,53,5,58,0,inf
27675,53,7,60,0,inf
27676,51,6,57,0,inf
27677,62,6,68,0,inf
27678,57,10,67,0,inf
27679,67,7,74,0,inf
27680,65,12,77,0,inf
27681,67,10,77,0,inf
27682,54,8,62,0,inf
27683,55,6,61,0,inf
27684,56,10,66,0,inf
27685,65,11,76,0,inf
27686,52,10,62,0,inf
27687,58,6,64,0,inf
27688,58,13,71,0,inf
27689,57,6,63,0,inf
27690,54,6,60,0,inf
27691,58,5,63,0,inf
27692,61,13,74,0,inf
27693,67,8,75,0,inf
27694,53,9,62,0,inf
27695,65,7,72,0,inf
27696,51,13,64,0,inf
27697,56,7,63,0,inf
27698,53,8,61,0,inf
27699,54,8,62,0,inf
27700,53,8,61,0,inf
27701,67,12,79,1,1.543134543170467
27702,53,5,58,0,inf
27703,64,13,77,0,inf
27704,67,13,80,0,inf
27705,65,6,71,0,inf
27706,61,11,72,0,inf
27707,59,6,65,0,inf
27708,58,6,64,0,inf
27709,67,7,74,0,inf
27710,51,12,63,0,inf
27711,61,5,66,0,inf
27712,51,11,62,0,inf
27713,64,9,73,1,6.9421791447960715
27714,67,7,74,0,inf
27715,53,10,63,0,inf
27716,63,10,73,0,inf
27717,53,9,62,0,inf
27718,62,11,73,0,inf
27719,53,7,60,0,inf
27720,52,8,60,0,inf
27721,55,8,63,0,inf
27722,50,12,62,0,inf
27723,56,9,65,0,inf
27724,65,6,71,0,inf
27725,56,7,63,0,inf
27726,53,6,59,0,inf
27727,56,10,66,0,inf
27728,58,12,70,0,inf
27729,61,7,68,0,inf
27730,58,7,65,0,inf
27731,61,5,66,0,inf
27732,52,10,62,0,inf
27733,59,8,67,0,inf
27734,50,8,58,0,inf
27735,65,10,75,0,inf
27736,50,10,60,0,inf
27737,55,9,64,0,inf
27738,50,9,59,0,inf
27739,54,12,66,0,inf
27740,53,9,62,0,inf
27741,50,10,60,0,inf
27742,56,7,63,0,inf
27743,58,9,67,0,inf
27744,56,6,62,0,inf
27745,60,6,66,0,inf
27746,54,6,60,0,inf
27747,60,8,68,0,inf
27748,64,5,69,0,inf
27749,64,6,70,0,inf
27750,57,10,67,0,inf
27751,66,7,73,0,inf
27752,50,12,62,0,inf
27753,64,8,72,0,inf
27754,61,8,69,0,inf
27755,60,12,72,0,inf
27756,57,9,66,0,inf
27757,52,8,60,0,inf
27758,61,12,73,0,inf
27759,57,6,63,0,inf
27760,67,9,76,0,inf
27761,55,7,62,0,inf
27762,62,11,73,0,inf
27763,51,9,60,0,inf
27764,66,9,75,1,1.6205368840444123
27765,51,11,62,0,inf
27766,62,7,69,0,inf
27767,56,13,69,0,inf
27768,59,13,72,0,inf
27769,53,6,59,0,inf
27770,58,7,65,0,inf
27771,62,7,69,0,inf
27772,67,6,73,0,inf
27773,58,11,69,0,inf
27774,60,9,69,0,inf
27775,56,7,63,0,inf
27776,64,5,69,0,inf
27777,65,10,75,0,inf
27778,62,8,70,0,inf
27779,56,12,68,0,inf
27780,65,7,72,0,inf
27781,51,12,63,0,inf
27782,56,9,65,0,inf
27783,64,7,71,0,inf
27784,61,10,71,0,inf
27785,59,11,70,0,inf
27786,52,8,60,0,inf
27787,52,12,64,0,inf
27788,58,13,71,0,inf
27789,56,6,62,0,inf
27790,66,9,75,0,inf
27791,57,8,65,0,inf
27792,63,10,73,0,inf
27793,56,13,69,0,inf
27794,54,10,64,0,inf
27795,54,10,64,0,inf
27796,65,6,71,0,inf
27797,62,11,73,0,inf
27798,62,8,70,0,inf
27799,55,8,63,0,inf
27800,57,5,62,0,inf
27801,65,12,77,0,inf
27802,63,11,74,0,inf
27803,64,7,71,0,inf
27804,57,10,67,0,inf
27805,51,11,62,0,inf
27806,63,13,76,0,inf
27807,65,10,75,0,inf
27808,50,13,63,0,inf
27809,66,6,72,0,inf
27810,63,8,71,0,inf
27811,58,7,65,0,inf
27812,59,6,65,0,inf
27813,52,6,58,0,inf
27814,55,11,66,0,inf
27815,64,7,71,0,inf
27816,58,6,64,0,inf
27817,56,11,67,0,inf
27818,54,13,67,0,inf
27819,65,13,78,0,inf
27820,59,7,66,0,inf
27821,50,5,55,0,inf
27822,60,8,68,0,inf
27823,56,7,63,0,inf
27824,65,7,72,0,inf
27825,55,11,66,0,inf
27826,57,7,64,0,inf
27827,52,8,60,0,inf
27828,57,11,68,0,inf
27829,59,5,64,0,inf
27830,59,10,69,0,inf
27831,53,6,59,0,inf
27832,54,5,59,0,inf
27833,66,9,75,0,inf
27834,55,10,65,0,inf
27835,63,10,73,0,inf
27836,64,8,72,0,inf
27837,66,8,74,0,inf
27838,57,10,67,0,inf
27839,60,11,71,0,inf
27840,54,7,61,0,inf
27841,60,5,65,0,inf
27842,55,5,60,0,inf
27843,58,8,66,0,inf
27844,51,10,61,0,inf
27845,50,5,55,0,inf
27846,63,12,75,0,inf
27847,64,9,73,0,inf
27848,54,11,65,0,inf
27849,54,11,65,0,inf
27850,50,8,58,0,inf
27851,66,11,77,1,7.6558963057601375
27852,67,13,80,0,inf
27853,67,6,73,0,inf
27854,53,11,64,0,inf
27855,58,11,69,0,inf
27856,63,12,75,0,inf
27857,50,11,61,0,inf
27858,64,7,71,0,inf
27859,53,10,63,0,inf
27860,50,11,61,0,inf
27861,51,7,58,0,inf
27862,57,11,68,0,inf
27863,61,5,66,0,inf
27864,63,5,68,0,inf
27865,61,13,74,0,inf
27866,51,5,56,0,inf
27867,67,11,78,0,inf
27868,52,8,60,0,inf
27869,51,5,56,0,inf
27870,64,10,74,0,inf
27871,51,5,56,0,inf
27872,54,12,66,0,inf
27873,50,8,58,0,inf
27874,58,5,63,0,inf
27875,63,10,73,0,inf
27876,59,12,71,0,inf
27877,56,5,61,1,2.407740273980849
27878,61,9,70,0,inf
27879,65,7,72,0,inf
27880,59,6,65,0,inf
27881,52,12,64,0,inf
27882,65,9,74,0,inf
27883,53,8,61,0,inf
27884,50,10,60,0,inf
27885,63,9,72,0,inf
27886,66,9,75,0,inf
27887,58,7,65,0,inf
27888,67,9,76,0,inf
27889,52,9,61,0,inf
27890,62,10,72,0,inf
27891,59,6,65,0,inf
27892,63,13,76,0,inf
27893,58,9,67,0,inf
27894,64,7,71,0,inf
27895,51,8,59,0,inf
27896,57,10,67,0,inf
27897,61,6,67,0,inf
27898,50,11,61,0,inf
27899,56,5,61,0,inf
27900,65,11,76,0,inf
27901,66,13,79,0,inf
27902,60,8,68,0,inf
27903,55,13,68,0,inf
27904,54,5,59,0,inf
27905,55,5,60,0,inf
27906,65,7,72,0,inf
27907,53,10,63,0,inf
27908,51,12,63,0,inf
27909,54,5,59,0,inf
27910,53,9,62,0,inf
27911,62,10,72,0,inf
27912,50,11,61,1,5.188371595246139
27913,50,7,57,0,inf
27914,66,5,71,0,inf
27915,56,10,66,0,inf
27916,56,8,64,0,inf
27917,52,5,57,0,inf
27918,56,12,68,0,inf
27919,61,7,68,0,inf
27920,66,7,73,0,inf
27921,51,9,60,0,inf
27922,65,11,76,0,inf
27923,59,10,69,0,inf
27924,54,5,59,0,inf
27925,53,6,59,0,inf
27926,56,8,64,0,inf
27927,65,7,72,0,inf
27928,57,10,67,0,inf
27929,67,12,79,0,inf
27930,50,12,62,0,inf
27931,59,5,64,0,inf
27932,52,13,65,0,inf
27933,62,6,68,0,inf
27934,64,11,75,0,inf
27935,66,10,76,0,inf
27936,51,13,64,0,inf
27937,57,12,69,0,inf
27938,55,11,66,0,inf
27939,52,8,60,0,inf
27940,57,8,65,0,inf
27941,65,13,78,0,inf
27942,67,13,80,0,inf
27943,65,9,74,0,inf
27944,53,9,62,0,inf
27945,59,10,69,0,inf
27946,55,12,67,1,4.922554813531889
27947,56,7,63,0,inf
27948,55,13,68,0,inf
27949,57,6,63,0,inf
27950,51,11,62,0,inf
27951,58,8,66,1,7.837783530015585
27952,53,6,59,0,inf
27953,67,12,79,0,inf
27954,67,12,79,0,inf
27955,64,12,76,0,inf
27956,52,5,57,1,1.449253615869786
27957,67,11,78,0,inf
27958,54,13,67,0,inf
27959,67,12,79,0,inf
27960,52,9,61,0,inf
27961,64,12,76,0,inf
27962,60,5,65,0,inf
27963,55,9,64,0,inf
27964,53,9,62,0,inf
27965,67,7,74,0,inf
27966,52,5,57,0,inf
27967,61,8,69,0,inf
27968,56,11,67,0,inf
27969,59,12,71,0,inf
27970,61,11,72,0,inf
27971,58,6,64,0,inf
27972,53,13,66,0,inf
27973,52,9,61,1,4.298385691204125
27974,66,12,78,0,inf
27975,50,11,61,0,inf
27976,65,8,73,0,inf
27977,52,10,62,0,inf
27978,67,13,80,0,inf
27979,50,10,60,0,inf
27980,61,11,72,0,inf
27981,62,7,69,0,inf
27982,61,5,66,0,inf
27983,55,10,65,0,inf
27984,56,5,61,0,inf
27985,58,8,66,0,inf
27986,61,11,72,1,8.445731412862244
27987,60,7,67,0,inf
27988,61,9,70,0,inf
27989,50,13,63,0,inf
27990,55,12,67,0,inf
27991,62,8,70,0,inf
27992,56,8,64,0,inf
27993,64,5,69,0,inf
27994,67,9,76,0,inf
27995,55,7,62,0,inf
27996,54,8,62,0,inf
27997,59,11,70,0,inf
27998,50,7,57,0,inf
27999,60,5,65,0,inf
28000,59,5,64,0,inf
28001,56,5,61,0,inf
28002,53,11,64,0,inf
28003,62,5,67,0,inf
28004,59,9,68,0,inf
28005,59,8,67,0,inf
28006,54,10,64,0,inf
28007,52,9,61,0,inf
28008,56,6,62,1,3.3601721977802796
28009,61,12,73,0,inf
28010,54,7,61,0,inf
28011,63,8,71,0,inf
28012,53,6,59,0,inf
28013,65,13,78,0,inf
28014,50,8,58,0,inf
28015,66,8,74,0,inf
28016,67,5,72,1,0.15010478219727474
28017,56,12,68,0,inf
28018,62,7,69,0,inf
28019,51,12,63,0,inf
28020,58,13,71,0,inf
28021,60,12,72,0,inf
28022,67,9,76,0,inf
28023,65,8,73,0,inf
28024,62,9,71,0,inf
28025,62,13,75,0,inf
28026,63,13,76,0,inf
28027,56,7,63,0,inf
28028,51,7,58,0,inf
28029,61,7,68,0,inf
28030,57,7,64,0,inf
28031,61,13,74,0,inf
28032,51,9,60,0,inf
28033,51,5,56,0,inf
28034,61,6,67,0,inf
28035,57,9,66,0,inf
28036,52,5,57,0,inf
28037,66,5,71,0,inf
28038,65,10,75,0,inf
28039,51,13,64,0,inf
28040,56,13,69,0,inf
28041,59,11,70,0,inf
28042,60,10,70,0,inf
28043,62,7,69,0,inf
28044,66,6,72,0,inf
28045,56,13,69,0,inf
28046,52,8,60,0,inf
28047,62,9,71,1,2.1988125305132087
28048,52,13,65,0,inf
28049,58,7,65,0,inf
28050,56,6,62,0,inf
28051,55,13,68,0,inf
28052,64,7,71,0,inf
28053,60,13,73,0,inf
28054,58,9,67,0,inf
28055,53,10,63,0,inf
28056,56,10,66,0,inf
28057,56,7,63,0,inf
28058,64,10,74,0,inf
28059,60,10,70,0,inf
28060,66,9,75,0,inf
28061,57,12,69,0,inf
28062,62,11,73,0,inf
28063,53,11,64,0,inf
28064,57,12,69,0,inf
28065,61,10,71,0,inf
28066,56,13,69,0,inf
28067,60,8,68,0,inf
28068,64,5,69,0,inf
28069,59,11,70,0,inf
28070,54,9,63,0,inf
28071,63,12,75,0,inf
28072,53,9,62,0,inf
28073,61,9,70,0,inf
28074,58,9,67,0,inf
28075,67,8,75,0,inf
28076,55,8,63,0,inf
28077,55,10,65,0,inf
28078,51,13,64,0,inf
28079,59,7,66,0,inf
28080,58,12,70,0,inf
28081,56,5,61,0,inf
28082,52,6,58,0,inf
28083,51,5,56,0,inf
28084,50,8,58,0,inf
28085,64,13,77,0,inf
28086,62,11,73,0,inf
28087,53,11,64,0,inf
28088,56,9,65,0,inf
28089,64,7,71,0,inf
28090,56,9,65,0,inf
28091,63,12,75,0,inf
28092,52,10,62,0,inf
28093,50,6,56,0,inf
28094,63,12,75,0,inf
28095,66,9,75,0,inf
28096,54,13,67,0,inf
28097,67,10,77,0,inf
28098,65,6,71,0,inf
28099,62,12,74,0,inf
28100,63,9,72,1,3.3637942376693957
28101,54,11,65,0,inf
28102,66,8,74,0,inf
28103,61,13,74,0,inf
28104,67,9,76,0,inf
28105,52,9,61,0,inf
28106,66,9,75,0,inf
28107,60,13,73,0,inf
28108,53,8,61,0,inf
28109,56,11,67,0,inf
28110,64,9,73,0,inf
28111,53,13,66,0,inf
28112,52,5,57,0,inf
28113,51,8,59,0,inf
28114,56,10,66,0,inf
28115,61,8,69,0,inf
28116,57,9,66,0,inf
28117,65,5,70,0,inf
28118,60,12,72,0,inf
28119,54,12,66,0,inf
28120,51,10,61,0,inf
28121,62,13,75,1,4.068740724775765
28122,63,8,71,0,inf
28123,58,11,69,0,inf
28124,54,12,66,0,inf
28125,65,9,74,0,inf
28126,63,5,68,0,inf
28127,59,7,66,0,inf
28128,59,5,64,0,inf
28129,52,8,60,0,inf
28130,60,5,65,0,inf
28131,53,5,58,0,inf
28132,50,11,61,0,inf
28133,64,6,70,0,inf
28134,64,11,75,0,inf
28135,67,10,77,0,inf
28136,57,10,67,0,inf
28137,60,13,73,0,inf
28138,54,13,67,0,inf
28139,65,12,77,0,inf
28140,57,8,65,0,inf
28141,52,11,63,0,inf
28142,52,8,60,0,inf
28143,58,6,64,0,inf
28144,65,11,76,0,inf
28145,59,11,70,0,inf
28146,66,10,76,0,inf
28147,60,5,65,0,inf
28148,54,10,64,0,inf
28149,55,13,68,0,inf
28150,59,13,72,0,inf
28151,67,7,74,0,inf
28152,52,7,59,0,inf
28153,63,5,68,0,inf
28154,59,8,67,0,inf
28155,65,12,77,0,inf
28156,57,8,65,0,inf
28157,53,9,62,0,inf
28158,53,8,61,0,inf
28159,66,11,77,0,inf
28160,64,9,73,0,inf
28161,50,7,57,0,inf
28162,51,6,57,1,4.191773117385402
28163,63,6,69,0,inf
28164,57,5,62,0,inf
28165,67,11,78,0,inf
28166,50,10,60,0,inf
28167,62,6,68,0,inf
28168,66,13,79,0,inf
28169,59,5,64,0,inf
28170,60,6,66,0,inf
28171,60,8,68,0,inf
28172,56,13,69,0,inf
28173,57,13,70,0,inf
28174,50,9,59,0,inf
28175,61,9,70,0,inf
28176,61,12,73,0,inf
28177,66,10,76,0,inf
28178,59,13,72,0,inf
28179,51,8,59,0,inf
28180,66,5,71,0,inf
28181,61,8,69,0,inf
28182,52,9,61,0,inf
28183,54,9,63,0,inf
28184,66,6,72,0,inf
28185,52,9,61,0,inf
28186,67,5,72,0,inf
28187,50,11,61,0,inf
28188,67,12,79,0,inf
28189,65,6,71,0,inf
28190,50,8,58,0,inf
28191,60,7,67,0,inf
28192,50,6,56,0,inf
28193,60,7,67,0,inf
28194,51,7,58,0,inf
28195,61,11,72,0,inf
28196,60,6,66,0,inf
28197,63,10,73,0,inf
28198,66,13,79,0,inf
28199,67,5,72,0,inf
28200,54,10,64,0,inf
28201,67,6,73,0,inf
28202,51,13,64,0,inf
28203,58,10,68,0,inf
28204,61,8,69,0,inf
28205,64,11,75,0,inf
28206,53,5,58,0,inf
28207,55,9,64,0,inf
28208,58,11,69,0,inf
28209,52,9,61,0,inf
28210,54,12,66,0,inf
28211,66,10,76,0,inf
28212,54,13,67,0,inf
28213,50,11,61,0,inf
28214,54,11,65,0,inf
28215,51,10,61,0,inf
28216,55,9,64,0,inf
28217,58,12,70,0,inf
28218,59,12,71,0,inf
28219,57,8,65,0,inf
28220,59,8,67,0,inf
28221,59,5,64,1,3.3957243438395253
28222,67,6,73,0,inf
28223,56,10,66,0,inf
28224,66,8,74,0,inf
28225,63,11,74,0,inf
28226,67,11,78,0,inf
28227,52,11,63,0,inf
28228,62,13,75,0,inf
28229,61,10,71,0,inf
28230,64,7,71,0,inf
28231,53,8,61,0,inf
28232,62,7,69,0,inf
28233,64,12,76,0,inf
28234,67,6,73,0,inf
28235,57,11,68,0,inf
28236,51,9,60,0,inf
28237,64,12,76,0,inf
28238,58,7,65,0,inf
28239,56,8,64,0,inf
28240,63,6,69,0,inf
28241,54,13,67,0,inf
28242,62,7,69,0,inf
28243,59,10,69,0,inf
28244,53,7,60,0,inf
28245,56,10,66,0,inf
28246,63,11,74,0,inf
28247,56,8,64,0,inf
28248,64,13,77,0,inf
28249,58,10,68,0,inf
28250,59,6,65,0,inf
28251,53,7,60,0,inf
28252,55,8,63,0,inf
28253,56,7,63,0,inf
28254,64,6,70,0,inf
28255,61,5,66,0,inf
28256,54,10,64,0,inf
28257,58,13,71,0,inf
28258,51,7,58,0,inf
28259,61,13,74,0,inf
28260,55,7,62,0,inf
28261,56,11,67,0,inf
28262,53,10,63,0,inf
28263,59,12,71,0,inf
28264,67,9,76,0,inf
28265,54,5,59,0,inf
28266,56,13,69,0,inf
28267,63,11,74,0,inf
28268,55,12,67,0,inf
28269,62,12,74,0,inf
28270,56,13,69,0,inf
28271,57,6,63,0,inf
28272,63,7,70,0,inf
28273,64,10,74,1,9.299432561554966
28274,57,7,64,0,inf
28275,55,7,62,0,inf
28276,51,11,62,0,inf
28277,64,11,75,0,inf
28278,64,5,69,0,inf
28279,55,5,60,0,inf
28280,55,11,66,0,inf
28281,59,11,70,0,inf
28282,61,8,69,0,inf
28283,50,9,59,0,inf
28284,62,8,70,0,inf
28285,50,10,60,0,inf
28286,67,13,80,0,inf
28287,58,13,71,0,inf
28288,64,5,69,0,inf
28289,65,5,70,0,inf
28290,54,6,60,0,inf
28291,64,8,72,0,inf
28292,58,10,68,0,inf
28293,61,12,73,0,inf
28294,61,12,73,0,inf
28295,65,5,70,0,inf
28296,50,13,63,0,inf
28297,64,12,76,0,inf
28298,63,9,72,0,inf
28299,54,5,59,0,inf
28300,51,5,56,0,inf
28301,56,10,66,1,7.105300954121944
28302,57,9,66,0,inf
28303,53,8,61,0,inf
28304,55,6,61,0,inf
28305,53,5,58,0,inf
28306,61,6,67,0,inf
28307,58,10,68,0,inf
28308,66,11,77,0,inf
28309,58,9,67,0,inf
28310,64,7,71,0,inf
28311,60,11,71,0,inf
28312,56,6,62,0,inf
28313,51,5,56,0,inf
28314,51,12,63,0,inf
28315,52,13,65,0,inf
28316,66,13,79,0,inf
28317,56,10,66,0,inf
28318,58,12,70,0,inf
28319,63,11,74,0,inf
28320,58,9,67,1,5.883987203519794
28321,61,11,72,0,inf
28322,55,12,67,0,inf
28323,64,9,73,0,inf
28324,66,7,73,0,inf
28325,51,7,58,0,inf
28326,67,7,74,0,inf
28327,66,13,79,0,inf
28328,60,6,66,0,inf
28329,65,9,74,0,inf
28330,59,6,65,0,inf
28331,65,11,76,0,inf
28332,66,13,79,0,inf
28333,57,13,70,0,inf
28334,60,8,68,0,inf
28335,63,7,70,0,inf
28336,60,6,66,0,inf
28337,60,12,72,0,inf
28338,66,9,75,0,inf
28339,51,8,59,0,inf
28340,63,9,72,0,inf
28341,55,10,65,0,inf
28342,63,8,71,0,inf
28343,61,8,69,0,inf
28344,50,9,59,0,inf
28345,51,13,64,0,inf
28346,62,11,73,0,inf
28347,50,10,60,0,inf
28348,53,10,63,0,inf
28349,52,5,57,0,inf
28350,59,11,70,0,inf
28351,57,10,67,0,inf
28352,60,7,67,0,inf
28353,63,8,71,0,inf
28354,63,9,72,0,inf
28355,51,9,60,0,inf
28356,52,10,62,1,6.512302366284295
28357,54,9,63,0,inf
28358,58,7,65,0,inf
28359,55,6,61,1,2.225540178506982
28360,65,10,75,0,inf
28361,57,7,64,0,inf
28362,56,10,66,0,inf
28363,53,6,59,0,inf
28364,63,9,72,0,inf
28365,63,6,69,0,inf
28366,50,10,60,0,inf
28367,65,7,72,0,inf
28368,60,5,65,0,inf
28369,65,8,73,0,inf
28370,56,12,68,0,inf
28371,58,6,64,0,inf
28372,63,11,74,0,inf
28373,52,10,62,0,inf
28374,52,13,65,0,inf
28375,52,6,58,0,inf
28376,58,10,68,0,inf
28377,53,6,59,0,inf
28378,60,12,72,0,inf
28379,51,9,60,0,inf
28380,50,5,55,0,inf
28381,56,13,69,0,inf
28382,53,5,58,0,inf
28383,57,9,66,0,inf
28384,62,12,74,0,inf
28385,64,10,74,0,inf
28386,60,9,69,0,inf
28387,61,10,71,0,inf
28388,50,10,60,0,inf
28389,52,12,64,1,11.909924908484562
28390,65,13,78,0,inf
28391,58,6,64,0,inf
28392,56,9,65,0,inf
28393,56,6,62,0,inf
28394,60,10,70,0,inf
28395,62,11,73,0,inf
28396,53,6,59,0,inf
28397,62,7,69,0,inf
28398,54,7,61,0,inf
28399,57,12,69,0,inf
28400,59,6,65,0,inf
28401,61,6,67,0,inf
28402,50,10,60,0,inf
28403,67,7,74,0,inf
28404,67,13,80,0,inf
28405,61,11,72,0,inf
28406,51,11,62,0,inf
28407,56,6,62,0,inf
28408,55,12,67,0,inf
28409,64,7,71,0,inf
28410,60,7,67,0,inf
28411,66,12,78,0,inf
28412,53,7,60,0,inf
28413,54,7,61,0,inf
28414,59,9,68,0,inf
28415,59,8,67,0,inf
28416,51,8,59,0,inf
28417,53,10,63,0,inf
28418,59,10,69,0,inf
28419,59,12,71,0,inf
28420,51,6,57,0,inf
28421,61,5,66,0,inf
28422,64,9,73,0,inf
28423,57,13,70,0,inf
28424,54,13,67,0,inf
28425,59,13,72,0,inf
28426,51,13,64,0,inf
28427,62,13,75,0,inf
28428,59,9,68,0,inf
28429,65,10,75,0,inf
28430,63,6,69,0,inf
28431,63,5,68,0,inf
28432,61,10,71,0,inf
28433,58,5,63,0,inf
28434,54,5,59,0,inf
28435,67,10,77,0,inf
28436,66,13,79,0,inf
28437,63,11,74,0,inf
28438,58,9,67,0,inf
28439,58,8,66,0,inf
28440,62,9,71,0,inf
28441,52,12,64,0,inf
28442,51,8,59,0,inf
28443,65,10,75,0,inf
28444,62,8,70,0,inf
28445,51,5,56,0,inf
28446,56,7,63,0,inf
28447,57,7,64,0,inf
28448,60,5,65,0,inf
28449,58,11,69,0,inf
28450,55,6,61,0,inf
28451,58,13,71,0,inf
28452,50,10,60,0,inf
28453,65,5,70,0,inf
28454,55,10,65,0,inf
28455,65,10,75,0,inf
28456,67,6,73,0,inf
28457,64,5,69,0,inf
28458,55,11,66,0,inf
28459,62,8,70,0,inf
28460,52,7,59,0,inf
28461,52,9,61,0,inf
28462,59,10,69,0,inf
28463,52,13,65,0,inf
28464,66,10,76,0,inf
28465,59,12,71,0,inf
28466,59,10,69,0,inf
28467,59,13,72,0,inf
28468,63,8,71,0,inf
28469,54,8,62,0,inf
28470,67,6,73,0,inf
28471,54,8,62,0,inf
28472,52,5,57,0,inf
28473,67,11,78,0,inf
28474,67,5,72,0,inf
28475,61,7,68,0,inf
28476,51,13,64,0,inf
28477,51,6,57,0,inf
28478,53,11,64,0,inf
28479,60,7,67,0,inf
28480,53,10,63,0,inf
28481,51,7,58,0,inf
28482,67,10,77,0,inf
28483,52,8,60,0,inf
28484,55,10,65,0,inf
28485,59,8,67,0,inf
28486,55,7,62,0,inf
28487,60,12,72,0,inf
28488,59,8,67,0,inf
28489,52,7,59,0,inf
28490,62,11,73,0,inf
28491,51,13,64,0,inf
28492,59,11,70,0,inf
28493,62,6,68,0,inf
28494,64,6,70,0,inf
28495,60,10,70,0,inf
28496,52,7,59,0,inf
28497,60,11,71,0,inf
28498,55,8,63,0,inf
28499,67,10,77,0,inf
28500,62,7,69,0,inf
28501,62,11,73,0,inf
28502,50,13,63,0,inf
28503,50,9,59,0,inf
28504,64,13,77,0,inf
28505,67,11,78,0,inf
28506,50,7,57,0,inf
28507,67,13,80,0,inf
28508,58,13,71,1,8.251828448226647
28509,58,7,65,0,inf
28510,56,12,68,0,inf
28511,54,12,66,0,inf
28512,51,13,64,0,inf
28513,67,10,77,0,inf
28514,63,11,74,1,1.0113898144133913
28515,50,11,61,0,inf
28516,54,8,62,0,inf
28517,59,12,71,0,inf
28518,60,5,65,0,inf
28519,59,6,65,0,inf
28520,53,8,61,0,inf
28521,62,5,67,0,inf
28522,53,9,62,0,inf
28523,62,7,69,0,inf
28524,61,10,71,0,inf
28525,52,13,65,0,inf
28526,57,10,67,1,1.010858504937545
28527,51,12,63,0,inf
28528,51,10,61,0,inf
28529,59,6,65,0,inf
28530,52,12,64,0,inf
28531,52,10,62,0,inf
28532,54,7,61,0,inf
28533,66,13,79,0,inf
28534,57,13,70,0,inf
28535,54,8,62,0,inf
28536,56,7,63,0,inf
28537,63,9,72,0,inf
28538,56,7,63,0,inf
28539,65,13,78,0,inf
28540,60,7,67,0,inf
28541,50,13,63,0,inf
28542,60,10,70,0,inf
28543,58,8,66,0,inf
28544,53,7,60,0,inf
28545,63,12,75,0,inf
28546,63,8,71,0,inf
28547,57,9,66,0,inf
28548,66,8,74,0,inf
28549,64,13,77,0,inf
28550,66,12,78,0,inf
28551,65,12,77,0,inf
28552,61,13,74,0,inf
28553,60,7,67,0,inf
28554,60,13,73,0,inf
28555,53,5,58,0,inf
28556,61,9,70,0,inf
28557,58,12,70,0,inf
28558,53,9,62,0,inf
28559,56,8,64,0,inf
28560,58,10,68,0,inf
28561,62,5,67,0,inf
28562,55,9,64,0,inf
28563,63,12,75,0,inf
28564,65,5,70,0,inf
28565,59,6,65,1,1.7576288408157623
28566,53,7,60,0,inf
28567,59,12,71,0,inf
28568,51,10,61,0,inf
28569,61,7,68,0,inf
28570,63,13,76,0,inf
28571,51,10,61,0,inf
28572,60,6,66,0,inf
28573,61,9,70,0,inf
28574,53,9,62,0,inf
28575,55,12,67,0,inf
28576,60,7,67,0,inf
28577,52,12,64,0,inf
28578,56,12,68,0,inf
28579,67,8,75,0,inf
28580,50,6,56,0,inf
28581,52,5,57,0,inf
28582,52,10,62,0,inf
28583,59,12,71,0,inf
28584,66,9,75,0,inf
28585,52,5,57,0,inf
28586,60,8,68,0,inf
28587,54,9,63,0,inf
28588,63,12,75,0,inf
28589,56,8,64,0,inf
28590,56,11,67,0,inf
28591,61,8,69,0,inf
28592,61,8,69,0,inf
28593,60,6,66,0,inf
28594,65,13,78,0,inf
28595,60,5,65,0,inf
28596,53,13,66,0,inf
28597,67,10,77,0,inf
28598,56,6,62,0,inf
28599,66,12,78,0,inf
28600,58,8,66,0,inf
28601,62,9,71,0,inf
28602,52,5,57,0,inf
28603,52,13,65,0,inf
28604,52,7,59,0,inf
28605,63,12,75,0,inf
28606,56,11,67,0,inf
28607,63,7,70,1,6.591367144965602
28608,66,11,77,0,inf
28609,51,13,64,0,inf
28610,67,8,75,0,inf
28611,52,11,63,0,inf
28612,50,5,55,0,inf
28613,57,7,64,0,inf
28614,61,8,69,0,inf
28615,55,10,65,0,inf
28616,67,8,75,0,inf
28617,52,12,64,0,inf
28618,66,11,77,0,inf
28619,58,6,64,0,inf
28620,59,11,70,0,inf
28621,61,6,67,0,inf
28622,55,13,68,0,inf
28623,59,9,68,0,inf
28624,59,13,72,0,inf
28625,64,10,74,0,inf
28626,61,11,72,0,inf
28627,57,12,69,0,inf
28628,64,9,73,0,inf
28629,59,9,68,0,inf
28630,57,6,63,0,inf
28631,57,12,69,1,7.485009784668293
28632,63,12,75,0,inf
28633,53,8,61,0,inf
28634,62,7,69,0,inf
28635,52,7,59,0,inf
28636,56,7,63,0,inf
28637,60,9,69,0,inf
28638,58,7,65,0,inf
28639,61,12,73,0,inf
28640,56,10,66,0,inf
28641,67,5,72,0,inf
28642,55,12,67,0,inf
28643,52,11,63,0,inf
28644,52,11,63,0,inf
28645,65,10,75,0,inf
28646,66,9,75,0,inf
28647,57,9,66,0,inf
28648,52,6,58,0,inf
28649,62,11,73,0,inf
28650,62,5,67,0,inf
28651,56,10,66,0,inf
28652,52,6,58,0,inf
28653,57,9,66,0,inf
28654,59,12,71,0,inf
28655,65,12,77,0,inf
28656,57,12,69,0,inf
28657,63,12,75,0,inf
28658,51,9,60,0,inf
28659,52,7,59,0,inf
28660,51,11,62,0,inf
28661,54,5,59,0,inf
28662,65,7,72,0,inf
28663,52,7,59,0,inf
28664,57,8,65,0,inf
28665,58,8,66,0,inf
28666,64,6,70,0,inf
28667,61,9,70,0,inf
28668,53,10,63,0,inf
28669,57,8,65,0,inf
28670,62,7,69,0,inf
28671,64,9,73,0,inf
28672,50,13,63,0,inf
28673,57,8,65,0,inf
28674,55,9,64,0,inf
28675,64,13,77,0,inf
28676,61,5,66,0,inf
28677,56,6,62,0,inf
28678,61,13,74,0,inf
28679,57,9,66,0,inf
28680,50,8,58,0,inf
28681,51,10,61,0,inf
28682,67,13,80,0,inf
28683,67,6,73,0,inf
28684,52,7,59,0,inf
28685,51,8,59,0,inf
28686,65,5,70,0,inf
28687,60,8,68,0,inf
28688,64,13,77,1,1.1015248927997021
28689,67,11,78,0,inf
28690,67,7,74,0,inf
28691,53,12,65,0,inf
28692,61,13,74,0,inf
28693,63,10,73,0,inf
28694,51,6,57,0,inf
28695,53,6,59,0,inf
28696,64,11,75,0,inf
28697,66,13,79,0,inf
28698,53,11,64,0,inf
28699,61,10,71,0,inf
28700,66,9,75,0,inf
28701,55,5,60,0,inf
28702,52,12,64,0,inf
28703,52,6,58,0,inf
28704,53,7,60,0,inf
28705,67,13,80,0,inf
28706,58,7,65,0,inf
28707,61,6,67,0,inf
28708,61,10,71,0,inf
28709,66,10,76,0,inf
28710,62,6,68,0,inf
28711,67,13,80,0,inf
28712,65,7,72,0,inf
28713,50,5,55,0,inf
28714,55,12,67,1,6.224669647970757
28715,63,10,73,1,7.407306949551071
28716,55,11,66,0,inf
28717,50,6,56,0,inf
28718,56,6,62,0,inf
28719,67,8,75,0,inf
28720,56,6,62,0,inf
28721,55,10,65,0,inf
28722,57,12,69,0,inf
28723,55,5,60,0,inf
28724,51,9,60,0,inf
28725,56,11,67,0,inf
28726,53,13,66,0,inf
28727,67,13,80,0,inf
28728,57,13,70,0,inf
28729,65,13,78,0,inf
28730,52,8,60,0,inf
28731,60,11,71,0,inf
28732,54,5,59,0,inf
28733,62,9,71,0,inf
28734,57,11,68,0,inf
28735,58,8,66,0,inf
28736,51,9,60,0,inf
28737,55,7,62,0,inf
28738,52,11,63,0,inf
28739,51,12,63,0,inf
28740,62,11,73,0,inf
28741,67,13,80,1,2.9427861431043993
28742,55,10,65,0,inf
28743,56,7,63,0,inf
28744,61,5,66,0,inf
28745,66,5,71,0,inf
28746,64,9,73,0,inf
28747,65,5,70,0,inf
28748,63,9,72,0,inf
28749,53,12,65,0,inf
28750,62,6,68,0,inf
28751,63,11,74,0,inf
28752,63,10,73,0,inf
28753,59,7,66,0,inf
28754,58,10,68,0,inf
28755,55,9,64,0,inf
28756,51,12,63,0,inf
28757,59,13,72,0,inf
28758,67,10,77,0,inf
28759,52,5,57,0,inf
28760,50,7,57,0,inf
28761,50,10,60,0,inf
28762,67,12,79,0,inf
28763,67,9,76,0,inf
28764,65,6,71,0,inf
28765,51,12,63,0,inf
28766,52,9,61,0,inf
28767,58,12,70,0,inf
28768,61,9,70,1,8.17317031924729
28769,66,13,79,0,inf
28770,54,10,64,0,inf
28771,51,6,57,0,inf
28772,53,5,58,0,inf
28773,67,13,80,0,inf
28774,66,6,72,0,inf
28775,66,10,76,0,inf
28776,65,9,74,1,5.47957231593827
28777,51,13,64,0,inf
28778,64,5,69,0,inf
28779,64,12,76,0,inf
28780,60,9,69,0,inf
28781,52,8,60,0,inf
28782,59,11,70,0,inf
28783,64,10,74,0,inf
28784,50,8,58,0,inf
28785,50,11,61,0,inf
28786,64,5,69,0,inf
28787,64,9,73,0,inf
28788,60,12,72,0,inf
28789,62,11,73,0,inf
28790,51,9,60,0,inf
28791,57,7,64,0,inf
28792,55,9,64,0,inf
28793,59,10,69,0,inf
28794,63,11,74,0,inf
28795,50,12,62,1,3.7766005109610745
28796,59,12,71,0,inf
28797,66,10,76,0,inf
28798,62,6,68,0,inf
28799,50,12,62,0,inf
28800,62,7,69,0,inf
28801,66,7,73,0,inf
28802,64,5,69,0,inf
28803,52,11,63,0,inf
28804,64,12,76,0,inf
28805,60,9,69,0,inf
28806,64,8,72,0,inf
28807,66,5,71,0,inf
28808,53,9,62,0,inf
28809,54,9,63,0,inf
28810,65,9,74,0,inf
28811,67,9,76,0,inf
28812,65,13,78,0,inf
28813,67,7,74,0,inf
28814,56,10,66,0,inf
28815,55,13,68,0,inf
28816,59,10,69,0,inf
28817,62,10,72,1,1.3274783088307274
28818,64,9,73,0,inf
28819,63,12,75,0,inf
28820,50,12,62,0,inf
28821,61,9,70,0,inf
28822,57,11,68,0,inf
28823,50,8,58,0,inf
28824,61,9,70,0,inf
28825,64,5,69,0,inf
28826,66,5,71,0,inf
28827,60,9,69,0,inf
28828,51,6,57,0,inf
28829,53,13,66,0,inf
28830,63,7,70,0,inf
28831,53,13,66,0,inf
28832,50,9,59,0,inf
28833,55,8,63,0,inf
28834,55,11,66,0,inf
28835,64,11,75,0,inf
28836,67,13,80,0,inf
28837,61,10,71,0,inf
28838,50,10,60,0,inf
28839,57,7,64,0,inf
28840,50,11,61,0,inf
28841,65,8,73,0,inf
28842,56,6,62,0,inf
28843,63,6,69,0,inf
28844,57,7,64,0,inf
28845,66,8,74,1,3.1893704735008725
28846,51,8,59,0,inf
28847,53,13,66,0,inf
28848,56,5,61,0,inf
28849,60,7,67,0,inf
28850,64,5,69,0,inf
28851,50,11,61,0,inf
28852,67,12,79,0,inf
28853,64,12,76,0,inf
28854,65,5,70,0,inf
28855,51,9,60,0,inf
28856,61,12,73,0,inf
28857,61,13,74,0,inf
28858,64,7,71,0,inf
28859,56,6,62,0,inf
28860,58,6,64,0,inf
28861,52,8,60,0,inf
28862,64,12,76,0,inf
28863,55,12,67,0,inf
28864,62,11,73,0,inf
28865,54,10,64,0,inf
28866,53,7,60,0,inf
28867,65,5,70,0,inf
28868,51,5,56,0,inf
28869,64,8,72,0,inf
28870,64,10,74,0,inf
28871,56,8,64,0,inf
28872,62,5,67,0,inf
28873,54,12,66,0,inf
28874,59,5,64,0,inf
28875,57,10,67,0,inf
28876,61,5,66,0,inf
28877,50,10,60,0,inf
28878,60,12,72,0,inf
28879,52,10,62,0,inf
28880,65,9,74,0,inf
28881,65,12,77,1,6.864648888424767
28882,54,5,59,0,inf
28883,59,7,66,0,inf
28884,55,13,68,0,inf
28885,51,8,59,0,inf
28886,54,7,61,0,inf
28887,56,13,69,0,inf
28888,55,11,66,0,inf
28889,61,7,68,0,inf
28890,67,9,76,0,inf
28891,67,9,76,0,inf
28892,55,11,66,0,inf
28893,59,9,68,0,inf
28894,59,13,72,0,inf
28895,53,8,61,0,inf
28896,52,5,57,0,inf
28897,59,12,71,0,inf
28898,52,7,59,0,inf
28899,52,5,57,0,inf
28900,62,10,72,0,inf
28901,53,10,63,1,8.020621572493724
28902,67,12,79,0,inf
28903,60,13,73,0,inf
28904,61,8,69,0,inf
28905,60,5,65,0,inf
28906,61,9,70,0,inf
28907,52,5,57,0,inf
28908,67,13,80,0,inf
28909,51,13,64,0,inf
28910,67,5,72,0,inf
28911,55,10,65,0,inf
28912,64,13,77,0,inf
28913,60,10,70,0,inf
28914,67,9,76,0,inf
28915,66,13,79,0,inf
28916,56,7,63,0,inf
28917,65,12,77,0,inf
28918,56,13,69,1,0.5089362855433635
28919,64,12,76,0,inf
28920,53,10,63,0,inf
28921,60,8,68,0,inf
28922,52,6,58,0,inf
28923,55,6,61,0,inf
28924,53,8,61,0,inf
28925,65,10,75,0,inf
28926,60,6,66,0,inf
28927,51,10,61,0,inf
28928,57,5,62,0,inf
28929,51,6,57,0,inf
28930,66,8,74,0,inf
28931,50,5,55,0,inf
28932,60,7,67,0,inf
28933,60,7,67,0,inf
28934,54,13,67,0,inf
28935,67,10,77,0,inf
28936,60,8,68,0,inf
28937,63,10,73,0,inf
28938,64,6,70,0,inf
28939,63,12,75,1,1.4749732711653962
28940,54,5,59,0,inf
28941,58,12,70,0,inf
28942,54,6,60,0,inf
28943,54,6,60,0,inf
28944,57,6,63,0,inf
28945,60,11,71,0,inf
28946,52,5,57,0,inf
28947,53,9,62,0,inf
28948,56,11,67,0,inf
28949,54,13,67,0,inf
28950,53,11,64,0,inf
28951,57,13,70,0,inf
28952,58,12,70,0,inf
28953,57,8,65,0,inf
28954,60,7,67,0,inf
28955,51,5,56,0,inf
28956,52,8,60,0,inf
28957,66,9,75,0,inf
28958,58,9,67,0,inf
28959,66,6,72,0,inf
28960,54,5,59,0,inf
28961,66,12,78,0,inf
28962,65,11,76,0,inf
28963,64,5,69,0,inf
28964,51,8,59,0,inf
28965,61,5,66,0,inf
28966,50,9,59,0,inf
28967,51,5,56,0,inf
28968,52,10,62,0,inf
28969,66,6,72,0,inf
28970,61,9,70,0,inf
28971,53,6,59,0,inf
28972,60,13,73,0,inf
28973,67,7,74,0,inf
28974,51,7,58,0,inf
28975,55,6,61,0,inf
28976,56,10,66,0,inf
28977,51,7,58,0,inf
28978,59,9,68,0,inf
28979,50,5,55,0,inf
28980,53,10,63,0,inf
28981,62,10,72,0,inf
28982,64,6,70,0,inf
28983,50,7,57,0,inf
28984,51,11,62,0,inf
28985,56,6,62,0,inf
28986,67,11,78,0,inf
28987,59,9,68,0,inf
28988,63,9,72,0,inf
28989,53,5,58,0,inf
28990,57,13,70,0,inf
28991,65,13,78,0,inf
28992,57,9,66,0,inf
28993,58,10,68,0,inf
28994,52,13,65,0,inf
28995,66,8,74,0,inf
28996,59,11,70,0,inf
28997,52,7,59,0,inf
28998,53,8,61,0,inf
28999,61,6,67,0,inf
29000,57,9,66,0,inf
29001,52,5,57,0,inf
29002,63,5,68,0,inf
29003,58,7,65,0,inf
29004,53,9,62,0,inf
29005,50,12,62,0,inf
29006,57,6,63,0,inf
29007,67,5,72,0,inf
29008,66,9,75,0,inf
29009,50,5,55,0,inf
29010,52,13,65,0,inf
29011,65,12,77,0,inf
29012,55,7,62,0,inf
29013,61,10,71,0,inf
29014,56,5,61,0,inf
29015,55,12,67,0,inf
29016,59,7,66,0,inf
29017,67,7,74,0,inf
29018,54,10,64,0,inf
29019,54,10,64,0,inf
29020,59,9,68,0,inf
29021,63,6,69,0,inf
29022,55,10,65,0,inf
29023,55,9,64,0,inf
29024,54,7,61,0,inf
29025,67,10,77,0,inf
29026,52,12,64,0,inf
29027,65,10,75,0,inf
29028,65,8,73,0,inf
29029,53,7,60,0,inf
29030,60,12,72,0,inf
29031,61,9,70,0,inf
29032,60,6,66,0,inf
29033,64,7,71,0,inf
29034,60,8,68,0,inf
29035,52,8,60,0,inf
29036,66,6,72,0,inf
29037,62,7,69,0,inf
29038,51,9,60,0,inf
29039,64,9,73,0,inf
29040,52,13,65,0,inf
29041,55,7,62,0,inf
29042,59,6,65,0,inf
29043,66,9,75,0,inf
29044,51,7,58,0,inf
29045,65,12,77,1,5.062390776833993
29046,63,10,73,0,inf
29047,66,7,73,0,inf
29048,50,7,57,0,inf
29049,54,9,63,0,inf
29050,57,9,66,0,inf
29051,50,11,61,0,inf
29052,66,5,71,0,inf
29053,64,11,75,0,inf
29054,61,6,67,0,inf
29055,56,12,68,0,inf
29056,52,12,64,0,inf
29057,63,9,72,0,inf
29058,64,9,73,0,inf
29059,52,13,65,0,inf
29060,53,12,65,0,inf
29061,63,12,75,0,inf
29062,50,9,59,0,inf
29063,64,9,73,0,inf
29064,54,8,62,0,inf
29065,66,8,74,0,inf
29066,52,6,58,0,inf
29067,60,5,65,0,inf
29068,59,11,70,0,inf
29069,56,12,68,0,inf
29070,67,7,74,0,inf
29071,65,13,78,0,inf
29072,65,8,73,0,inf
29073,62,7,69,0,inf
29074,50,8,58,0,inf
29075,64,13,77,0,inf
29076,65,11,76,0,inf
29077,52,13,65,0,inf
29078,65,6,71,0,inf
29079,56,13,69,0,inf
29080,67,11,78,0,inf
29081,61,7,68,0,inf
29082,60,13,73,0,inf
29083,67,6,73,1,5.096816692930858
29084,60,8,68,0,inf
29085,61,9,70,0,inf
29086,50,6,56,0,inf
29087,67,10,77,0,inf
29088,54,11,65,0,inf
29089,57,12,69,0,inf
29090,60,8,68,0,inf
29091,55,13,68,0,inf
29092,59,7,66,0,inf
29093,61,7,68,0,inf
29094,62,7,69,0,inf
29095,50,11,61,0,inf
29096,65,12,77,0,inf
29097,50,9,59,0,inf
29098,55,13,68,0,inf
29099,61,6,67,0,inf
29100,53,8,61,0,inf
29101,60,8,68,0,inf
29102,54,9,63,0,inf
29103,57,6,63,0,inf
29104,62,13,75,0,inf
29105,61,5,66,0,inf
29106,62,12,74,0,inf
29107,64,13,77,0,inf
29108,64,9,73,0,inf
29109,61,12,73,1,0.8067627590808257
29110,51,9,60,0,inf
29111,55,11,66,0,inf
29112,54,8,62,0,inf
29113,63,10,73,0,inf
29114,51,6,57,0,inf
29115,56,10,66,0,inf
29116,58,13,71,0,inf
29117,58,10,68,0,inf
29118,63,7,70,0,inf
29119,58,10,68,0,inf
29120,53,9,62,0,inf
29121,58,5,63,0,inf
29122,63,11,74,0,inf
29123,56,6,62,0,inf
29124,55,8,63,0,inf
29125,63,13,76,0,inf
29126,57,10,67,0,inf
29127,59,13,72,0,inf
29128,65,5,70,0,inf
29129,64,9,73,0,inf
29130,67,6,73,0,inf
29131,52,10,62,0,inf
29132,65,6,71,0,inf
29133,66,10,76,0,inf
29134,51,13,64,0,inf
29135,50,5,55,0,inf
29136,55,11,66,0,inf
29137,63,5,68,0,inf
29138,58,7,65,0,inf
29139,56,13,69,0,inf
29140,60,7,67,0,inf
29141,63,7,70,0,inf
29142,54,12,66,0,inf
29143,52,12,64,0,inf
29144,53,10,63,0,inf
29145,51,12,63,0,inf
29146,64,9,73,0,inf
29147,66,9,75,0,inf
29148,62,12,74,0,inf
29149,64,5,69,1,1.7015235687764942
29150,55,5,60,0,inf
29151,53,9,62,0,inf
29152,65,6,71,0,inf
29153,62,11,73,0,inf
29154,63,8,71,0,inf
29155,63,8,71,0,inf
29156,65,13,78,0,inf
29157,51,8,59,0,inf
29158,54,11,65,0,inf
29159,64,10,74,0,inf
29160,52,11,63,0,inf
29161,51,9,60,0,inf
29162,60,5,65,0,inf
29163,54,5,59,0,inf
29164,65,9,74,0,inf
29165,63,9,72,0,inf
29166,51,8,59,1,0.31755321715895946
29167,52,8,60,0,inf
29168,61,13,74,0,inf
29169,52,5,57,0,inf
29170,67,8,75,0,inf
29171,52,6,58,0,inf
29172,60,12,72,0,inf
29173,55,12,67,0,inf
29174,61,12,73,0,inf
29175,64,5,69,0,inf
29176,50,6,56,0,inf
29177,53,8,61,0,inf
29178,56,13,69,0,inf
29179,64,5,69,0,inf
29180,65,5,70,0,inf
29181,65,13,78,0,inf
29182,61,8,69,0,inf
29183,55,11,66,0,inf
29184,50,8,58,0,inf
29185,64,10,74,0,inf
29186,62,8,70,0,inf
29187,56,11,67,0,inf
29188,61,8,69,0,inf
29189,58,11,69,0,inf
29190,56,9,65,0,inf
29191,53,6,59,0,inf
29192,62,7,69,0,inf
29193,50,13,63,0,inf
29194,54,13,67,0,inf
29195,53,9,62,0,inf
29196,53,10,63,0,inf
29197,63,10,73,0,inf
29198,53,9,62,0,inf
29199,51,10,61,0,inf
29200,61,7,68,0,inf
29201,66,12,78,0,inf
29202,61,10,71,0,inf
29203,51,7,58,0,inf
29204,60,6,66,0,inf
29205,56,7,63,0,inf
29206,60,6,66,0,inf
29207,62,10,72,0,inf
29208,57,12,69,1,1.7797013232783812
29209,50,8,58,0,inf
29210,64,13,77,0,inf
29211,64,13,77,0,inf
29212,54,11,65,0,inf
29213,52,8,60,0,inf
29214,52,8,60,0,inf
29215,52,10,62,0,inf
29216,67,7,74,0,inf
29217,60,11,71,0,inf
29218,59,10,69,0,inf
29219,56,6,62,0,inf
29220,61,5,66,0,inf
29221,67,8,75,0,inf
29222,57,11,68,0,inf
29223,64,8,72,0,inf
29224,64,9,73,0,inf
29225,59,5,64,0,inf
29226,66,7,73,0,inf
29227,55,11,66,0,inf
29228,66,13,79,0,inf
29229,57,6,63,0,inf
29230,60,5,65,0,inf
29231,65,10,75,0,inf
29232,53,7,60,0,inf
29233,53,9,62,0,inf
29234,58,12,70,0,inf
29235,54,9,63,0,inf
29236,63,9,72,0,inf
29237,52,13,65,0,inf
29238,61,9,70,0,inf
29239,54,13,67,0,inf
29240,55,11,66,1,1.0525441655159682
29241,65,8,73,0,inf
29242,60,12,72,0,inf
29243,67,10,77,0,inf
29244,63,5,68,0,inf
29245,52,11,63,0,inf
29246,66,11,77,0,inf
29247,55,11,66,0,inf
29248,51,7,58,0,inf
29249,50,13,63,0,inf
29250,53,12,65,0,inf
29251,67,9,76,0,inf
29252,59,10,69,0,inf
29253,58,9,67,0,inf
29254,50,9,59,0,inf
29255,50,9,59,0,inf
29256,57,7,64,0,inf
29257,54,12,66,0,inf
29258,67,11,78,0,inf
29259,62,11,73,0,inf
29260,55,10,65,0,inf
29261,59,10,69,0,inf
29262,53,9,62,0,inf
29263,65,8,73,0,inf
29264,59,12,71,0,inf
29265,62,12,74,0,inf
29266,67,9,76,0,inf
29267,54,13,67,0,inf
29268,53,7,60,0,inf
29269,54,6,60,0,inf
29270,64,7,71,0,inf
29271,53,5,58,0,inf
29272,60,11,71,0,inf
29273,59,11,70,0,inf
29274,61,13,74,0,inf
29275,66,7,73,0,inf
29276,52,9,61,0,inf
29277,58,9,67,0,inf
29278,63,12,75,0,inf
29279,62,7,69,0,inf
29280,58,12,70,0,inf
29281,51,9,60,0,inf
29282,58,6,64,0,inf
29283,50,10,60,0,inf
29284,62,5,67,0,inf
29285,64,12,76,0,inf
29286,57,11,68,1,7.5556645373142715
29287,54,6,60,0,inf
29288,60,13,73,0,inf
29289,59,13,72,0,inf
29290,55,9,64,0,inf
29291,58,7,65,0,inf
29292,58,6,64,0,inf
29293,62,11,73,0,inf
29294,55,10,65,0,inf
29295,59,5,64,0,inf
29296,63,7,70,0,inf
29297,60,10,70,0,inf
29298,63,13,76,0,inf
29299,67,11,78,0,inf
29300,58,6,64,0,inf
29301,54,11,65,0,inf
29302,58,9,67,0,inf
29303,67,6,73,0,inf
29304,56,11,67,0,inf
29305,56,12,68,0,inf
29306,56,10,66,0,inf
29307,66,9,75,0,inf
29308,67,11,78,0,inf
29309,52,13,65,0,inf
29310,61,6,67,0,inf
29311,56,5,61,0,inf
29312,60,8,68,0,inf
29313,51,10,61,0,inf
29314,52,5,57,0,inf
29315,51,11,62,0,inf
29316,61,7,68,0,inf
29317,58,6,64,0,inf
29318,64,7,71,0,inf
29319,57,13,70,0,inf
29320,61,8,69,0,inf
29321,54,9,63,0,inf
29322,56,9,65,0,inf
29323,52,8,60,0,inf
29324,53,5,58,0,inf
29325,60,9,69,0,inf
29326,64,11,75,0,inf
29327,65,8,73,0,inf
29328,66,12,78,0,inf
29329,62,8,70,0,inf
29330,58,10,68,0,inf
29331,62,8,70,0,inf
29332,55,12,67,0,inf
29333,62,13,75,0,inf
29334,54,6,60,0,inf
29335,63,10,73,0,inf
29336,61,13,74,1,5.986376288009339
29337,50,5,55,0,inf
29338,59,12,71,1,8.001383851077875
29339,56,13,69,0,inf
29340,52,10,62,0,inf
29341,65,8,73,0,inf
29342,67,11,78,0,inf
29343,58,13,71,0,inf
29344,51,13,64,0,inf
29345,54,11,65,0,inf
29346,64,7,71,0,inf
29347,67,6,73,0,inf
29348,51,7,58,0,inf
29349,67,11,78,0,inf
29350,63,7,70,0,inf
29351,61,12,73,0,inf
29352,60,12,72,1,3.223415412400499
29353,61,5,66,0,inf
29354,56,8,64,0,inf
29355,61,8,69,0,inf
29356,50,13,63,0,inf
29357,50,10,60,0,inf
29358,57,6,63,0,inf
29359,56,10,66,0,inf
29360,67,8,75,0,inf
29361,62,9,71,0,inf
29362,59,11,70,0,inf
29363,57,8,65,0,inf
29364,57,12,69,0,inf
29365,56,11,67,0,inf
29366,66,7,73,0,inf
29367,67,5,72,0,inf
29368,66,8,74,0,inf
29369,50,10,60,0,inf
29370,53,5,58,0,inf
29371,55,9,64,0,inf
29372,52,5,57,0,inf
29373,57,11,68,0,inf
29374,65,12,77,0,inf
29375,58,13,71,0,inf
29376,60,12,72,0,inf
29377,51,13,64,0,inf
29378,67,5,72,0,inf
29379,60,13,73,0,inf
29380,66,6,72,1,1.3961935466360558
29381,62,11,73,0,inf
29382,56,12,68,0,inf
29383,66,10,76,0,inf
29384,53,5,58,0,inf
29385,65,10,75,1,4.4390884566987125
29386,58,8,66,0,inf
29387,52,10,62,0,inf
29388,51,13,64,0,inf
29389,61,10,71,0,inf
29390,63,8,71,0,inf
29391,60,11,71,0,inf
29392,61,10,71,0,inf
29393,58,11,69,0,inf
29394,56,10,66,0,inf
29395,62,6,68,0,inf
29396,53,7,60,0,inf
29397,54,5,59,0,inf
29398,55,7,62,0,inf
29399,66,13,79,0,inf
29400,66,7,73,0,inf
29401,50,9,59,0,inf
29402,52,10,62,0,inf
29403,63,13,76,0,inf
29404,60,6,66,0,inf
29405,54,11,65,0,inf
29406,63,10,73,0,inf
29407,59,7,66,0,inf
29408,53,7,60,0,inf
29409,53,9,62,0,inf
29410,61,8,69,0,inf
29411,52,5,57,0,inf
29412,59,5,64,0,inf
29413,65,6,71,0,inf
29414,50,10,60,0,inf
29415,52,8,60,0,inf
29416,55,8,63,0,inf
29417,56,10,66,0,inf
29418,58,13,71,0,inf
29419,59,12,71,0,inf
29420,54,12,66,0,inf
29421,59,10,69,0,inf
29422,63,8,71,0,inf
29423,51,12,63,0,inf
29424,63,5,68,0,inf
29425,67,12,79,0,inf
29426,57,12,69,0,inf
29427,51,5,56,0,inf
29428,61,12,73,0,inf
29429,59,6,65,0,inf
29430,64,10,74,0,inf
29431,62,10,72,0,inf
29432,64,9,73,0,inf
29433,58,7,65,0,inf
29434,61,9,70,0,inf
29435,54,8,62,0,inf
29436,65,13,78,0,inf
29437,65,8,73,0,inf
29438,66,9,75,0,inf
29439,53,12,65,0,inf
29440,66,6,72,0,inf
29441,64,11,75,0,inf
29442,50,10,60,0,inf
29443,54,9,63,0,inf
29444,56,7,63,0,inf
29445,53,12,65,0,inf
29446,65,5,70,0,inf
29447,65,8,73,0,inf
29448,61,6,67,0,inf
29449,53,8,61,0,inf
29450,64,6,70,0,inf
29451,52,7,59,0,inf
29452,58,7,65,0,inf
29453,62,10,72,0,inf
29454,56,6,62,0,inf
29455,52,9,61,0,inf
29456,65,12,77,0,inf
29457,67,6,73,0,inf
29458,53,8,61,0,inf
29459,58,6,64,0,inf
29460,61,10,71,0,inf
29461,53,13,66,0,inf
29462,55,7,62,0,inf
29463,60,10,70,0,inf
29464,58,12,70,1,1.4118899467246564
29465,55,12,67,0,inf
29466,64,5,69,0,inf
29467,57,11,68,0,inf
29468,52,9,61,0,inf
29469,51,13,64,0,inf
29470,51,7,58,1,2.649026459991518
29471,50,8,58,0,inf
29472,52,8,60,1,5.929649042293178
29473,66,8,74,0,inf
29474,65,11,76,0,inf
29475,66,5,71,0,inf
29476,51,5,56,0,inf
29477,53,10,63,0,inf
29478,52,13,65,0,inf
29479,58,10,68,0,inf
29480,51,6,57,0,inf
29481,52,7,59,1,5.271796158896329
29482,58,12,70,0,inf
29483,62,7,69,0,inf
29484,54,7,61,0,inf
29485,62,10,72,0,inf
29486,56,7,63,0,inf
29487,67,11,78,0,inf
29488,51,6,57,0,inf
29489,55,5,60,0,inf
29490,51,7,58,0,inf
29491,55,8,63,0,inf
29492,67,6,73,0,inf
29493,66,7,73,0,inf
29494,53,8,61,0,inf
29495,62,9,71,0,inf
29496,64,11,75,0,inf
29497,62,11,73,0,inf
29498,56,7,63,0,inf
29499,61,6,67,0,inf
29500,63,7,70,0,inf
29501,62,6,68,0,inf
29502,51,12,63,0,inf
29503,50,11,61,0,inf
29504,55,10,65,0,inf
29505,64,11,75,0,inf
29506,59,5,64,0,inf
29507,60,5,65,0,inf
29508,64,6,70,0,inf
29509,64,13,77,0,inf
29510,61,9,70,0,inf
29511,57,12,69,0,inf
29512,63,7,70,0,inf
29513,54,11,65,0,inf
29514,65,10,75,0,inf
29515,53,5,58,0,inf
29516,58,5,63,0,inf
29517,63,7,70,0,inf
29518,55,11,66,0,inf
29519,60,10,70,0,inf
29520,63,6,69,0,inf
29521,54,11,65,0,inf
29522,54,7,61,0,inf
29523,50,6,56,0,inf
29524,58,13,71,1,11.175728239036218
29525,53,5,58,0,inf
29526,53,9,62,0,inf
29527,53,9,62,0,inf
29528,61,7,68,0,inf
29529,56,8,64,0,inf
29530,67,7,74,0,inf
29531,53,13,66,0,inf
29532,59,6,65,0,inf
29533,58,12,70,0,inf
29534,60,6,66,0,inf
29535,53,10,63,1,7.279255736896559
29536,56,11,67,0,inf
29537,65,7,72,0,inf
29538,62,9,71,0,inf
29539,60,6,66,0,inf
29540,60,12,72,0,inf
29541,52,12,64,0,inf
29542,63,12,75,0,inf
29543,55,10,65,0,inf
29544,54,12,66,0,inf
29545,59,13,72,0,inf
29546,60,7,67,0,inf
29547,65,9,74,0,inf
29548,54,10,64,0,inf
29549,64,8,72,0,inf
29550,54,12,66,0,inf
29551,51,13,64,0,inf
29552,54,6,60,0,inf
29553,50,7,57,0,inf
29554,59,10,69,0,inf
29555,53,13,66,0,inf
29556,66,7,73,0,inf
29557,64,11,75,0,inf
29558,51,5,56,0,inf
29559,51,12,63,0,inf
29560,53,12,65,0,inf
29561,50,6,56,0,inf
29562,51,12,63,0,inf
29563,56,8,64,0,inf
29564,60,10,70,0,inf
29565,63,5,68,0,inf
29566,53,5,58,0,inf
29567,54,13,67,0,inf
29568,65,8,73,0,inf
29569,53,12,65,0,inf
29570,57,9,66,0,inf
29571,66,7,73,0,inf
29572,57,11,68,0,inf
29573,53,6,59,0,inf
29574,56,9,65,0,inf
29575,55,9,64,0,inf
29576,55,12,67,1,9.239388078346678
29577,53,11,64,0,inf
29578,54,5,59,0,inf
29579,52,7,59,0,inf
29580,59,11,70,0,inf
29581,50,5,55,0,inf
29582,56,12,68,0,inf
29583,65,7,72,0,inf
29584,50,11,61,0,inf
29585,64,7,71,0,inf
29586,64,5,69,0,inf
29587,64,11,75,0,inf
29588,53,9,62,0,inf
29589,64,11,75,0,inf
29590,60,12,72,0,inf
29591,51,5,56,0,inf
29592,53,9,62,0,inf
29593,66,5,71,0,inf
29594,64,8,72,0,inf
29595,57,10,67,0,inf
29596,56,5,61,0,inf
29597,55,8,63,0,inf
29598,56,12,68,0,inf
29599,50,5,55,0,inf
29600,65,8,73,0,inf
29601,59,13,72,0,inf
29602,62,6,68,0,inf
29603,50,10,60,0,inf
29604,52,12,64,0,inf
29605,59,11,70,0,inf
29606,67,9,76,0,inf
29607,66,10,76,0,inf
29608,52,10,62,0,inf
29609,65,9,74,0,inf
29610,60,12,72,0,inf
29611,55,10,65,0,inf
29612,60,5,65,0,inf
29613,56,7,63,0,inf
29614,67,11,78,0,inf
29615,50,8,58,0,inf
29616,57,11,68,0,inf
29617,64,13,77,0,inf
29618,50,8,58,0,inf
29619,66,13,79,0,inf
29620,59,9,68,0,inf
29621,65,12,77,0,inf
29622,66,11,77,0,inf
29623,62,6,68,0,inf
29624,61,13,74,0,inf
29625,62,5,67,0,inf
29626,61,9,70,0,inf
29627,66,9,75,0,inf
29628,52,11,63,1,0.3709557619031969
29629,63,8,71,1,0.009423005015861463
29630,66,8,74,0,inf
29631,67,12,79,0,inf
29632,66,6,72,0,inf
29633,52,12,64,0,inf
29634,52,9,61,0,inf
29635,61,7,68,0,inf
29636,62,7,69,1,5.606711364120798
29637,67,6,73,0,inf
29638,63,8,71,0,inf
29639,57,12,69,0,inf
29640,51,13,64,0,inf
29641,67,11,78,0,inf
29642,62,13,75,0,inf
29643,50,11,61,0,inf
29644,62,11,73,0,inf
29645,52,12,64,0,inf
29646,54,8,62,0,inf
29647,51,9,60,0,inf
29648,60,6,66,0,inf
29649,54,5,59,0,inf
29650,60,5,65,0,inf
29651,65,9,74,0,inf
29652,61,13,74,0,inf
29653,63,12,75,0,inf
29654,60,13,73,0,inf
29655,65,12,77,0,inf
29656,67,11,78,0,inf
29657,64,6,70,0,inf
29658,65,11,76,0,inf
29659,54,9,63,1,3.172165915636036
29660,59,5,64,0,inf
29661,50,10,60,0,inf
29662,65,12,77,0,inf
29663,65,8,73,0,inf
29664,62,10,72,0,inf
29665,61,6,67,0,inf
29666,65,10,75,0,inf
29667,67,12,79,0,inf
29668,54,7,61,0,inf
29669,62,13,75,1,6.0398118427990966
29670,65,7,72,0,inf
29671,67,11,78,0,inf
29672,53,12,65,0,inf
29673,55,10,65,0,inf
29674,50,12,62,0,inf
29675,60,11,71,0,inf
29676,54,7,61,0,inf
29677,57,12,69,0,inf
29678,61,11,72,0,inf
29679,55,13,68,0,inf
29680,50,10,60,0,inf
29681,57,7,64,1,2.962834452224925
29682,66,7,73,0,inf
29683,57,5,62,0,inf
29684,55,6,61,0,inf
29685,63,7,70,0,inf
29686,51,10,61,0,inf
29687,63,12,75,0,inf
29688,62,11,73,0,inf
29689,56,11,67,0,inf
29690,62,13,75,0,inf
29691,52,7,59,0,inf
29692,52,13,65,0,inf
29693,63,12,75,0,inf
29694,61,7,68,0,inf
29695,50,13,63,0,inf
29696,61,10,71,0,inf
29697,55,5,60,0,inf
29698,64,5,69,0,inf
29699,51,7,58,0,inf
29700,65,12,77,0,inf
29701,58,8,66,0,inf
29702,63,13,76,0,inf
29703,67,8,75,0,inf
29704,57,5,62,1,3.924235812360699
29705,55,7,62,0,inf
29706,65,13,78,0,inf
29707,64,6,70,0,inf
29708,60,6,66,0,inf
29709,57,8,65,0,inf
29710,54,11,65,1,3.7353708994770756
29711,53,13,66,0,inf
29712,59,7,66,0,inf
29713,62,8,70,0,inf
29714,65,8,73,1,4.261401934058796
29715,61,10,71,0,inf
29716,67,7,74,0,inf
29717,64,5,69,0,inf
29718,58,12,70,0,inf
29719,60,8,68,0,inf
29720,50,10,60,0,inf
29721,62,9,71,0,inf
29722,64,7,71,0,inf
29723,65,9,74,0,inf
29724,62,8,70,0,inf
29725,62,12,74,0,inf
29726,54,6,60,0,inf
29727,67,6,73,0,inf
29728,52,9,61,0,inf
29729,52,9,61,0,inf
29730,58,12,70,0,inf
29731,54,8,62,0,inf
29732,57,13,70,0,inf
29733,50,11,61,0,inf
29734,57,5,62,0,inf
29735,50,9,59,0,inf
29736,67,6,73,0,inf
29737,59,8,67,0,inf
29738,58,13,71,0,inf
29739,62,11,73,0,inf
29740,59,9,68,0,inf
29741,65,6,71,0,inf
29742,57,8,65,0,inf
29743,52,10,62,0,inf
29744,50,12,62,0,inf
29745,62,6,68,0,inf
29746,53,13,66,0,inf
29747,56,11,67,0,inf
29748,55,10,65,0,inf
29749,56,7,63,0,inf
29750,55,9,64,0,inf
29751,50,10,60,0,inf
29752,50,9,59,0,inf
29753,64,12,76,1,3.0936089790748866
29754,59,8,67,0,inf
29755,50,7,57,0,inf
29756,53,9,62,0,inf
29757,58,6,64,0,inf
29758,58,8,66,0,inf
29759,53,11,64,0,inf
29760,61,13,74,0,inf
29761,62,9,71,0,inf
29762,53,9,62,0,inf
29763,58,5,63,0,inf
29764,64,9,73,0,inf
29765,59,9,68,0,inf
29766,52,12,64,0,inf
29767,50,10,60,0,inf
29768,51,11,62,0,inf
29769,54,9,63,0,inf
29770,63,5,68,0,inf
29771,62,5,67,0,inf
29772,57,9,66,0,inf
29773,62,6,68,0,inf
29774,50,10,60,0,inf
29775,62,7,69,0,inf
29776,58,6,64,0,inf
29777,65,12,77,0,inf
29778,63,5,68,0,inf
29779,54,9,63,0,inf
29780,62,7,69,0,inf
29781,65,10,75,0,inf
29782,56,8,64,0,inf
29783,56,7,63,0,inf
29784,54,6,60,0,inf
29785,59,8,67,0,inf
29786,55,13,68,0,inf
29787,55,5,60,0,inf
29788,54,6,60,0,inf
29789,66,8,74,0,inf
29790,63,13,76,0,inf
29791,61,11,72,0,inf
29792,57,13,70,0,inf
29793,56,10,66,0,inf
29794,61,13,74,0,inf
29795,56,9,65,0,inf
29796,54,9,63,0,inf
29797,58,11,69,0,inf
29798,62,10,72,0,inf
29799,50,9,59,0,inf
29800,62,5,67,0,inf
29801,62,12,74,0,inf
29802,63,8,71,0,inf
29803,55,8,63,0,inf
29804,58,6,64,0,inf
29805,52,8,60,0,inf
29806,52,12,64,0,inf
29807,63,10,73,0,inf
29808,65,9,74,0,inf
29809,66,7,73,0,inf
29810,66,5,71,0,inf
29811,57,12,69,0,inf
29812,57,9,66,0,inf
29813,52,6,58,0,inf
29814,64,11,75,0,inf
29815,65,6,71,0,inf
29816,66,8,74,0,inf
29817,51,12,63,0,inf
29818,58,11,69,0,inf
29819,53,9,62,0,inf
29820,67,5,72,0,inf
29821,56,8,64,0,inf
29822,63,9,72,0,inf
29823,61,9,70,0,inf
29824,57,8,65,0,inf
29825,63,5,68,0,inf
29826,66,12,78,0,inf
29827,57,11,68,0,inf
29828,65,12,77,0,inf
29829,53,10,63,0,inf
29830,51,10,61,0,inf
29831,63,5,68,0,inf
29832,67,13,80,0,inf
29833,59,7,66,0,inf
29834,55,7,62,0,inf
29835,52,6,58,0,inf
29836,51,10,61,0,inf
29837,56,9,65,0,inf
29838,57,6,63,0,inf
29839,54,13,67,0,inf
29840,51,10,61,0,inf
29841,52,8,60,0,inf
29842,64,10,74,0,inf
29843,60,13,73,0,inf
29844,53,7,60,0,inf
29845,63,5,68,0,inf
29846,63,8,71,0,inf
29847,55,7,62,0,inf
29848,55,8,63,0,inf
29849,63,12,75,0,inf
29850,61,10,71,0,inf
29851,51,13,64,0,inf
29852,54,13,67,0,inf
29853,55,5,60,0,inf
29854,62,11,73,0,inf
29855,52,10,62,0,inf
29856,55,10,65,0,inf
29857,59,6,65,0,inf
29858,65,8,73,0,inf
29859,51,13,64,0,inf
29860,53,10,63,0,inf
29861,58,13,71,0,inf
29862,65,13,78,0,inf
29863,51,11,62,0,inf
29864,56,10,66,0,inf
29865,56,5,61,0,inf
29866,63,13,76,0,inf
29867,66,13,79,1,10.763428744361207
29868,60,9,69,1,2.4553489518172142
29869,59,9,68,0,inf
29870,53,8,61,0,inf
29871,56,8,64,0,inf
29872,60,13,73,0,inf
29873,53,7,60,0,inf
29874,66,9,75,0,inf
29875,50,12,62,0,inf
29876,52,6,58,0,inf
29877,50,10,60,0,inf
29878,54,10,64,0,inf
29879,50,6,56,1,3.7917594332120927
29880,67,7,74,0,inf
29881,57,11,68,0,inf
29882,61,13,74,0,inf
29883,62,11,73,0,inf
29884,51,12,63,0,inf
29885,55,7,62,0,inf
29886,66,12,78,0,inf
29887,52,12,64,0,inf
29888,62,9,71,0,inf
29889,67,5,72,0,inf
29890,62,11,73,0,inf
29891,50,8,58,0,inf
29892,59,7,66,0,inf
29893,51,8,59,0,inf
29894,62,7,69,0,inf
29895,52,5,57,0,inf
29896,62,6,68,0,inf
29897,61,6,67,0,inf
29898,58,8,66,0,inf
29899,61,7,68,1,6.079735789986728
29900,52,7,59,0,inf
29901,61,12,73,1,6.011594285458997
29902,59,10,69,0,inf
29903,63,12,75,0,inf
29904,54,10,64,0,inf
29905,63,5,68,0,inf
29906,61,8,69,0,inf
29907,61,13,74,0,inf
29908,61,8,69,0,inf
29909,59,6,65,0,inf
29910,62,12,74,0,inf
29911,61,12,73,0,inf
29912,60,8,68,0,inf
29913,61,5,66,0,inf
29914,58,5,63,0,inf
29915,57,11,68,0,inf
29916,52,10,62,0,inf
29917,64,9,73,0,inf
29918,55,11,66,0,inf
29919,56,6,62,0,inf
29920,66,5,71,0,inf
29921,63,8,71,0,inf
29922,54,9,63,0,inf
29923,67,13,80,0,inf
29924,63,12,75,0,inf
29925,55,8,63,0,inf
29926,50,7,57,0,inf
29927,57,9,66,0,inf
29928,64,12,76,0,inf
29929,60,6,66,0,inf
29930,67,5,72,0,inf
29931,62,7,69,0,inf
29932,67,5,72,0,inf
29933,52,10,62,0,inf
29934,53,11,64,0,inf
29935,61,9,70,0,inf
29936,54,13,67,0,inf
29937,57,6,63,0,inf
29938,61,6,67,0,inf
29939,52,13,65,0,inf
29940,57,7,64,0,inf
29941,58,5,63,0,inf
29942,58,5,63,0,inf
29943,60,5,65,0,inf
29944,50,5,55,0,inf
29945,67,9,76,0,inf
29946,60,5,65,0,inf
29947,65,8,73,0,inf
29948,64,13,77,1,7.4378262306556024
29949,60,12,72,0,inf
29950,51,7,58,0,inf
29951,64,12,76,0,inf
29952,52,12,64,0,inf
29953,61,7,68,0,inf
29954,65,8,73,0,inf
29955,55,10,65,0,inf
29956,56,12,68,0,inf
29957,58,9,67,0,inf
29958,50,12,62,0,inf
29959,60,5,65,0,inf
29960,57,7,64,0,inf
29961,50,6,56,0,inf
29962,61,11,72,0,inf
29963,50,7,57,0,inf
29964,67,13,80,0,inf
29965,52,11,63,0,inf
29966,65,10,75,0,inf
29967,51,13,64,0,inf
29968,57,12,69,0,inf
29969,65,12,77,0,inf
29970,65,6,71,0,inf
29971,58,9,67,0,inf
29972,54,12,66,1,1.594317095264536
29973,52,9,61,0,inf
29974,64,6,70,0,inf
29975,60,9,69,0,inf
29976,55,12,67,0,inf
29977,54,12,66,0,inf
29978,55,5,60,0,inf
29979,56,11,67,0,inf
29980,58,12,70,0,inf
29981,65,10,75,0,inf
29982,55,8,63,0,inf
29983,57,8,65,0,inf
29984,66,6,72,0,inf
29985,56,6,62,0,inf
29986,55,6,61,0,inf
29987,63,5,68,0,inf
29988,50,13,63,0,inf
29989,57,8,65,0,inf
29990,52,11,63,1,10.30822531237682
29991,64,13,77,0,inf
29992,55,6,61,0,inf
29993,57,11,68,0,inf
29994,63,6,69,0,inf
29995,61,9,70,0,inf
29996,50,6,56,0,inf
29997,53,13,66,0,inf
29998,67,7,74,0,inf
29999,61,6,67,0,inf
30000,58,5,63,0,inf
30001,55,5,60,0,inf
30002,55,12,67,0,inf
30003,60,8,68,0,inf
30004,54,6,60,0,inf
30005,67,7,74,0,inf
30006,65,11,76,0,inf
30007,50,9,59,0,inf
30008,61,13,74,0,inf
30009,55,13,68,0,inf
30010,57,11,68,0,inf
30011,67,9,76,0,inf
30012,61,11,72,0,inf
30013,54,6,60,0,inf
30014,64,10,74,0,inf
30015,62,10,72,0,inf
30016,64,8,72,0,inf
30017,67,10,77,0,inf
30018,62,13,75,0,inf
30019,67,13,80,0,inf
30020,58,10,68,0,inf
30021,66,12,78,0,inf
30022,63,11,74,0,inf
30023,53,12,65,0,inf
30024,54,10,64,0,inf
30025,50,8,58,0,inf
30026,65,10,75,0,inf
30027,58,11,69,0,inf
30028,58,6,64,0,inf
30029,67,12,79,0,inf
30030,50,10,60,0,inf
30031,63,13,76,0,inf
30032,55,6,61,0,inf
30033,65,10,75,0,inf
30034,59,5,64,0,inf
30035,59,13,72,0,inf
30036,58,9,67,0,inf
30037,60,6,66,0,inf
30038,58,10,68,0,inf
30039,67,11,78,0,inf
30040,63,13,76,0,inf
30041,57,11,68,0,inf
30042,62,6,68,0,inf
30043,55,8,63,0,inf
30044,50,7,57,0,inf
30045,58,9,67,0,inf
30046,62,6,68,0,inf
30047,66,12,78,0,inf
30048,51,6,57,0,inf
30049,57,9,66,0,inf
30050,50,5,55,0,inf
30051,67,13,80,0,inf
30052,54,6,60,0,inf
30053,62,6,68,0,inf
30054,55,12,67,0,inf
30055,59,8,67,0,inf
30056,52,6,58,0,inf
30057,57,7,64,0,inf
30058,54,9,63,0,inf
30059,56,12,68,0,inf
30060,51,9,60,0,inf
30061,56,7,63,0,inf
30062,67,13,80,0,inf
30063,58,10,68,0,inf
30064,60,7,67,0,inf
30065,53,8,61,0,inf
30066,57,6,63,0,inf
30067,53,13,66,0,inf
30068,51,6,57,0,inf
30069,65,9,74,0,inf
30070,57,5,62,0,inf
30071,52,9,61,0,inf
30072,57,9,66,0,inf
30073,56,7,63,0,inf
30074,64,9,73,0,inf
30075,67,12,79,0,inf
30076,59,9,68,0,inf
30077,67,5,72,0,inf
30078,67,12,79,1,1.5920563813826902
30079,61,8,69,0,inf
30080,56,6,62,0,inf
30081,62,7,69,0,inf
30082,53,6,59,0,inf
30083,54,9,63,0,inf
30084,54,9,63,0,inf
30085,66,5,71,0,inf
30086,59,12,71,0,inf
30087,55,7,62,0,inf
30088,66,7,73,0,inf
30089,62,7,69,0,inf
30090,60,12,72,0,inf
30091,56,13,69,0,inf
30092,58,10,68,0,inf
30093,62,13,75,0,inf
30094,64,11,75,0,inf
30095,55,12,67,0,inf
30096,59,9,68,0,inf
30097,51,5,56,0,inf
30098,51,6,57,0,inf
30099,65,11,76,0,inf
30100,62,13,75,0,inf
30101,58,13,71,0,inf
30102,54,11,65,0,inf
30103,60,8,68,0,inf
30104,57,7,64,0,inf
30105,50,10,60,0,inf
30106,61,8,69,0,inf
30107,59,9,68,0,inf
30108,66,9,75,0,inf
30109,58,5,63,0,inf
30110,58,10,68,0,inf
30111,61,5,66,0,inf
30112,58,8,66,0,inf
30113,50,7,57,0,inf
30114,55,6,61,0,inf
30115,62,11,73,0,inf
30116,55,10,65,1,7.868770655507092
30117,56,7,63,0,inf
30118,50,13,63,0,inf
30119,54,11,65,0,inf
30120,51,5,56,0,inf
30121,50,12,62,0,inf
30122,59,9,68,0,inf
30123,57,9,66,0,inf
30124,63,5,68,0,inf
30125,67,5,72,0,inf
30126,52,12,64,0,inf
30127,57,7,64,0,inf
30128,60,9,69,0,inf
30129,62,11,73,0,inf
30130,65,7,72,0,inf
30131,64,12,76,0,inf
30132,61,11,72,0,inf
30133,55,5,60,0,inf
30134,61,9,70,1,3.5825606103360172
30135,53,10,63,0,inf
30136,62,8,70,0,inf
30137,53,13,66,0,inf
30138,55,10,65,0,inf
30139,55,13,68,0,inf
30140,66,7,73,0,inf
30141,62,8,70,0,inf
30142,50,13,63,0,inf
30143,57,10,67,0,inf
30144,66,5,71,0,inf
30145,51,6,57,0,inf
30146,64,8,72,0,inf
30147,52,7,59,0,inf
30148,56,13,69,0,inf
30149,61,13,74,0,inf
30150,65,11,76,0,inf
30151,53,5,58,0,inf
30152,61,10,71,0,inf
30153,54,11,65,0,inf
30154,54,9,63,0,inf
30155,59,7,66,0,inf
30156,66,10,76,0,inf
30157,53,11,64,0,inf
30158,66,5,71,1,4.580524467544464
30159,58,11,69,0,inf
30160,59,9,68,0,inf
30161,53,13,66,1,2.8560882894446493
30162,55,12,67,0,inf
30163,61,10,71,0,inf
30164,62,9,71,0,inf
30165,55,8,63,0,inf
30166,66,12,78,0,inf
30167,56,13,69,0,inf
30168,56,11,67,0,inf
30169,67,13,80,0,inf
30170,57,9,66,0,inf
30171,58,13,71,0,inf
30172,57,8,65,0,inf
30173,65,5,70,0,inf
30174,55,5,60,0,inf
30175,56,9,65,0,inf
30176,55,10,65,0,inf
30177,52,9,61,0,inf
30178,67,12,79,0,inf
30179,56,9,65,0,inf
30180,54,6,60,0,inf
30181,59,12,71,0,inf
30182,53,12,65,0,inf
30183,55,11,66,0,inf
30184,58,5,63,0,inf
30185,52,11,63,0,inf
30186,52,6,58,0,inf
30187,56,7,63,0,inf
30188,66,7,73,1,3.5943976511329225
30189,53,6,59,0,inf
30190,56,10,66,0,inf
30191,50,6,56,0,inf
30192,52,7,59,0,inf
30193,61,9,70,0,inf
30194,53,12,65,0,inf
30195,62,7,69,0,inf
30196,53,10,63,0,inf
30197,54,11,65,0,inf
30198,61,7,68,0,inf
30199,57,5,62,0,inf
30200,54,7,61,0,inf
30201,51,8,59,0,inf
30202,62,10,72,0,inf
30203,51,5,56,0,inf
30204,55,5,60,0,inf
30205,59,11,70,0,inf
30206,62,12,74,0,inf
30207,51,11,62,0,inf
30208,66,11,77,0,inf
30209,62,13,75,0,inf
30210,67,9,76,0,inf
30211,53,7,60,0,inf
30212,67,10,77,0,inf
30213,54,6,60,0,inf
30214,59,6,65,0,inf
30215,64,9,73,0,inf
30216,53,6,59,0,inf
30217,58,5,63,0,inf
30218,61,10,71,0,inf
30219,66,7,73,0,inf
30220,53,13,66,0,inf
30221,51,7,58,0,inf
30222,57,10,67,0,inf
30223,62,11,73,0,inf
30224,51,12,63,0,inf
30225,64,5,69,0,inf
30226,64,12,76,0,inf
30227,64,13,77,0,inf
30228,50,13,63,0,inf
30229,64,8,72,0,inf
30230,62,12,74,0,inf
30231,51,8,59,0,inf
30232,50,12,62,1,8.847062245015366
30233,64,12,76,0,inf
30234,55,7,62,0,inf
30235,50,11,61,0,inf
30236,58,5,63,0,inf
30237,63,10,73,0,inf
30238,66,8,74,0,inf
30239,53,12,65,0,inf
30240,50,13,63,0,inf
30241,53,12,65,0,inf
30242,62,7,69,0,inf
30243,56,12,68,0,inf
30244,61,5,66,0,inf
30245,60,11,71,0,inf
30246,63,11,74,0,inf
30247,63,6,69,0,inf
30248,61,5,66,0,inf
30249,67,8,75,0,inf
30250,53,8,61,0,inf
30251,64,7,71,0,inf
30252,57,6,63,0,inf
30253,53,13,66,0,inf
30254,64,10,74,0,inf
30255,62,11,73,0,inf
30256,63,5,68,0,inf
30257,51,6,57,0,inf
30258,55,6,61,0,inf
30259,57,13,70,0,inf
30260,53,11,64,0,inf
30261,63,12,75,0,inf
30262,66,7,73,0,inf
30263,53,6,59,0,inf
30264,53,13,66,0,inf
30265,66,6,72,0,inf
30266,56,6,62,0,inf
30267,54,12,66,0,inf
30268,59,6,65,0,inf
30269,56,11,67,0,inf
30270,57,11,68,0,inf
30271,51,7,58,0,inf
30272,57,12,69,1,11.084799825936344
30273,59,9,68,0,inf
30274,60,10,70,0,inf
30275,55,8,63,0,inf
30276,52,13,65,0,inf
30277,64,12,76,0,inf
30278,52,7,59,0,inf
30279,57,11,68,0,inf
30280,56,7,63,0,inf
30281,57,8,65,0,inf
30282,60,5,65,0,inf
30283,63,13,76,0,inf
30284,63,9,72,0,inf
30285,52,9,61,0,inf
30286,52,7,59,0,inf
30287,62,6,68,0,inf
30288,60,6,66,0,inf
30289,58,7,65,0,inf
30290,64,9,73,0,inf
30291,64,6,70,0,inf
30292,59,7,66,0,inf
30293,55,12,67,0,inf
30294,60,10,70,0,inf
30295,56,6,62,0,inf
30296,52,5,57,0,inf
30297,61,10,71,0,inf
30298,56,10,66,0,inf
30299,55,13,68,0,inf
30300,66,11,77,0,inf
30301,67,13,80,0,inf
30302,67,6,73,0,inf
30303,65,10,75,0,inf
30304,50,5,55,0,inf
30305,67,12,79,0,inf
30306,56,6,62,0,inf
30307,54,10,64,0,inf
30308,62,8,70,1,6.2585457695956705
30309,67,8,75,0,inf
30310,53,8,61,0,inf
30311,55,12,67,0,inf
30312,55,6,61,0,inf
30313,60,11,71,0,inf
30314,53,8,61,0,inf
30315,60,10,70,0,inf
30316,64,10,74,0,inf
30317,61,12,73,0,inf
30318,51,7,58,0,inf
30319,53,13,66,1,8.490922132332102
30320,56,5,61,0,inf
30321,52,5,57,0,inf
30322,58,12,70,0,inf
30323,63,10,73,0,inf
30324,54,13,67,1,11.348644521152863
30325,59,13,72,0,inf
30326,64,10,74,0,inf
30327,63,12,75,0,inf
30328,66,6,72,0,inf
30329,62,12,74,0,inf
30330,53,6,59,0,inf
30331,54,8,62,0,inf
30332,52,11,63,0,inf
30333,65,6,71,0,inf
30334,60,6,66,0,inf
30335,52,8,60,0,inf
30336,54,12,66,0,inf
30337,57,13,70,0,inf
30338,56,8,64,0,inf
30339,54,7,61,0,inf
30340,60,8,68,0,inf
30341,52,8,60,0,inf
30342,62,13,75,0,inf
30343,55,10,65,0,inf
30344,53,5,58,0,inf
30345,60,9,69,0,inf
30346,50,9,59,0,inf
30347,59,12,71,0,inf
30348,58,12,70,0,inf
30349,66,6,72,0,inf
30350,58,12,70,0,inf
30351,52,6,58,0,inf
30352,53,10,63,0,inf
30353,63,8,71,0,inf
30354,58,9,67,0,inf
30355,55,9,64,0,inf
30356,61,6,67,0,inf
30357,54,13,67,0,inf
30358,54,13,67,0,inf
30359,52,7,59,0,inf
30360,53,6,59,0,inf
30361,67,12,79,0,inf
30362,51,7,58,0,inf
30363,67,7,74,0,inf
30364,63,10,73,0,inf
30365,59,7,66,0,inf
30366,67,8,75,1,5.112605716599518
30367,67,5,72,0,inf
30368,65,5,70,0,inf
30369,67,10,77,0,inf
30370,53,9,62,0,inf
30371,51,10,61,0,inf
30372,56,8,64,0,inf
30373,53,5,58,0,inf
30374,65,5,70,0,inf
30375,50,13,63,0,inf
30376,66,10,76,0,inf
30377,61,9,70,0,inf
30378,61,6,67,0,inf
30379,63,9,72,0,inf
30380,62,10,72,0,inf
30381,53,7,60,0,inf
30382,54,5,59,0,inf
30383,59,11,70,0,inf
30384,65,13,78,0,inf
30385,60,8,68,0,inf
30386,59,13,72,0,inf
30387,64,10,74,0,inf
30388,61,13,74,0,inf
30389,61,12,73,0,inf
30390,57,10,67,0,inf
30391,60,8,68,0,inf
30392,61,9,70,0,inf
30393,57,7,64,0,inf
30394,50,6,56,0,inf
30395,59,12,71,0,inf
30396,66,12,78,0,inf
30397,52,8,60,0,inf
30398,63,6,69,0,inf
30399,63,11,74,0,inf
30400,67,5,72,0,inf
30401,60,7,67,0,inf
30402,61,13,74,0,inf
30403,54,12,66,0,inf
30404,66,5,71,0,inf
30405,66,7,73,0,inf
30406,51,7,58,0,inf
30407,66,11,77,1,7.777582998213958
30408,64,13,77,0,inf
30409,56,8,64,0,inf
30410,58,7,65,0,inf
30411,55,6,61,0,inf
30412,55,8,63,0,inf
30413,59,13,72,1,1.5238144340316282
30414,51,13,64,0,inf
30415,50,8,58,0,inf
30416,53,12,65,0,inf
30417,63,10,73,0,inf
30418,50,5,55,0,inf
30419,65,10,75,0,inf
30420,54,7,61,0,inf
30421,64,13,77,1,3.0865796118817173
30422,54,10,64,0,inf
30423,64,8,72,0,inf
30424,62,5,67,0,inf
30425,50,13,63,0,inf
30426,54,8,62,1,0.9193885074218002
30427,55,8,63,0,inf
30428,53,10,63,0,inf
30429,56,7,63,0,inf
30430,58,13,71,0,inf
30431,66,11,77,0,inf
30432,63,6,69,0,inf
30433,51,9,60,0,inf
30434,65,13,78,0,inf
30435,50,13,63,0,inf
30436,67,6,73,0,inf
30437,65,8,73,0,inf
30438,58,7,65,0,inf
30439,67,13,80,0,inf
30440,67,12,79,0,inf
30441,67,12,79,0,inf
30442,56,8,64,0,inf
30443,52,8,60,0,inf
30444,50,9,59,0,inf
30445,56,10,66,0,inf
30446,64,13,77,0,inf
30447,50,5,55,0,inf
30448,58,6,64,0,inf
30449,53,10,63,1,7.8813393982215345
30450,63,9,72,0,inf
30451,65,8,73,0,inf
30452,62,11,73,0,inf
30453,58,7,65,0,inf
30454,62,9,71,0,inf
30455,52,11,63,1,3.886341869018537
30456,51,7,58,0,inf
30457,64,10,74,0,inf
30458,61,6,67,0,inf
30459,58,13,71,0,inf
30460,54,9,63,0,inf
30461,61,8,69,0,inf
30462,50,6,56,0,inf
30463,63,11,74,0,inf
30464,63,10,73,0,inf
30465,56,7,63,0,inf
30466,52,11,63,0,inf
30467,61,10,71,0,inf
30468,50,11,61,0,inf
30469,67,8,75,0,inf
30470,67,6,73,0,inf
30471,65,11,76,1,4.3343637584662815
30472,59,5,64,0,inf
30473,59,9,68,1,2.2521972869493965
30474,55,13,68,0,inf
30475,61,9,70,0,inf
30476,62,10,72,0,inf
30477,58,7,65,0,inf
30478,51,13,64,0,inf
30479,64,11,75,0,inf
30480,54,12,66,0,inf
30481,65,10,75,0,inf
30482,56,9,65,0,inf
30483,63,6,69,0,inf
30484,64,6,70,0,inf
30485,63,10,73,0,inf
30486,61,13,74,0,inf
30487,66,7,73,0,inf
30488,66,10,76,1,9.7974930246464
30489,58,8,66,0,inf
30490,57,7,64,0,inf
30491,67,8,75,0,inf
30492,67,5,72,1,0.629428700514751
30493,61,10,71,0,inf
30494,54,11,65,0,inf
30495,67,7,74,1,3.8252561591426257
30496,66,7,73,0,inf
30497,66,11,77,0,inf
30498,62,9,71,0,inf
30499,58,12,70,0,inf
30500,56,7,63,0,inf
30501,52,6,58,0,inf
30502,52,10,62,0,inf
30503,56,10,66,0,inf
30504,57,13,70,0,inf
30505,60,7,67,0,inf
30506,63,6,69,1,4.393947271702672
30507,57,7,64,0,inf
30508,59,8,67,0,inf
30509,56,7,63,0,inf
30510,65,7,72,0,inf
30511,54,13,67,1,6.216963297672137
30512,54,10,64,0,inf
30513,50,8,58,0,inf
30514,50,10,60,0,inf
30515,62,7,69,0,inf
30516,54,5,59,0,inf
30517,53,12,65,0,inf
30518,64,7,71,0,inf
30519,57,7,64,0,inf
30520,52,8,60,0,inf
30521,66,13,79,0,inf
30522,52,7,59,0,inf
30523,55,10,65,0,inf
30524,67,9,76,0,inf
30525,50,11,61,0,inf
30526,50,12,62,0,inf
30527,56,10,66,0,inf
30528,56,8,64,0,inf
30529,61,7,68,0,inf
30530,62,7,69,0,inf
30531,52,5,57,0,inf
30532,56,13,69,0,inf
30533,67,6,73,0,inf
30534,59,7,66,0,inf
30535,67,8,75,0,inf
30536,64,11,75,0,inf
30537,67,12,79,0,inf
30538,51,8,59,0,inf
30539,62,5,67,0,inf
30540,52,10,62,0,inf
30541,50,13,63,0,inf
30542,63,12,75,0,inf
30543,65,8,73,0,inf
30544,64,8,72,0,inf
30545,57,11,68,0,inf
30546,67,5,72,0,inf
30547,67,12,79,1,4.2114897346876745
30548,56,12,68,0,inf
30549,57,13,70,0,inf
30550,52,5,57,0,inf
30551,60,6,66,0,inf
30552,64,13,77,0,inf
30553,55,10,65,0,inf
30554,63,8,71,0,inf
30555,52,9,61,0,inf
30556,59,7,66,0,inf
30557,55,8,63,0,inf
30558,60,7,67,0,inf
30559,66,7,73,0,inf
30560,65,9,74,0,inf
30561,67,5,72,0,inf
30562,50,11,61,0,inf
30563,53,12,65,0,inf
30564,66,5,71,0,inf
30565,56,11,67,0,inf
30566,54,9,63,0,inf
30567,59,6,65,0,inf
30568,66,9,75,0,inf
30569,66,8,74,0,inf
30570,61,5,66,0,inf
30571,56,11,67,0,inf
30572,65,9,74,0,inf
30573,54,8,62,0,inf
30574,61,7,68,0,inf
30575,65,10,75,0,inf
30576,54,5,59,0,inf
30577,54,10,64,0,inf
30578,50,5,55,0,inf
30579,62,7,69,0,inf
30580,57,6,63,0,inf
30581,61,6,67,0,inf
30582,62,9,71,0,inf
30583,52,9,61,0,inf
30584,52,7,59,0,inf
30585,60,11,71,0,inf
30586,66,12,78,0,inf
30587,58,12,70,0,inf
30588,51,7,58,0,inf
30589,63,10,73,0,inf
30590,55,5,60,0,inf
30591,59,5,64,0,inf
30592,63,12,75,0,inf
30593,56,11,67,0,inf
30594,53,7,60,0,inf
30595,59,12,71,0,inf
30596,58,10,68,0,inf
30597,54,6,60,0,inf
30598,66,10,76,0,inf
30599,55,7,62,0,inf
30600,55,7,62,0,inf
30601,55,5,60,0,inf
30602,57,8,65,0,inf
30603,50,13,63,0,inf
30604,60,9,69,0,inf
30605,59,10,69,0,inf
30606,51,5,56,0,inf
30607,66,12,78,0,inf
30608,50,7,57,0,inf
30609,60,6,66,0,inf
30610,63,13,76,0,inf
30611,59,7,66,0,inf
30612,54,10,64,0,inf
30613,58,10,68,0,inf
30614,58,11,69,0,inf
30615,67,6,73,0,inf
30616,55,8,63,0,inf
30617,59,11,70,0,inf
30618,63,12,75,0,inf
30619,65,6,71,0,inf
30620,62,8,70,0,inf
30621,59,8,67,0,inf
30622,57,11,68,0,inf
30623,54,10,64,0,inf
30624,67,8,75,0,inf
30625,50,12,62,0,inf
30626,63,8,71,0,inf
30627,50,11,61,0,inf
30628,64,6,70,0,inf
30629,66,13,79,0,inf
30630,58,9,67,0,inf
30631,65,10,75,0,inf
30632,53,11,64,0,inf
30633,54,12,66,0,inf
30634,58,11,69,0,inf
30635,53,13,66,0,inf
30636,66,5,71,0,inf
30637,56,11,67,0,inf
30638,58,13,71,0,inf
30639,66,13,79,0,inf
30640,60,9,69,0,inf
30641,52,5,57,0,inf
30642,63,5,68,0,inf
30643,55,13,68,0,inf
30644,62,12,74,0,inf
30645,64,5,69,0,inf
30646,51,11,62,0,inf
30647,65,9,74,0,inf
30648,60,5,65,0,inf
30649,53,9,62,0,inf
30650,54,6,60,0,inf
30651,58,9,67,1,2.3690613309392887
30652,52,6,58,0,inf
30653,63,9,72,0,inf
30654,52,7,59,0,inf
30655,67,5,72,0,inf
30656,53,5,58,0,inf
30657,50,10,60,0,inf
30658,64,13,77,0,inf
30659,67,13,80,0,inf
30660,56,9,65,0,inf
30661,50,10,60,0,inf
30662,66,12,78,0,inf
30663,53,7,60,0,inf
30664,62,11,73,0,inf
30665,60,11,71,0,inf
30666,56,8,64,0,inf
30667,59,6,65,0,inf
30668,67,7,74,0,inf
30669,53,6,59,0,inf
30670,58,12,70,0,inf
30671,55,5,60,0,inf
30672,67,11,78,0,inf
30673,52,12,64,0,inf
30674,66,11,77,0,inf
30675,60,11,71,0,inf
30676,50,5,55,0,inf
30677,62,13,75,0,inf
30678,58,11,69,0,inf
30679,51,10,61,0,inf
30680,55,8,63,0,inf
30681,57,12,69,0,inf
30682,57,5,62,0,inf
30683,63,7,70,0,inf
30684,61,12,73,0,inf
30685,65,8,73,0,inf
30686,67,10,77,0,inf
30687,51,7,58,0,inf
30688,50,13,63,0,inf
30689,66,7,73,0,inf
30690,61,13,74,0,inf
30691,56,10,66,0,inf
30692,59,11,70,0,inf
30693,62,13,75,0,inf
30694,56,9,65,0,inf
30695,62,7,69,0,inf
30696,58,8,66,1,1.5658967588307746
30697,50,6,56,0,inf
30698,65,10,75,0,inf
30699,57,13,70,0,inf
30700,51,5,56,0,inf
30701,55,5,60,0,inf
30702,53,5,58,0,inf
30703,52,8,60,0,inf
30704,52,5,57,0,inf
30705,53,6,59,0,inf
30706,52,5,57,0,inf
30707,50,10,60,0,inf
30708,58,13,71,0,inf
30709,52,10,62,0,inf
30710,57,12,69,0,inf
30711,54,9,63,0,inf
30712,55,12,67,1,8.268252492725523
30713,66,6,72,0,inf
30714,54,7,61,0,inf
30715,60,12,72,0,inf
30716,54,12,66,0,inf
30717,59,6,65,0,inf
30718,58,8,66,0,inf
30719,55,6,61,0,inf
30720,52,8,60,1,4.264249393967795
30721,65,7,72,0,inf
30722,63,8,71,1,5.676438088990423
30723,63,5,68,0,inf
30724,65,6,71,0,inf
30725,54,6,60,0,inf
30726,50,5,55,0,inf
30727,54,8,62,0,inf
30728,64,9,73,0,inf
30729,53,9,62,0,inf
30730,52,9,61,0,inf
30731,60,12,72,0,inf
30732,50,9,59,0,inf
30733,56,6,62,0,inf
30734,65,8,73,0,inf
30735,54,12,66,0,inf
30736,51,9,60,0,inf
30737,67,5,72,0,inf
30738,50,7,57,0,inf
30739,61,7,68,0,inf
30740,55,12,67,0,inf
30741,67,8,75,0,inf
30742,63,9,72,0,inf
30743,63,5,68,0,inf
30744,62,5,67,0,inf
30745,57,5,62,0,inf
30746,66,5,71,0,inf
30747,55,7,62,0,inf
30748,62,7,69,0,inf
30749,52,10,62,0,inf
30750,52,8,60,0,inf
30751,66,12,78,0,inf
30752,55,9,64,0,inf
30753,66,12,78,0,inf
30754,62,11,73,0,inf
30755,58,10,68,0,inf
30756,53,11,64,0,inf
30757,62,12,74,1,6.347623863497674
30758,60,11,71,0,inf
30759,65,13,78,0,inf
30760,64,12,76,0,inf
30761,51,6,57,0,inf
30762,66,10,76,0,inf
30763,63,10,73,0,inf
30764,54,6,60,0,inf
30765,58,13,71,1,8.991028084071488
30766,55,8,63,0,inf
30767,50,11,61,0,inf
30768,57,8,65,0,inf
30769,56,9,65,0,inf
30770,60,8,68,0,inf
30771,53,13,66,0,inf
30772,65,12,77,0,inf
30773,66,7,73,0,inf
30774,63,10,73,0,inf
30775,56,9,65,0,inf
30776,56,11,67,0,inf
30777,67,12,79,0,inf
30778,50,6,56,0,inf
30779,54,11,65,0,inf
30780,65,9,74,0,inf
30781,50,6,56,0,inf
30782,62,8,70,0,inf
30783,55,9,64,0,inf
30784,60,13,73,0,inf
30785,60,9,69,0,inf
30786,67,13,80,0,inf
30787,66,11,77,0,inf
30788,62,6,68,0,inf
30789,61,13,74,0,inf
30790,53,7,60,0,inf
30791,54,6,60,0,inf
30792,64,6,70,0,inf
30793,61,8,69,0,inf
30794,53,13,66,0,inf
30795,54,9,63,0,inf
30796,61,6,67,0,inf
30797,53,5,58,0,inf
30798,67,7,74,0,inf
30799,50,11,61,0,inf
30800,55,11,66,0,inf
30801,57,10,67,0,inf
30802,62,13,75,0,inf
30803,55,11,66,0,inf
30804,64,13,77,0,inf
30805,55,5,60,0,inf
30806,60,9,69,0,inf
30807,53,11,64,0,inf
30808,57,7,64,0,inf
30809,62,5,67,0,inf
30810,65,9,74,0,inf
30811,51,8,59,0,inf
30812,62,7,69,0,inf
30813,59,7,66,0,inf
30814,58,8,66,0,inf
30815,62,11,73,0,inf
30816,50,6,56,0,inf
30817,67,11,78,0,inf
30818,57,12,69,0,inf
30819,67,9,76,0,inf
30820,55,7,62,0,inf
30821,55,8,63,0,inf
30822,63,8,71,0,inf
30823,64,11,75,0,inf
30824,50,7,57,0,inf
30825,63,13,76,0,inf
30826,54,6,60,0,inf
30827,53,9,62,0,inf
30828,64,7,71,0,inf
30829,61,8,69,0,inf
30830,55,13,68,0,inf
30831,50,7,57,0,inf
30832,58,11,69,1,0.9086208950448196
30833,63,13,76,0,inf
30834,65,6,71,0,inf
30835,54,6,60,0,inf
30836,59,5,64,0,inf
30837,57,12,69,0,inf
30838,54,13,67,0,inf
30839,51,10,61,0,inf
30840,67,11,78,0,inf
30841,62,10,72,0,inf
30842,59,8,67,0,inf
30843,55,13,68,0,inf
30844,65,7,72,0,inf
30845,53,5,58,0,inf
30846,66,8,74,0,inf
30847,53,12,65,0,inf
30848,60,6,66,0,inf
30849,50,12,62,0,inf
30850,55,9,64,0,inf
30851,54,9,63,0,inf
30852,51,6,57,0,inf
30853,63,5,68,0,inf
30854,65,12,77,0,inf
30855,67,5,72,0,inf
30856,62,6,68,0,inf
30857,65,5,70,0,inf
30858,54,9,63,0,inf
30859,67,8,75,0,inf
30860,54,8,62,0,inf
30861,59,7,66,0,inf
30862,55,9,64,0,inf
30863,67,7,74,0,inf
30864,58,7,65,0,inf
30865,59,5,64,0,inf
30866,53,11,64,0,inf
30867,62,7,69,0,inf
30868,55,7,62,0,inf
30869,57,13,70,0,inf
30870,53,13,66,0,inf
30871,65,11,76,0,inf
30872,64,12,76,0,inf
30873,53,10,63,0,inf
30874,63,5,68,0,inf
30875,66,9,75,0,inf
30876,56,9,65,0,inf
30877,51,7,58,0,inf
30878,62,11,73,0,inf
30879,61,5,66,0,inf
30880,65,11,76,0,inf
30881,61,9,70,1,8.286329730616927
30882,51,13,64,0,inf
30883,65,13,78,0,inf
30884,66,5,71,0,inf
30885,61,10,71,0,inf
30886,55,11,66,0,inf
30887,62,12,74,0,inf
30888,58,13,71,1,8.16575383482315
30889,61,10,71,0,inf
30890,58,12,70,1,7.2419145183871905
30891,57,13,70,0,inf
30892,60,10,70,0,inf
30893,60,7,67,0,inf
30894,67,6,73,0,inf
30895,64,13,77,0,inf
30896,56,10,66,0,inf
30897,60,8,68,0,inf
30898,61,8,69,0,inf
30899,62,5,67,0,inf
30900,51,12,63,0,inf
30901,59,9,68,0,inf
30902,56,5,61,0,inf
30903,50,12,62,0,inf
30904,53,8,61,0,inf
30905,52,6,58,0,inf
30906,64,12,76,0,inf
30907,50,9,59,0,inf
30908,51,11,62,0,inf
30909,59,6,65,0,inf
30910,52,9,61,0,inf
30911,59,10,69,0,inf
30912,52,11,63,0,inf
30913,61,13,74,0,inf
30914,54,8,62,0,inf
30915,52,6,58,0,inf
30916,55,13,68,0,inf
30917,57,13,70,0,inf
30918,67,9,76,1,7.570697983410668
30919,55,11,66,0,inf
30920,54,11,65,0,inf
30921,60,7,67,0,inf
30922,54,7,61,0,inf
30923,50,11,61,0,inf
30924,66,12,78,0,inf
30925,61,9,70,0,inf
30926,65,9,74,0,inf
30927,65,13,78,0,inf
30928,51,9,60,0,inf
30929,57,10,67,0,inf
30930,60,6,66,0,inf
30931,54,12,66,0,inf
30932,59,8,67,0,inf
30933,52,7,59,0,inf
30934,57,11,68,0,inf
30935,55,6,61,0,inf
30936,50,10,60,0,inf
30937,62,11,73,0,inf
30938,67,5,72,0,inf
30939,52,8,60,0,inf
30940,66,11,77,0,inf
30941,59,8,67,0,inf
30942,60,13,73,0,inf
30943,56,13,69,0,inf
30944,56,7,63,0,inf
30945,55,6,61,0,inf
30946,66,10,76,0,inf
30947,59,12,71,0,inf
30948,53,13,66,0,inf
30949,64,5,69,0,inf
30950,52,5,57,0,inf
30951,50,13,63,0,inf
30952,50,5,55,0,inf
30953,53,10,63,0,inf
30954,50,11,61,0,inf
30955,62,5,67,0,inf
30956,59,10,69,0,inf
30957,57,9,66,0,inf
30958,58,9,67,0,inf
30959,61,10,71,0,inf
30960,62,5,67,0,inf
30961,67,6,73,0,inf
30962,54,11,65,0,inf
30963,59,13,72,0,inf
30964,56,5,61,0,inf
30965,57,6,63,0,inf
30966,51,8,59,0,inf
30967,59,8,67,0,inf
30968,56,10,66,0,inf
30969,50,8,58,0,inf
30970,59,13,72,0,inf
30971,66,7,73,0,inf
30972,62,10,72,0,inf
30973,50,8,58,0,inf
30974,65,10,75,0,inf
30975,64,12,76,0,inf
30976,50,12,62,0,inf
30977,66,9,75,0,inf
30978,62,6,68,0,inf
30979,55,9,64,0,inf
30980,67,7,74,0,inf
30981,61,5,66,0,inf
30982,61,12,73,0,inf
30983,57,7,64,0,inf
30984,54,8,62,0,inf
30985,54,11,65,0,inf
30986,60,5,65,0,inf
30987,55,10,65,0,inf
30988,51,9,60,0,inf
30989,61,8,69,0,inf
30990,54,13,67,0,inf
30991,61,7,68,0,inf
30992,51,6,57,0,inf
30993,50,7,57,0,inf
30994,50,7,57,0,inf
30995,65,8,73,0,inf
30996,67,5,72,0,inf
30997,59,12,71,0,inf
30998,57,7,64,0,inf
30999,60,5,65,0,inf
31000,67,8,75,0,inf
31001,51,8,59,0,inf
31002,54,11,65,0,inf
31003,60,11,71,0,inf
31004,50,7,57,0,inf
31005,50,5,55,0,inf
31006,64,13,77,0,inf
31007,59,6,65,0,inf
31008,67,9,76,0,inf
31009,59,13,72,0,inf
31010,50,12,62,0,inf
31011,53,11,64,0,inf
31012,59,11,70,0,inf
31013,66,5,71,0,inf
31014,50,7,57,0,inf
31015,60,8,68,0,inf
31016,58,13,71,0,inf
31017,52,11,63,0,inf
31018,58,10,68,0,inf
31019,52,11,63,0,inf
31020,58,7,65,0,inf
31021,56,11,67,0,inf
31022,66,7,73,0,inf
31023,67,11,78,0,inf
31024,57,10,67,0,inf
31025,54,8,62,0,inf
31026,57,13,70,0,inf
31027,61,10,71,0,inf
31028,67,10,77,0,inf
31029,52,6,58,1,1.9221329403506147
31030,61,8,69,0,inf
31031,54,7,61,0,inf
31032,67,12,79,0,inf
31033,66,13,79,0,inf
31034,60,5,65,0,inf
31035,61,9,70,0,inf
31036,59,6,65,0,inf
31037,65,6,71,0,inf
31038,53,12,65,0,inf
31039,62,10,72,0,inf
31040,53,13,66,0,inf
31041,58,5,63,0,inf
31042,67,9,76,0,inf
31043,61,7,68,0,inf
31044,67,12,79,0,inf
31045,67,7,74,0,inf
31046,58,8,66,0,inf
31047,67,10,77,0,inf
31048,63,12,75,1,3.6031942615150427
31049,61,10,71,0,inf
31050,56,7,63,0,inf
31051,53,13,66,0,inf
31052,61,9,70,0,inf
31053,51,9,60,0,inf
31054,58,13,71,0,inf
31055,54,5,59,0,inf
31056,62,8,70,0,inf
31057,63,12,75,0,inf
31058,50,9,59,0,inf
31059,64,12,76,0,inf
31060,55,13,68,0,inf
31061,57,10,67,0,inf
31062,66,5,71,0,inf
31063,65,9,74,0,inf
31064,54,13,67,0,inf
31065,50,12,62,0,inf
31066,50,13,63,0,inf
31067,67,7,74,0,inf
31068,60,10,70,0,inf
31069,55,6,61,0,inf
31070,63,5,68,0,inf
31071,66,12,78,0,inf
31072,52,7,59,0,inf
31073,58,13,71,0,inf
31074,50,6,56,0,inf
31075,57,7,64,0,inf
31076,57,12,69,0,inf
31077,53,11,64,0,inf
31078,55,8,63,0,inf
31079,65,11,76,0,inf
31080,67,7,74,0,inf
31081,65,5,70,0,inf
31082,67,12,79,0,inf
31083,61,9,70,0,inf
31084,67,5,72,0,inf
31085,52,12,64,0,inf
31086,63,6,69,0,inf
31087,64,6,70,0,inf
31088,55,6,61,0,inf
31089,57,10,67,0,inf
31090,62,8,70,0,inf
31091,58,7,65,0,inf
31092,61,10,71,0,inf
31093,59,7,66,0,inf
31094,55,8,63,0,inf
31095,61,9,70,0,inf
31096,55,6,61,0,inf
31097,51,10,61,0,inf
31098,64,13,77,0,inf
31099,53,5,58,0,inf
31100,51,11,62,0,inf
31101,64,13,77,0,inf
31102,64,5,69,0,inf
31103,63,11,74,0,inf
31104,54,8,62,0,inf
31105,58,10,68,0,inf
31106,53,12,65,0,inf
31107,51,8,59,0,inf
31108,56,13,69,0,inf
31109,53,8,61,0,inf
31110,57,13,70,0,inf
31111,57,13,70,0,inf
31112,61,7,68,0,inf
31113,54,13,67,0,inf
31114,53,9,62,0,inf
31115,50,13,63,0,inf
31116,64,9,73,0,inf
31117,60,8,68,0,inf
31118,65,10,75,0,inf
31119,62,13,75,0,inf
31120,63,10,73,0,inf
31121,54,7,61,0,inf
31122,65,11,76,0,inf
31123,54,8,62,0,inf
31124,66,10,76,0,inf
31125,55,11,66,0,inf
31126,53,10,63,0,inf
31127,58,12,70,0,inf
31128,59,5,64,0,inf
31129,64,12,76,0,inf
31130,62,8,70,0,inf
31131,55,9,64,0,inf
31132,60,9,69,0,inf
31133,60,6,66,0,inf
31134,65,7,72,0,inf
31135,57,10,67,0,inf
31136,52,5,57,0,inf
31137,51,12,63,0,inf
31138,52,6,58,0,inf
31139,62,11,73,0,inf
31140,65,13,78,0,inf
31141,53,5,58,0,inf
31142,50,11,61,0,inf
31143,52,13,65,0,inf
31144,62,8,70,0,inf
31145,54,9,63,0,inf
31146,61,6,67,0,inf
31147,59,6,65,0,inf
31148,60,12,72,0,inf
31149,51,9,60,0,inf
31150,52,10,62,0,inf
31151,67,6,73,0,inf
31152,54,9,63,0,inf
31153,59,12,71,0,inf
31154,63,9,72,0,inf
31155,59,12,71,0,inf
31156,50,8,58,0,inf
31157,50,12,62,0,inf
31158,59,6,65,0,inf
31159,62,13,75,0,inf
31160,58,10,68,1,3.1810853137641004
31161,50,9,59,0,inf
31162,60,10,70,0,inf
31163,54,6,60,0,inf
31164,58,10,68,0,inf
31165,55,5,60,0,inf
31166,62,5,67,0,inf
31167,51,5,56,0,inf
31168,60,5,65,0,inf
31169,67,6,73,0,inf
31170,64,13,77,0,inf
31171,59,10,69,0,inf
31172,58,12,70,0,inf
31173,66,8,74,0,inf
31174,54,7,61,0,inf
31175,52,10,62,0,inf
31176,51,6,57,0,inf
31177,67,13,80,0,inf
31178,64,5,69,0,inf
31179,54,13,67,0,inf
31180,61,10,71,0,inf
31181,63,7,70,1,0.43043825572514294
31182,67,12,79,0,inf
31183,58,11,69,0,inf
31184,59,8,67,0,inf
31185,64,6,70,0,inf
31186,53,7,60,0,inf
31187,60,13,73,1,5.615663132753355
31188,55,13,68,0,inf
31189,52,9,61,0,inf
31190,67,10,77,0,inf
31191,67,13,80,0,inf
31192,56,7,63,0,inf
31193,58,10,68,0,inf
31194,61,9,70,0,inf
31195,57,7,64,0,inf
31196,51,11,62,0,inf
31197,60,9,69,0,inf
31198,57,9,66,0,inf
31199,65,7,72,0,inf
31200,57,5,62,0,inf
31201,53,9,62,0,inf
31202,54,12,66,0,inf
31203,55,13,68,0,inf
31204,65,11,76,0,inf
31205,52,9,61,0,inf
31206,65,5,70,0,inf
31207,58,5,63,0,inf
31208,55,6,61,0,inf
31209,58,12,70,1,10.162191163625153
31210,57,6,63,0,inf
31211,64,12,76,0,inf
31212,61,10,71,0,inf
31213,63,12,75,0,inf
31214,65,6,71,0,inf
31215,51,12,63,0,inf
31216,61,8,69,0,inf
31217,56,9,65,0,inf
31218,61,13,74,0,inf
31219,50,13,63,0,inf
31220,67,8,75,0,inf
31221,63,10,73,0,inf
31222,66,9,75,0,inf
31223,58,5,63,0,inf
31224,53,7,60,0,inf
31225,58,10,68,0,inf
31226,54,7,61,0,inf
31227,65,10,75,0,inf
31228,51,9,60,0,inf
31229,53,13,66,0,inf
31230,59,8,67,0,inf
31231,50,12,62,0,inf
31232,53,5,58,0,inf
31233,63,8,71,0,inf
31234,67,6,73,0,inf
31235,51,12,63,0,inf
31236,61,12,73,0,inf
31237,55,13,68,0,inf
31238,53,13,66,0,inf
31239,63,11,74,0,inf
31240,52,6,58,0,inf
31241,65,13,78,0,inf
31242,60,9,69,0,inf
31243,60,11,71,0,inf
31244,56,8,64,0,inf
31245,58,5,63,0,inf
31246,54,12,66,0,inf
31247,51,8,59,0,inf
31248,65,7,72,0,inf
31249,51,12,63,0,inf
31250,66,6,72,0,inf
31251,63,8,71,0,inf
31252,51,9,60,0,inf
31253,56,5,61,0,inf
31254,65,6,71,0,inf
31255,60,7,67,0,inf
31256,50,9,59,0,inf
31257,50,6,56,0,inf
31258,67,8,75,0,inf
31259,52,10,62,0,inf
31260,50,12,62,0,inf
31261,67,7,74,0,inf
31262,66,6,72,0,inf
31263,55,11,66,0,inf
31264,63,7,70,0,inf
31265,65,10,75,0,inf
31266,58,7,65,0,inf
31267,52,10,62,0,inf
31268,62,12,74,0,inf
31269,54,11,65,0,inf
31270,64,8,72,0,inf
31271,67,6,73,0,inf
31272,54,9,63,0,inf
31273,57,9,66,0,inf
31274,65,5,70,0,inf
31275,64,6,70,0,inf
31276,57,11,68,0,inf
31277,52,9,61,0,inf
31278,59,12,71,0,inf
31279,65,11,76,0,inf
31280,50,8,58,0,inf
31281,53,10,63,0,inf
31282,57,13,70,0,inf
31283,65,5,70,0,inf
31284,67,5,72,0,inf
31285,57,10,67,0,inf
31286,60,10,70,0,inf
31287,53,11,64,0,inf
31288,55,11,66,0,inf
31289,57,7,64,0,inf
31290,64,6,70,0,inf
31291,64,9,73,0,inf
31292,60,9,69,0,inf
31293,53,10,63,0,inf
31294,51,10,61,0,inf
31295,52,10,62,0,inf
31296,64,5,69,0,inf
31297,51,8,59,0,inf
31298,53,11,64,0,inf
31299,51,12,63,0,inf
31300,64,5,69,0,inf
31301,57,11,68,0,inf
31302,58,7,65,0,inf
31303,66,13,79,0,inf
31304,62,12,74,0,inf
31305,50,11,61,0,inf
31306,57,6,63,0,inf
31307,65,9,74,0,inf
31308,61,7,68,0,inf
31309,52,5,57,0,inf
31310,55,6,61,0,inf
31311,55,7,62,0,inf
31312,61,9,70,0,inf
31313,67,8,75,0,inf
31314,64,5,69,0,inf
31315,57,10,67,0,inf
31316,63,11,74,0,inf
31317,60,6,66,0,inf
31318,61,5,66,0,inf
31319,51,11,62,0,inf
31320,56,11,67,0,inf
31321,64,5,69,0,inf
31322,60,5,65,0,inf
31323,57,12,69,0,inf
31324,51,10,61,0,inf
31325,59,6,65,0,inf
31326,66,13,79,0,inf
31327,63,7,70,0,inf
31328,66,12,78,0,inf
31329,52,8,60,0,inf
31330,56,8,64,0,inf
31331,55,12,67,0,inf
31332,63,12,75,0,inf
31333,59,12,71,0,inf
31334,51,13,64,0,inf
31335,55,6,61,0,inf
31336,54,13,67,0,inf
31337,61,12,73,0,inf
31338,58,10,68,0,inf
31339,55,9,64,0,inf
31340,50,7,57,0,inf
31341,66,5,71,0,inf
31342,64,13,77,0,inf
31343,59,8,67,0,inf
31344,65,7,72,0,inf
31345,61,7,68,0,inf
31346,52,6,58,0,inf
31347,65,13,78,0,inf
31348,59,7,66,0,inf
31349,52,8,60,0,inf
31350,63,13,76,0,inf
31351,56,7,63,0,inf
31352,57,5,62,0,inf
31353,51,10,61,0,inf
31354,59,5,64,0,inf
31355,58,6,64,0,inf
31356,50,7,57,0,inf
31357,61,9,70,0,inf
31358,62,10,72,0,inf
31359,66,12,78,0,inf
31360,62,6,68,0,inf
31361,64,13,77,0,inf
31362,63,7,70,0,inf
31363,56,9,65,0,inf
31364,51,9,60,0,inf
31365,55,13,68,0,inf
31366,61,5,66,0,inf
31367,54,7,61,0,inf
31368,67,9,76,0,inf
31369,66,5,71,0,inf
31370,51,6,57,0,inf
31371,50,8,58,0,inf
31372,67,13,80,0,inf
31373,65,13,78,0,inf
31374,66,7,73,0,inf
31375,62,13,75,0,inf
31376,61,8,69,0,inf
31377,60,13,73,0,inf
31378,56,9,65,0,inf
31379,57,13,70,0,inf
31380,64,11,75,0,inf
31381,57,10,67,0,inf
31382,55,13,68,0,inf
31383,61,11,72,0,inf
31384,53,6,59,0,inf
31385,64,9,73,0,inf
31386,58,6,64,0,inf
31387,60,7,67,0,inf
31388,65,5,70,0,inf
31389,53,8,61,0,inf
31390,54,9,63,0,inf
31391,53,8,61,0,inf
31392,65,6,71,0,inf
31393,53,5,58,0,inf
31394,53,10,63,0,inf
31395,55,8,63,0,inf
31396,51,8,59,0,inf
31397,55,8,63,0,inf
31398,58,7,65,0,inf
31399,55,5,60,1,3.6918844416691172
31400,57,9,66,0,inf
31401,54,12,66,0,inf
31402,64,11,75,0,inf
31403,63,13,76,0,inf
31404,58,6,64,0,inf
31405,52,6,58,0,inf
31406,55,12,67,0,inf
31407,53,7,60,0,inf
31408,61,6,67,0,inf
31409,50,9,59,0,inf
31410,63,5,68,0,inf
31411,61,6,67,0,inf
31412,61,12,73,0,inf
31413,60,11,71,0,inf
31414,66,13,79,0,inf
31415,55,12,67,0,inf
31416,64,12,76,0,inf
31417,57,7,64,0,inf
31418,50,5,55,1,2.6082960916348625
31419,58,9,67,0,inf
31420,64,13,77,0,inf
31421,53,10,63,0,inf
31422,51,8,59,0,inf
31423,63,11,74,0,inf
31424,62,10,72,0,inf
31425,53,11,64,0,inf
31426,56,6,62,0,inf
31427,50,8,58,0,inf
31428,56,13,69,0,inf
31429,50,7,57,0,inf
31430,65,13,78,0,inf
31431,62,6,68,0,inf
31432,54,12,66,0,inf
31433,58,9,67,0,inf
31434,56,11,67,0,inf
31435,61,13,74,0,inf
31436,64,12,76,0,inf
31437,50,6,56,0,inf
31438,64,9,73,0,inf
31439,61,10,71,0,inf
31440,66,8,74,0,inf
31441,50,11,61,0,inf
31442,58,6,64,0,inf
31443,63,11,74,0,inf
31444,50,10,60,1,3.3254193152998326
31445,66,10,76,0,inf
31446,67,9,76,0,inf
31447,63,5,68,0,inf
31448,59,13,72,0,inf
31449,51,7,58,0,inf
31450,63,11,74,1,8.377294256503973
31451,51,6,57,0,inf
31452,64,6,70,0,inf
31453,57,11,68,0,inf
31454,67,11,78,0,inf
31455,55,9,64,0,inf
31456,58,9,67,0,inf
31457,63,7,70,0,inf
31458,64,12,76,0,inf
31459,61,10,71,0,inf
31460,62,11,73,0,inf
31461,57,6,63,0,inf
31462,60,8,68,0,inf
31463,65,13,78,0,inf
31464,63,8,71,0,inf
31465,55,11,66,0,inf
31466,61,9,70,1,0.23851849921892665
31467,59,12,71,0,inf
31468,64,5,69,0,inf
31469,60,8,68,0,inf
31470,67,8,75,0,inf
31471,56,8,64,0,inf
31472,67,6,73,0,inf
31473,57,11,68,0,inf
31474,58,10,68,0,inf
31475,55,8,63,0,inf
31476,66,5,71,0,inf
31477,52,11,63,0,inf
31478,63,10,73,0,inf
31479,67,12,79,0,inf
31480,66,8,74,0,inf
31481,67,5,72,0,inf
31482,50,6,56,0,inf
31483,55,6,61,0,inf
31484,57,8,65,0,inf
31485,63,12,75,0,inf
31486,52,7,59,0,inf
31487,56,9,65,0,inf
31488,55,8,63,0,inf
31489,66,6,72,0,inf
31490,62,9,71,0,inf
31491,54,9,63,0,inf
31492,51,7,58,0,inf
31493,66,12,78,0,inf
31494,54,7,61,0,inf
31495,66,12,78,0,inf
31496,67,11,78,0,inf
31497,54,8,62,0,inf
31498,51,7,58,0,inf
31499,54,5,59,0,inf
31500,61,10,71,0,inf
31501,53,6,59,0,inf
31502,63,6,69,0,inf
31503,64,11,75,0,inf
31504,63,6,69,0,inf
31505,52,5,57,0,inf
31506,66,8,74,0,inf
31507,59,13,72,0,inf
31508,64,10,74,0,inf
31509,61,8,69,0,inf
31510,51,10,61,0,inf
31511,66,7,73,0,inf
31512,58,7,65,0,inf
31513,59,13,72,0,inf
31514,65,5,70,0,inf
31515,57,11,68,0,inf
31516,65,12,77,0,inf
31517,65,12,77,0,inf
31518,51,9,60,0,inf
31519,54,11,65,0,inf
31520,62,7,69,0,inf
31521,63,12,75,0,inf
31522,58,9,67,1,8.843579179871028
31523,65,5,70,0,inf
31524,61,10,71,0,inf
31525,57,11,68,0,inf
31526,66,8,74,0,inf
31527,61,5,66,0,inf
31528,59,11,70,0,inf
31529,67,13,80,0,inf
31530,53,6,59,1,0.16025931776527358
31531,51,7,58,0,inf
31532,56,5,61,0,inf
31533,51,7,58,0,inf
31534,53,13,66,0,inf
31535,64,11,75,0,inf
31536,54,9,63,0,inf
31537,65,13,78,0,inf
31538,66,5,71,0,inf
31539,57,5,62,0,inf
31540,52,7,59,0,inf
31541,56,10,66,0,inf
31542,54,5,59,0,inf
31543,59,10,69,0,inf
31544,58,13,71,1,10.626626960312578
31545,64,13,77,0,inf
31546,63,12,75,0,inf
31547,55,6,61,0,inf
31548,60,10,70,0,inf
31549,51,11,62,0,inf
31550,53,13,66,0,inf
31551,60,5,65,0,inf
31552,66,10,76,0,inf
31553,56,9,65,0,inf
31554,51,10,61,0,inf
31555,64,8,72,0,inf
31556,65,5,70,0,inf
31557,51,9,60,0,inf
31558,50,13,63,0,inf
31559,53,10,63,0,inf
31560,56,6,62,0,inf
31561,67,6,73,0,inf
31562,65,5,70,0,inf
31563,57,9,66,0,inf
31564,59,9,68,0,inf
31565,59,13,72,0,inf
31566,52,10,62,0,inf
31567,62,11,73,0,inf
31568,63,5,68,0,inf
31569,54,6,60,0,inf
31570,65,6,71,0,inf
31571,57,8,65,0,inf
31572,64,10,74,0,inf
31573,57,6,63,0,inf
31574,54,8,62,0,inf
31575,51,7,58,1,2.358273860576759
31576,66,11,77,0,inf
31577,66,5,71,0,inf
31578,64,10,74,0,inf
31579,55,9,64,0,inf
31580,54,9,63,0,inf
31581,66,8,74,0,inf
31582,67,9,76,0,inf
31583,55,10,65,1,4.625257651565725
31584,60,5,65,0,inf
31585,64,6,70,0,inf
31586,62,9,71,0,inf
31587,65,12,77,0,inf
31588,58,9,67,0,inf
31589,56,7,63,0,inf
31590,61,7,68,0,inf
31591,53,8,61,0,inf
31592,60,11,71,0,inf
31593,50,7,57,0,inf
31594,65,11,76,0,inf
31595,63,11,74,0,inf
31596,57,12,69,0,inf
31597,54,12,66,0,inf
31598,55,7,62,0,inf
31599,50,5,55,0,inf
31600,66,5,71,0,inf
31601,61,10,71,0,inf
31602,60,5,65,0,inf
31603,50,10,60,0,inf
31604,51,7,58,0,inf
31605,54,10,64,0,inf
31606,56,13,69,0,inf
31607,64,7,71,0,inf
31608,62,9,71,0,inf
31609,50,13,63,0,inf
31610,67,13,80,0,inf
31611,52,8,60,0,inf
31612,51,5,56,0,inf
31613,60,11,71,0,inf
31614,65,8,73,0,inf
31615,54,8,62,0,inf
31616,63,9,72,0,inf
31617,63,12,75,0,inf
31618,50,5,55,0,inf
31619,60,13,73,0,inf
31620,61,13,74,0,inf
31621,52,7,59,0,inf
31622,60,11,71,0,inf
31623,61,11,72,0,inf
31624,67,13,80,0,inf
31625,52,9,61,0,inf
31626,65,8,73,0,inf
31627,52,7,59,0,inf
31628,57,11,68,0,inf
31629,62,11,73,0,inf
31630,62,6,68,0,inf
31631,54,7,61,0,inf
31632,67,10,77,0,inf
31633,53,8,61,0,inf
31634,62,10,72,0,inf
31635,64,7,71,0,inf
31636,53,12,65,0,inf
31637,67,8,75,0,inf
31638,54,12,66,0,inf
31639,61,12,73,0,inf
31640,63,10,73,0,inf
31641,56,8,64,0,inf
31642,59,6,65,1,0.9095325014408289
31643,66,9,75,0,inf
31644,65,11,76,0,inf
31645,58,8,66,0,inf
31646,52,13,65,0,inf
31647,61,13,74,0,inf
31648,58,10,68,0,inf
31649,56,12,68,0,inf
31650,61,10,71,0,inf
31651,55,5,60,0,inf
31652,56,5,61,0,inf
31653,51,6,57,0,inf
31654,59,5,64,0,inf
31655,63,9,72,0,inf
31656,52,7,59,0,inf
31657,56,9,65,0,inf
31658,51,13,64,0,inf
31659,65,6,71,0,inf
31660,58,5,63,0,inf
31661,65,11,76,0,inf
31662,52,8,60,0,inf
31663,52,5,57,0,inf
31664,63,5,68,0,inf
31665,60,12,72,0,inf
31666,57,11,68,0,inf
31667,58,11,69,0,inf
31668,61,9,70,0,inf
31669,52,9,61,0,inf
31670,61,7,68,0,inf
31671,54,9,63,0,inf
31672,56,11,67,0,inf
31673,62,12,74,0,inf
31674,62,7,69,0,inf
31675,66,10,76,0,inf
31676,60,11,71,0,inf
31677,62,5,67,0,inf
31678,62,8,70,0,inf
31679,67,8,75,0,inf
31680,54,7,61,0,inf
31681,60,6,66,0,inf
31682,62,10,72,0,inf
31683,63,10,73,0,inf
31684,50,9,59,0,inf
31685,55,7,62,0,inf
31686,54,13,67,0,inf
31687,57,12,69,0,inf
31688,50,13,63,0,inf
31689,54,13,67,0,inf
31690,54,10,64,0,inf
31691,59,7,66,0,inf
31692,58,7,65,0,inf
31693,52,6,58,0,inf
31694,52,7,59,0,inf
31695,67,10,77,0,inf
31696,56,5,61,0,inf
31697,59,10,69,0,inf
31698,66,11,77,0,inf
31699,50,8,58,0,inf
31700,58,12,70,1,6.600994769818186
31701,57,7,64,0,inf
31702,67,6,73,0,inf
31703,51,11,62,0,inf
31704,62,5,67,0,inf
31705,52,5,57,0,inf
31706,61,5,66,0,inf
31707,63,7,70,0,inf
31708,57,13,70,0,inf
31709,66,7,73,0,inf
31710,55,8,63,0,inf
31711,59,9,68,0,inf
31712,64,9,73,0,inf
31713,54,8,62,0,inf
31714,57,7,64,0,inf
31715,50,8,58,0,inf
31716,59,9,68,0,inf
31717,56,7,63,0,inf
31718,50,5,55,0,inf
31719,55,11,66,0,inf
31720,55,12,67,0,inf
31721,55,7,62,0,inf
31722,50,13,63,0,inf
31723,58,8,66,0,inf
31724,57,5,62,0,inf
31725,62,12,74,0,inf
31726,57,6,63,0,inf
31727,57,10,67,0,inf
31728,64,9,73,1,4.44014473292296
31729,53,6,59,0,inf
31730,65,8,73,0,inf
31731,55,13,68,0,inf
31732,61,10,71,0,inf
31733,64,13,77,0,inf
31734,58,10,68,0,inf
31735,66,11,77,0,inf
31736,66,13,79,0,inf
31737,55,12,67,0,inf
31738,56,11,67,0,inf
31739,61,5,66,0,inf
31740,67,8,75,0,inf
31741,61,8,69,0,inf
31742,57,9,66,0,inf
31743,56,5,61,0,inf
31744,66,6,72,0,inf
31745,52,7,59,0,inf
31746,58,13,71,0,inf
31747,50,8,58,0,inf
31748,63,12,75,0,inf
31749,52,13,65,0,inf
31750,56,9,65,0,inf
31751,51,6,57,0,inf
31752,67,6,73,0,inf
31753,66,6,72,0,inf
31754,61,13,74,0,inf
31755,66,8,74,0,inf
31756,62,7,69,0,inf
31757,61,5,66,0,inf
31758,55,13,68,0,inf
31759,60,9,69,1,6.864682355494111
31760,50,12,62,1,11.321514128374908
31761,61,9,70,0,inf
31762,64,12,76,0,inf
31763,63,12,75,0,inf
31764,57,5,62,1,3.8668957823754866
31765,60,11,71,0,inf
31766,61,9,70,0,inf
31767,62,7,69,0,inf
31768,67,11,78,0,inf
31769,60,12,72,0,inf
31770,51,7,58,0,inf
31771,60,10,70,0,inf
31772,67,11,78,0,inf
31773,66,10,76,0,inf
31774,57,9,66,0,inf
31775,59,8,67,0,inf
31776,64,13,77,0,inf
31777,54,12,66,0,inf
31778,67,6,73,0,inf
31779,53,6,59,0,inf
31780,52,6,58,0,inf
31781,64,10,74,0,inf
31782,65,9,74,0,inf
31783,62,10,72,0,inf
31784,62,12,74,0,inf
31785,53,5,58,0,inf
31786,55,13,68,0,inf
31787,56,11,67,0,inf
31788,67,10,77,0,inf
31789,52,7,59,0,inf
31790,66,13,79,0,inf
31791,61,5,66,0,inf
31792,57,7,64,0,inf
31793,63,8,71,0,inf
31794,52,13,65,0,inf
31795,67,5,72,0,inf
31796,63,7,70,0,inf
31797,63,10,73,0,inf
31798,59,12,71,0,inf
31799,64,11,75,0,inf
31800,66,8,74,0,inf
31801,61,9,70,0,inf
31802,50,7,57,0,inf
31803,52,10,62,0,inf
31804,51,13,64,0,inf
31805,61,7,68,0,inf
31806,59,7,66,0,inf
31807,50,11,61,1,2.144459504079343
31808,63,11,74,0,inf
31809,57,10,67,0,inf
31810,65,8,73,0,inf
31811,66,6,72,0,inf
31812,51,6,57,0,inf
31813,52,7,59,0,inf
31814,56,12,68,0,inf
31815,54,8,62,0,inf
31816,57,10,67,0,inf
31817,54,8,62,0,inf
31818,55,13,68,0,inf
31819,57,11,68,0,inf
31820,66,13,79,0,inf
31821,65,9,74,0,inf
31822,56,11,67,0,inf
31823,54,9,63,0,inf
31824,63,11,74,0,inf
31825,54,11,65,0,inf
31826,50,12,62,1,4.279735865951793
31827,51,7,58,0,inf
31828,53,13,66,0,inf
31829,63,9,72,0,inf
31830,63,6,69,0,inf
31831,65,9,74,0,inf
31832,63,11,74,0,inf
31833,66,10,76,0,inf
31834,66,7,73,0,inf
31835,56,8,64,0,inf
31836,62,8,70,0,inf
31837,55,7,62,0,inf
31838,54,6,60,0,inf
31839,64,7,71,0,inf
31840,58,11,69,0,inf
31841,64,9,73,1,2.850298380618071
31842,53,13,66,0,inf
31843,57,7,64,0,inf
31844,62,13,75,0,inf
31845,55,8,63,0,inf
31846,58,9,67,0,inf
31847,63,5,68,0,inf
31848,52,6,58,0,inf
31849,50,9,59,0,inf
31850,55,10,65,0,inf
31851,55,6,61,0,inf
31852,67,10,77,0,inf
31853,58,8,66,0,inf
31854,62,9,71,0,inf
31855,59,5,64,0,inf
31856,55,9,64,0,inf
31857,56,7,63,0,inf
31858,53,5,58,0,inf
31859,62,12,74,0,inf
31860,67,5,72,0,inf
31861,67,11,78,0,inf
31862,50,8,58,0,inf
31863,52,11,63,0,inf
31864,52,12,64,0,inf
31865,52,8,60,0,inf
31866,67,12,79,0,inf
31867,61,13,74,0,inf
31868,57,9,66,0,inf
31869,62,11,73,0,inf
31870,61,12,73,0,inf
31871,51,13,64,1,2.26077761223673
31872,63,12,75,0,inf
31873,63,6,69,0,inf
31874,50,10,60,0,inf
31875,57,8,65,0,inf
31876,63,9,72,0,inf
31877,62,11,73,0,inf
31878,52,7,59,0,inf
31879,57,6,63,0,inf
31880,53,13,66,0,inf
31881,50,9,59,0,inf
31882,64,10,74,0,inf
31883,63,12,75,0,inf
31884,58,12,70,0,inf
31885,66,9,75,0,inf
31886,56,12,68,0,inf
31887,53,6,59,0,inf
31888,51,11,62,0,inf
31889,57,13,70,0,inf
31890,62,7,69,0,inf
31891,51,12,63,0,inf
31892,67,8,75,1,6.630441106195775
31893,64,5,69,0,inf
31894,58,8,66,0,inf
31895,62,13,75,0,inf
31896,60,12,72,0,inf
31897,56,5,61,0,inf
31898,62,10,72,0,inf
31899,63,6,69,0,inf
31900,50,5,55,0,inf
31901,66,8,74,0,inf
31902,59,5,64,0,inf
31903,57,6,63,0,inf
31904,50,5,55,0,inf
31905,60,6,66,0,inf
31906,62,11,73,0,inf
31907,61,12,73,0,inf
31908,57,5,62,0,inf
31909,60,5,65,0,inf
31910,60,10,70,0,inf
31911,65,11,76,0,inf
31912,66,6,72,0,inf
31913,53,11,64,0,inf
31914,62,13,75,1,4.859102311356807
31915,56,10,66,0,inf
31916,65,10,75,1,6.985563167469152
31917,61,13,74,0,inf
31918,63,8,71,0,inf
31919,52,7,59,0,inf
31920,60,13,73,0,inf
31921,62,10,72,0,inf
31922,57,9,66,0,inf
31923,57,9,66,0,inf
31924,67,11,78,0,inf
31925,58,12,70,0,inf
31926,64,10,74,1,7.567052027686316
31927,67,12,79,0,inf
31928,59,10,69,0,inf
31929,61,5,66,0,inf
31930,51,13,64,1,2.607593508369874
31931,65,7,72,0,inf
31932,64,10,74,0,inf
31933,54,12,66,0,inf
31934,55,9,64,0,inf
31935,56,12,68,0,inf
31936,65,10,75,0,inf
31937,61,12,73,0,inf
31938,53,6,59,0,inf
31939,54,7,61,0,inf
31940,51,5,56,0,inf
31941,52,9,61,0,inf
31942,55,8,63,0,inf
31943,60,5,65,0,inf
31944,62,8,70,0,inf
31945,50,5,55,0,inf
31946,67,13,80,0,inf
31947,65,13,78,0,inf
31948,60,6,66,0,inf
31949,50,8,58,0,inf
31950,61,11,72,0,inf
31951,57,7,64,0,inf
31952,56,10,66,0,inf
31953,61,8,69,0,inf
31954,63,13,76,0,inf
31955,62,10,72,0,inf
31956,64,11,75,0,inf
31957,50,7,57,0,inf
31958,52,9,61,0,inf
31959,62,7,69,0,inf
31960,66,6,72,0,inf
31961,57,7,64,0,inf
31962,57,7,64,0,inf
31963,61,9,70,0,inf
31964,61,6,67,0,inf
31965,67,6,73,0,inf
31966,62,5,67,0,inf
31967,62,5,67,0,inf
31968,55,5,60,0,inf
31969,50,5,55,0,inf
31970,52,8,60,0,inf
31971,50,7,57,0,inf
31972,65,13,78,0,inf
31973,60,11,71,0,inf
31974,52,7,59,0,inf
31975,50,6,56,0,inf
31976,52,13,65,0,inf
31977,50,13,63,0,inf
31978,57,9,66,0,inf
31979,63,6,69,0,inf
31980,51,10,61,0,inf
31981,61,7,68,0,inf
31982,56,11,67,0,inf
31983,59,6,65,0,inf
31984,57,9,66,0,inf
31985,63,5,68,0,inf
31986,54,5,59,0,inf
31987,65,12,77,0,inf
31988,62,13,75,0,inf
31989,65,5,70,0,inf
31990,62,9,71,0,inf
31991,50,7,57,0,inf
31992,62,9,71,0,inf
31993,56,6,62,0,inf
31994,50,10,60,0,inf
31995,57,8,65,0,inf
31996,52,11,63,1,2.8736915290247538
31997,51,10,61,0,inf
31998,65,6,71,0,inf
31999,53,11,64,0,inf
32000,54,10,64,0,inf
32001,66,12,78,0,inf
32002,65,11,76,0,inf
32003,61,12,73,0,inf
32004,55,5,60,0,inf
32005,65,7,72,0,inf
32006,60,10,70,0,inf
32007,65,9,74,0,inf
32008,66,8,74,0,inf
32009,63,5,68,0,inf
32010,61,11,72,0,inf
32011,56,10,66,0,inf
32012,64,7,71,0,inf
32013,67,12,79,1,6.09361974467798
32014,60,5,65,0,inf
32015,50,5,55,0,inf
32016,61,7,68,0,inf
32017,53,6,59,0,inf
32018,66,13,79,0,inf
32019,58,13,71,0,inf
32020,59,6,65,0,inf
32021,53,5,58,0,inf
32022,50,8,58,0,inf
32023,54,5,59,0,inf
32024,60,10,70,0,inf
32025,52,10,62,0,inf
32026,61,9,70,0,inf
32027,67,12,79,0,inf
32028,65,8,73,0,inf
32029,58,13,71,0,inf
32030,58,8,66,0,inf
32031,55,10,65,0,inf
32032,55,8,63,0,inf
32033,62,8,70,0,inf
32034,56,8,64,0,inf
32035,65,5,70,0,inf
32036,65,13,78,0,inf
32037,52,8,60,0,inf
32038,50,12,62,0,inf
32039,61,5,66,0,inf
32040,54,9,63,0,inf
32041,63,10,73,0,inf
32042,61,12,73,0,inf
32043,54,13,67,0,inf
32044,63,12,75,0,inf
32045,56,9,65,0,inf
32046,56,10,66,0,inf
32047,66,8,74,0,inf
32048,59,12,71,0,inf
32049,50,6,56,0,inf
32050,60,5,65,0,inf
32051,57,8,65,0,inf
32052,52,10,62,0,inf
32053,57,10,67,0,inf
32054,51,11,62,0,inf
32055,59,7,66,0,inf
32056,56,7,63,0,inf
32057,52,9,61,0,inf
32058,55,6,61,0,inf
32059,55,7,62,0,inf
32060,63,8,71,0,inf
32061,60,7,67,0,inf
32062,56,12,68,0,inf
32063,55,7,62,0,inf
32064,52,11,63,0,inf
32065,51,10,61,0,inf
32066,52,7,59,0,inf
32067,62,5,67,0,inf
32068,56,5,61,0,inf
32069,66,10,76,0,inf
32070,53,13,66,0,inf
32071,54,13,67,0,inf
32072,60,5,65,0,inf
32073,54,6,60,0,inf
32074,51,5,56,0,inf
32075,53,7,60,0,inf
32076,54,6,60,0,inf
32077,67,11,78,0,inf
32078,55,6,61,0,inf
32079,58,8,66,0,inf
32080,65,10,75,0,inf
32081,62,6,68,0,inf
32082,62,5,67,0,inf
32083,61,10,71,0,inf
32084,62,8,70,0,inf
32085,57,13,70,0,inf
32086,60,9,69,0,inf
32087,60,7,67,0,inf
32088,52,12,64,0,inf
32089,67,13,80,0,inf
32090,58,7,65,0,inf
32091,56,7,63,0,inf
32092,53,8,61,0,inf
32093,62,6,68,0,inf
32094,54,12,66,0,inf
32095,61,5,66,0,inf
32096,55,12,67,0,inf
32097,65,8,73,0,inf
32098,52,9,61,0,inf
32099,59,10,69,0,inf
32100,50,12,62,0,inf
32101,55,6,61,0,inf
32102,64,8,72,0,inf
32103,60,11,71,0,inf
32104,61,5,66,0,inf
32105,57,11,68,0,inf
32106,57,5,62,0,inf
32107,66,5,71,0,inf
32108,57,6,63,0,inf
32109,63,5,68,0,inf
32110,55,10,65,0,inf
32111,53,7,60,0,inf
32112,54,9,63,0,inf
32113,56,9,65,0,inf
32114,65,5,70,0,inf
32115,57,10,67,0,inf
32116,51,11,62,0,inf
32117,55,10,65,0,inf
32118,50,9,59,0,inf
32119,65,11,76,0,inf
32120,53,13,66,0,inf
32121,61,8,69,0,inf
32122,50,9,59,0,inf
32123,67,12,79,0,inf
32124,51,13,64,0,inf
32125,51,11,62,0,inf
32126,58,6,64,0,inf
32127,57,13,70,0,inf
32128,54,11,65,0,inf
32129,66,10,76,0,inf
32130,62,12,74,0,inf
32131,60,12,72,0,inf
32132,59,6,65,0,inf
32133,51,12,63,0,inf
32134,60,9,69,0,inf
32135,61,7,68,0,inf
32136,56,11,67,0,inf
32137,67,13,80,0,inf
32138,56,12,68,0,inf
32139,65,11,76,0,inf
32140,50,9,59,0,inf
32141,57,13,70,0,inf
32142,51,13,64,0,inf
32143,58,9,67,0,inf
32144,62,6,68,0,inf
32145,66,6,72,0,inf
32146,53,9,62,0,inf
32147,61,12,73,0,inf
32148,65,12,77,0,inf
32149,57,6,63,0,inf
32150,54,5,59,0,inf
32151,65,9,74,0,inf
32152,52,7,59,0,inf
32153,51,7,58,0,inf
32154,53,5,58,0,inf
32155,55,10,65,0,inf
32156,54,8,62,0,inf
32157,58,7,65,0,inf
32158,64,10,74,0,inf
32159,66,5,71,0,inf
32160,58,5,63,0,inf
32161,53,6,59,0,inf
32162,55,8,63,0,inf
32163,59,11,70,0,inf
32164,67,10,77,0,inf
32165,60,6,66,0,inf
32166,59,10,69,0,inf
32167,59,8,67,0,inf
32168,60,7,67,0,inf
32169,61,12,73,0,inf
32170,61,7,68,0,inf
32171,56,8,64,0,inf
32172,56,11,67,0,inf
32173,63,13,76,0,inf
32174,58,7,65,0,inf
32175,58,11,69,0,inf
32176,63,5,68,0,inf
32177,66,10,76,1,1.6777942282298852
32178,67,9,76,0,inf
32179,66,6,72,0,inf
32180,56,13,69,0,inf
32181,65,13,78,0,inf
32182,59,9,68,0,inf
32183,59,10,69,0,inf
32184,52,5,57,0,inf
32185,56,9,65,0,inf
32186,50,13,63,0,inf
32187,51,13,64,0,inf
32188,58,13,71,0,inf
32189,67,9,76,0,inf
32190,50,7,57,0,inf
32191,59,6,65,0,inf
32192,62,13,75,0,inf
32193,53,7,60,0,inf
32194,65,11,76,0,inf
32195,65,10,75,0,inf
32196,60,13,73,0,inf
32197,63,10,73,0,inf
32198,53,13,66,0,inf
32199,51,8,59,0,inf
32200,58,11,69,1,3.953709464941568
32201,54,7,61,0,inf
32202,50,5,55,0,inf
32203,61,10,71,0,inf
32204,64,11,75,0,inf
32205,52,6,58,0,inf
32206,55,11,66,0,inf
32207,58,5,63,0,inf
32208,56,11,67,0,inf
32209,62,5,67,0,inf
32210,67,9,76,0,inf
32211,52,10,62,0,inf
32212,59,13,72,0,inf
32213,50,6,56,0,inf
32214,55,10,65,0,inf
32215,63,12,75,0,inf
32216,54,5,59,0,inf
32217,54,6,60,0,inf
32218,65,7,72,0,inf
32219,60,12,72,0,inf
32220,53,10,63,0,inf
32221,65,12,77,0,inf
32222,60,13,73,0,inf
32223,59,8,67,0,inf
32224,61,9,70,0,inf
32225,60,13,73,0,inf
32226,66,7,73,0,inf
32227,67,12,79,0,inf
32228,56,12,68,0,inf
32229,57,12,69,0,inf
32230,65,12,77,0,inf
32231,56,11,67,0,inf
32232,53,12,65,0,inf
32233,63,8,71,0,inf
32234,50,13,63,0,inf
32235,58,10,68,0,inf
32236,58,5,63,0,inf
32237,65,8,73,0,inf
32238,53,13,66,0,inf
32239,61,7,68,1,0.8851237997460046
32240,54,10,64,0,inf
32241,54,6,60,1,4.275191747955702
32242,63,12,75,0,inf
32243,61,12,73,0,inf
32244,61,10,71,0,inf
32245,62,12,74,0,inf
32246,55,6,61,0,inf
32247,62,8,70,0,inf
32248,60,5,65,0,inf
32249,51,5,56,0,inf
32250,52,6,58,0,inf
32251,66,7,73,0,inf
32252,65,9,74,0,inf
32253,50,8,58,0,inf
32254,64,12,76,0,inf
32255,57,11,68,0,inf
32256,54,12,66,0,inf
32257,55,8,63,0,inf
32258,57,8,65,0,inf
32259,58,13,71,0,inf
32260,57,8,65,0,inf
32261,52,13,65,0,inf
32262,58,12,70,0,inf
32263,59,7,66,0,inf
32264,60,12,72,0,inf
32265,63,7,70,0,inf
32266,51,8,59,0,inf
32267,66,13,79,0,inf
32268,50,11,61,0,inf
32269,61,10,71,0,inf
32270,59,8,67,0,inf
32271,53,5,58,0,inf
32272,53,13,66,0,inf
32273,67,12,79,0,inf
32274,54,12,66,0,inf
32275,56,5,61,0,inf
32276,62,7,69,0,inf
32277,61,12,73,0,inf
32278,51,7,58,0,inf
32279,57,10,67,0,inf
32280,58,5,63,0,inf
32281,65,7,72,0,inf
32282,58,8,66,0,inf
32283,54,10,64,0,inf
32284,59,6,65,0,inf
32285,54,8,62,0,inf
32286,53,10,63,0,inf
32287,51,12,63,1,0.18669437938328315
32288,62,12,74,0,inf
32289,52,9,61,0,inf
32290,64,12,76,0,inf
32291,64,8,72,0,inf
32292,56,11,67,0,inf
32293,51,8,59,0,inf
32294,62,9,71,0,inf
32295,53,7,60,0,inf
32296,57,5,62,0,inf
32297,63,6,69,0,inf
32298,57,5,62,0,inf
32299,63,5,68,0,inf
32300,61,12,73,0,inf
32301,56,7,63,0,inf
32302,53,12,65,0,inf
32303,56,11,67,1,3.3916871704686216
32304,61,13,74,0,inf
32305,56,8,64,0,inf
32306,59,11,70,0,inf
32307,60,11,71,0,inf
32308,63,11,74,0,inf
32309,62,8,70,0,inf
32310,65,5,70,0,inf
32311,51,9,60,0,inf
32312,61,11,72,0,inf
32313,50,12,62,0,inf
32314,63,6,69,0,inf
32315,53,11,64,0,inf
32316,64,13,77,0,inf
32317,59,5,64,0,inf
32318,57,7,64,0,inf
32319,51,12,63,0,inf
32320,63,5,68,0,inf
32321,61,12,73,0,inf
32322,57,9,66,0,inf
32323,52,5,57,0,inf
32324,50,6,56,0,inf
32325,64,10,74,0,inf
32326,67,13,80,0,inf
32327,65,8,73,0,inf
32328,55,5,60,0,inf
32329,53,10,63,0,inf
32330,57,9,66,0,inf
32331,52,13,65,0,inf
32332,57,5,62,0,inf
32333,58,10,68,0,inf
32334,53,12,65,0,inf
32335,64,6,70,0,inf
32336,62,8,70,0,inf
32337,57,12,69,0,inf
32338,53,5,58,1,4.270726598661483
32339,66,7,73,0,inf
32340,54,10,64,0,inf
32341,62,11,73,0,inf
32342,62,12,74,0,inf
32343,53,5,58,0,inf
32344,64,5,69,0,inf
32345,57,7,64,1,0.7143667342077862
32346,53,5,58,0,inf
32347,60,13,73,0,inf
32348,62,7,69,0,inf
32349,56,10,66,0,inf
32350,61,5,66,0,inf
32351,50,9,59,0,inf
32352,65,7,72,0,inf
32353,55,5,60,0,inf
32354,59,5,64,0,inf
32355,65,8,73,0,inf
32356,63,10,73,0,inf
32357,63,9,72,0,inf
32358,63,6,69,0,inf
32359,64,11,75,0,inf
32360,51,11,62,0,inf
32361,58,13,71,0,inf
32362,55,13,68,0,inf
32363,56,9,65,0,inf
32364,66,12,78,0,inf
32365,54,9,63,0,inf
32366,54,8,62,0,inf
32367,64,6,70,0,inf
32368,59,11,70,0,inf
32369,62,10,72,0,inf
32370,53,10,63,0,inf
32371,56,7,63,0,inf
32372,65,13,78,0,inf
32373,54,13,67,0,inf
32374,62,8,70,0,inf
32375,62,9,71,0,inf
32376,57,5,62,0,inf
32377,56,9,65,0,inf
32378,51,10,61,0,inf
32379,56,9,65,0,inf
32380,52,11,63,0,inf
32381,54,6,60,0,inf
32382,56,7,63,0,inf
32383,58,7,65,0,inf
32384,66,10,76,0,inf
32385,50,13,63,0,inf
32386,55,5,60,0,inf
32387,61,12,73,0,inf
32388,59,7,66,0,inf
32389,59,10,69,0,inf
32390,54,10,64,0,inf
32391,54,11,65,0,inf
32392,51,11,62,0,inf
32393,65,6,71,0,inf
32394,52,10,62,0,inf
32395,66,5,71,0,inf
32396,57,9,66,0,inf
32397,56,7,63,0,inf
32398,50,11,61,0,inf
32399,66,12,78,0,inf
32400,57,8,65,0,inf
32401,57,6,63,0,inf
32402,52,6,58,0,inf
32403,53,10,63,0,inf
32404,51,12,63,0,inf
32405,62,7,69,0,inf
32406,57,9,66,0,inf
32407,63,13,76,0,inf
32408,59,5,64,0,inf
32409,52,8,60,0,inf
32410,52,5,57,0,inf
32411,58,6,64,0,inf
32412,66,10,76,0,inf
32413,66,8,74,0,inf
32414,53,13,66,0,inf
32415,66,6,72,0,inf
32416,67,8,75,0,inf
32417,66,6,72,0,inf
32418,50,11,61,0,inf
32419,53,5,58,0,inf
32420,52,8,60,0,inf
32421,63,7,70,0,inf
32422,63,12,75,0,inf
32423,53,12,65,0,inf
32424,58,11,69,0,inf
32425,67,12,79,0,inf
32426,60,8,68,0,inf
32427,59,8,67,0,inf
32428,65,12,77,0,inf
32429,52,7,59,0,inf
32430,60,7,67,0,inf
32431,57,12,69,0,inf
32432,56,7,63,0,inf
32433,66,5,71,0,inf
32434,67,13,80,0,inf
32435,67,11,78,0,inf
32436,59,9,68,0,inf
32437,56,5,61,0,inf
32438,59,12,71,0,inf
32439,65,6,71,0,inf
32440,61,11,72,0,inf
32441,65,13,78,1,10.873859386411567
32442,61,9,70,0,inf
32443,51,7,58,0,inf
32444,54,6,60,0,inf
32445,52,10,62,0,inf
32446,62,6,68,0,inf
32447,65,12,77,0,inf
32448,59,11,70,0,inf
32449,52,7,59,0,inf
32450,59,7,66,0,inf
32451,50,7,57,0,inf
32452,52,10,62,0,inf
32453,50,6,56,0,inf
32454,60,11,71,1,8.219762646247858
32455,64,11,75,0,inf
32456,63,12,75,0,inf
32457,65,7,72,0,inf
32458,64,9,73,0,inf
32459,64,12,76,0,inf
32460,51,11,62,0,inf
32461,62,13,75,0,inf
32462,61,9,70,0,inf
32463,54,13,67,0,inf
32464,62,5,67,0,inf
32465,66,10,76,0,inf
32466,55,11,66,0,inf
32467,54,5,59,0,inf
32468,50,7,57,0,inf
32469,65,9,74,0,inf
32470,54,13,67,0,inf
32471,67,6,73,0,inf
32472,61,8,69,0,inf
32473,60,10,70,0,inf
32474,54,13,67,0,inf
32475,62,12,74,0,inf
32476,51,13,64,0,inf
32477,62,7,69,0,inf
32478,65,5,70,0,inf
32479,58,8,66,0,inf
32480,62,10,72,0,inf
32481,60,11,71,0,inf
32482,51,6,57,0,inf
32483,65,13,78,0,inf
32484,67,9,76,0,inf
32485,60,13,73,0,inf
32486,60,9,69,0,inf
32487,53,12,65,0,inf
32488,52,5,57,0,inf
32489,55,11,66,0,inf
32490,54,7,61,0,inf
32491,58,8,66,0,inf
32492,51,5,56,0,inf
32493,51,12,63,0,inf
32494,60,11,71,0,inf
32495,56,11,67,0,inf
32496,56,6,62,0,inf
32497,59,13,72,0,inf
32498,60,11,71,0,inf
32499,54,13,67,0,inf
32500,51,8,59,0,inf
32501,51,9,60,0,inf
32502,53,13,66,0,inf
32503,66,11,77,0,inf
32504,51,5,56,0,inf
32505,50,9,59,0,inf
32506,63,7,70,0,inf
32507,62,8,70,0,inf
32508,60,8,68,0,inf
32509,57,10,67,0,inf
32510,63,12,75,0,inf
32511,51,12,63,0,inf
32512,51,7,58,0,inf
32513,55,12,67,0,inf
32514,52,13,65,0,inf
32515,62,13,75,0,inf
32516,67,12,79,0,inf
32517,66,11,77,0,inf
32518,52,11,63,0,inf
32519,62,13,75,0,inf
32520,50,6,56,0,inf
32521,62,12,74,0,inf
32522,52,7,59,0,inf
32523,51,6,57,0,inf
32524,65,12,77,0,inf
32525,51,6,57,0,inf
32526,66,6,72,0,inf
32527,67,5,72,0,inf
32528,56,11,67,0,inf
32529,56,9,65,0,inf
32530,52,13,65,0,inf
32531,52,12,64,0,inf
32532,66,13,79,0,inf
32533,62,8,70,0,inf
32534,52,9,61,0,inf
32535,51,8,59,0,inf
32536,62,7,69,0,inf
32537,50,7,57,0,inf
32538,59,11,70,0,inf
32539,59,12,71,0,inf
32540,63,10,73,0,inf
32541,56,9,65,0,inf
32542,54,6,60,0,inf
32543,53,10,63,0,inf
32544,55,8,63,0,inf
32545,60,10,70,0,inf
32546,52,12,64,0,inf
32547,65,5,70,0,inf
32548,61,13,74,0,inf
32549,62,9,71,1,6.807088363735062
32550,53,10,63,0,inf
32551,57,12,69,0,inf
32552,58,9,67,0,inf
32553,65,11,76,0,inf
32554,53,11,64,0,inf
32555,63,12,75,0,inf
32556,51,8,59,0,inf
32557,59,7,66,0,inf
32558,59,8,67,0,inf
32559,59,10,69,0,inf
32560,59,6,65,0,inf
32561,57,5,62,0,inf
32562,53,7,60,0,inf
32563,66,7,73,0,inf
32564,63,5,68,0,inf
32565,61,9,70,0,inf
32566,54,5,59,0,inf
32567,59,8,67,0,inf
32568,64,11,75,0,inf
32569,53,8,61,0,inf
32570,56,12,68,1,10.377422994331368
32571,63,10,73,0,inf
32572,59,7,66,0,inf
32573,63,6,69,0,inf
32574,54,5,59,0,inf
32575,64,8,72,1,3.5079259734640686
32576,63,6,69,0,inf
32577,55,10,65,0,inf
32578,61,6,67,0,inf
32579,61,13,74,0,inf
32580,62,6,68,0,inf
32581,57,10,67,0,inf
32582,65,8,73,0,inf
32583,62,12,74,1,4.821570300316708
32584,61,12,73,0,inf
32585,60,13,73,0,inf
32586,59,9,68,0,inf
32587,63,10,73,0,inf
32588,50,11,61,0,inf
32589,66,7,73,0,inf
32590,61,11,72,0,inf
32591,65,8,73,0,inf
32592,56,13,69,0,inf
32593,63,9,72,0,inf
32594,64,5,69,0,inf
32595,60,12,72,0,inf
32596,67,12,79,0,inf
32597,61,9,70,0,inf
32598,62,9,71,0,inf
32599,62,11,73,0,inf
32600,67,7,74,0,inf
32601,53,5,58,0,inf
32602,57,6,63,1,3.6246773034596984
32603,54,13,67,0,inf
32604,56,5,61,0,inf
32605,53,12,65,0,inf
32606,59,6,65,0,inf
32607,67,6,73,0,inf
32608,60,12,72,0,inf
32609,67,5,72,0,inf
32610,57,13,70,0,inf
32611,53,11,64,0,inf
32612,61,5,66,0,inf
32613,55,6,61,0,inf
32614,60,10,70,0,inf
32615,66,9,75,0,inf
32616,52,5,57,0,inf
32617,53,6,59,0,inf
32618,66,8,74,0,inf
32619,66,9,75,0,inf
32620,59,7,66,0,inf
32621,50,8,58,0,inf
32622,50,8,58,0,inf
32623,66,12,78,0,inf
32624,64,6,70,0,inf
32625,67,7,74,0,inf
32626,54,8,62,0,inf
32627,59,8,67,0,inf
32628,53,5,58,0,inf
32629,64,9,73,0,inf
32630,50,11,61,0,inf
32631,52,8,60,0,inf
32632,51,7,58,0,inf
32633,55,12,67,0,inf
32634,64,13,77,0,inf
32635,62,7,69,0,inf
32636,65,8,73,0,inf
32637,51,7,58,0,inf
32638,54,8,62,1,4.625906197972107
32639,52,8,60,0,inf
32640,63,12,75,0,inf
32641,66,10,76,0,inf
32642,56,8,64,0,inf
32643,65,11,76,0,inf
32644,65,12,77,0,inf
32645,55,7,62,0,inf
32646,66,6,72,0,inf
32647,60,6,66,0,inf
32648,65,6,71,0,inf
32649,63,6,69,0,inf
32650,62,6,68,0,inf
32651,57,8,65,0,inf
32652,56,5,61,0,inf
32653,52,12,64,0,inf
32654,50,9,59,0,inf
32655,67,8,75,0,inf
32656,67,11,78,1,9.30149061175652
32657,63,5,68,0,inf
32658,64,8,72,0,inf
32659,53,5,58,0,inf
32660,51,7,58,0,inf
32661,67,11,78,0,inf
32662,67,12,79,0,inf
32663,50,7,57,0,inf
32664,52,10,62,0,inf
32665,62,13,75,0,inf
32666,60,6,66,1,1.2388894088334297
32667,61,10,71,0,inf
32668,52,8,60,0,inf
32669,62,13,75,0,inf
32670,60,6,66,0,inf
32671,57,6,63,0,inf
32672,53,10,63,0,inf
32673,54,11,65,1,5.072899531218518
32674,63,6,69,0,inf
32675,61,7,68,0,inf
32676,58,8,66,0,inf
32677,67,6,73,0,inf
32678,56,8,64,0,inf
32679,64,12,76,0,inf
32680,61,12,73,0,inf
32681,63,10,73,0,inf
32682,66,11,77,0,inf
32683,54,6,60,0,inf
32684,57,12,69,0,inf
32685,61,5,66,1,4.931153422194669
32686,67,10,77,0,inf
32687,53,7,60,0,inf
32688,55,10,65,0,inf
32689,55,6,61,0,inf
32690,55,12,67,0,inf
32691,51,10,61,0,inf
32692,61,7,68,0,inf
32693,50,10,60,0,inf
32694,59,7,66,0,inf
32695,51,9,60,0,inf
32696,58,6,64,0,inf
32697,55,8,63,0,inf
32698,59,11,70,0,inf
32699,62,9,71,0,inf
32700,56,13,69,0,inf
32701,61,13,74,0,inf
32702,64,7,71,0,inf
32703,54,13,67,0,inf
32704,64,7,71,0,inf
32705,64,12,76,0,inf
32706,58,10,68,0,inf
32707,55,6,61,0,inf
32708,67,5,72,0,inf
32709,58,13,71,0,inf
32710,64,7,71,0,inf
32711,56,9,65,0,inf
32712,57,9,66,0,inf
32713,54,8,62,0,inf
32714,50,6,56,0,inf
32715,59,8,67,0,inf
32716,65,9,74,0,inf
32717,58,6,64,0,inf
32718,54,9,63,0,inf
32719,53,13,66,0,inf
32720,55,10,65,0,inf
32721,52,12,64,0,inf
32722,57,10,67,0,inf
32723,62,10,72,0,inf
32724,66,13,79,0,inf
32725,57,5,62,0,inf
32726,63,6,69,0,inf
32727,57,11,68,1,7.909327711105192
32728,56,6,62,0,inf
32729,58,6,64,0,inf
32730,57,13,70,0,inf
32731,57,6,63,0,inf
32732,57,6,63,0,inf
32733,58,12,70,0,inf
32734,64,8,72,0,inf
32735,65,13,78,0,inf
32736,53,11,64,0,inf
32737,58,12,70,0,inf
32738,67,9,76,0,inf
32739,58,13,71,0,inf
32740,55,9,64,0,inf
32741,51,12,63,0,inf
32742,64,13,77,0,inf
32743,62,13,75,0,inf
32744,54,13,67,0,inf
32745,66,10,76,0,inf
32746,54,13,67,0,inf
32747,51,9,60,0,inf
32748,62,8,70,0,inf
32749,58,13,71,0,inf
32750,60,11,71,0,inf
32751,59,8,67,0,inf
32752,53,8,61,0,inf
32753,64,5,69,0,inf
32754,51,9,60,0,inf
32755,54,12,66,0,inf
32756,56,6,62,0,inf
32757,65,12,77,0,inf
32758,65,8,73,0,inf
32759,65,11,76,0,inf
32760,58,7,65,0,inf
32761,52,10,62,0,inf
32762,55,9,64,0,inf
32763,61,9,70,0,inf
32764,63,9,72,0,inf
32765,53,5,58,0,inf
32766,56,5,61,0,inf
32767,52,5,57,0,inf
32768,60,7,67,0,inf
32769,57,11,68,0,inf
32770,53,12,65,0,inf
32771,55,9,64,0,inf
32772,61,13,74,0,inf
32773,51,10,61,0,inf
32774,60,5,65,0,inf
32775,65,7,72,0,inf
32776,52,10,62,0,inf
32777,58,13,71,0,inf
32778,64,9,73,0,inf
32779,58,8,66,0,inf
32780,66,10,76,0,inf
32781,52,12,64,0,inf
32782,59,10,69,1,7.726443661333818
32783,60,5,65,0,inf
32784,50,7,57,0,inf
32785,65,8,73,0,inf
32786,53,13,66,0,inf
32787,51,8,59,0,inf
32788,67,7,74,0,inf
32789,65,10,75,0,inf
32790,64,7,71,0,inf
32791,54,13,67,0,inf
32792,56,13,69,0,inf
32793,50,11,61,0,inf
32794,55,13,68,0,inf
32795,61,7,68,0,inf
32796,53,8,61,0,inf
32797,51,9,60,0,inf
32798,54,12,66,0,inf
32799,56,12,68,0,inf
32800,53,5,58,0,inf
32801,54,12,66,0,inf
32802,67,12,79,1,6.678513341831376
32803,51,13,64,0,inf
32804,50,12,62,0,inf
32805,58,6,64,0,inf
32806,55,9,64,0,inf
32807,59,7,66,0,inf
32808,63,11,74,0,inf
32809,52,5,57,0,inf
32810,67,6,73,0,inf
32811,60,8,68,0,inf
32812,59,12,71,0,inf
32813,51,5,56,0,inf
32814,63,10,73,0,inf
32815,56,10,66,0,inf
32816,60,13,73,0,inf
32817,56,10,66,0,inf
32818,65,13,78,0,inf
32819,56,7,63,0,inf
32820,51,8,59,0,inf
32821,55,5,60,0,inf
32822,55,6,61,0,inf
32823,64,6,70,0,inf
32824,62,9,71,0,inf
32825,63,12,75,0,inf
32826,60,10,70,0,inf
32827,62,5,67,0,inf
32828,64,8,72,0,inf
32829,65,8,73,0,inf
32830,51,11,62,0,inf
32831,53,7,60,0,inf
32832,53,13,66,0,inf
32833,61,11,72,0,inf
32834,58,5,63,0,inf
32835,50,7,57,0,inf
32836,65,10,75,0,inf
32837,50,6,56,0,inf
32838,51,8,59,0,inf
32839,58,12,70,0,inf
32840,66,13,79,0,inf
32841,58,8,66,0,inf
32842,61,6,67,0,inf
32843,53,5,58,0,inf
32844,61,5,66,0,inf
32845,57,8,65,0,inf
32846,53,10,63,0,inf
32847,60,8,68,0,inf
32848,66,11,77,0,inf
32849,67,13,80,0,inf
32850,57,7,64,0,inf
32851,57,10,67,0,inf
32852,58,5,63,0,inf
32853,51,6,57,0,inf
32854,56,13,69,0,inf
32855,65,8,73,0,inf
32856,53,13,66,0,inf
32857,54,6,60,0,inf
32858,56,13,69,0,inf
32859,66,11,77,1,3.0000192951275864
32860,57,6,63,0,inf
32861,55,12,67,0,inf
32862,50,6,56,0,inf
32863,67,7,74,0,inf
32864,62,9,71,0,inf
32865,62,12,74,0,inf
32866,55,9,64,1,0.9663042490150531
32867,51,13,64,0,inf
32868,56,13,69,0,inf
32869,56,5,61,0,inf
32870,64,5,69,0,inf
32871,60,9,69,0,inf
32872,62,10,72,0,inf
32873,61,7,68,0,inf
32874,63,10,73,0,inf
32875,60,9,69,0,inf
32876,51,12,63,0,inf
32877,62,11,73,0,inf
32878,63,11,74,0,inf
32879,65,5,70,0,inf
32880,65,9,74,0,inf
32881,57,7,64,0,inf
32882,64,6,70,0,inf
32883,51,12,63,0,inf
32884,60,7,67,1,1.0776058190123479
32885,58,9,67,0,inf
32886,53,8,61,0,inf
32887,65,12,77,0,inf
32888,66,8,74,0,inf
32889,67,13,80,0,inf
32890,58,8,66,0,inf
32891,51,13,64,0,inf
32892,65,5,70,0,inf
32893,62,12,74,0,inf
32894,56,7,63,1,3.409383922734463
32895,57,8,65,0,inf
32896,56,12,68,0,inf
32897,54,5,59,0,inf
32898,62,6,68,0,inf
32899,56,7,63,0,inf
32900,66,6,72,0,inf
32901,54,12,66,0,inf
32902,55,13,68,0,inf
32903,66,9,75,0,inf
32904,61,12,73,0,inf
32905,61,7,68,0,inf
32906,61,8,69,0,inf
32907,59,8,67,0,inf
32908,61,12,73,0,inf
32909,65,9,74,0,inf
32910,64,12,76,0,inf
32911,52,8,60,0,inf
32912,55,10,65,0,inf
32913,67,8,75,0,inf
32914,52,11,63,0,inf
32915,51,8,59,0,inf
32916,53,13,66,0,inf
32917,58,6,64,0,inf
32918,51,6,57,0,inf
32919,61,5,66,0,inf
32920,52,6,58,0,inf
32921,54,10,64,0,inf
32922,51,7,58,0,inf
32923,54,12,66,0,inf
32924,67,12,79,1,10.262252509219635
32925,59,7,66,0,inf
32926,50,7,57,0,inf
32927,55,5,60,0,inf
32928,67,5,72,0,inf
32929,55,13,68,0,inf
32930,56,7,63,0,inf
32931,51,6,57,0,inf
32932,60,5,65,0,inf
32933,63,9,72,0,inf
32934,56,6,62,0,inf
32935,54,10,64,0,inf
32936,55,13,68,0,inf
32937,59,11,70,0,inf
32938,64,8,72,0,inf
32939,50,12,62,0,inf
32940,51,10,61,0,inf
32941,52,5,57,0,inf
32942,67,10,77,0,inf
32943,57,12,69,0,inf
32944,66,10,76,0,inf
32945,63,9,72,0,inf
32946,54,7,61,0,inf
32947,52,5,57,0,inf
32948,64,8,72,0,inf
32949,55,11,66,0,inf
32950,67,9,76,0,inf
32951,59,12,71,0,inf
32952,57,9,66,0,inf
32953,61,10,71,0,inf
32954,51,8,59,0,inf
32955,62,6,68,0,inf
32956,66,8,74,0,inf
32957,67,13,80,0,inf
32958,60,5,65,0,inf
32959,66,11,77,0,inf
32960,52,13,65,0,inf
32961,60,7,67,0,inf
32962,55,6,61,0,inf
32963,62,11,73,0,inf
32964,60,5,65,0,inf
32965,56,8,64,0,inf
32966,65,11,76,0,inf
32967,66,10,76,0,inf
32968,65,13,78,0,inf
32969,59,11,70,0,inf
32970,64,6,70,0,inf
32971,56,12,68,0,inf
32972,61,13,74,0,inf
32973,53,12,65,0,inf
32974,63,5,68,0,inf
32975,52,11,63,0,inf
32976,50,12,62,0,inf
32977,55,13,68,0,inf
32978,57,10,67,0,inf
32979,66,6,72,0,inf
32980,64,7,71,0,inf
32981,67,12,79,0,inf
32982,61,13,74,0,inf
32983,66,13,79,0,inf
32984,51,10,61,0,inf
32985,66,13,79,0,inf
32986,58,10,68,0,inf
32987,53,13,66,0,inf
32988,60,9,69,0,inf
32989,63,5,68,0,inf
32990,60,12,72,0,inf
32991,61,5,66,0,inf
32992,58,5,63,0,inf
32993,62,13,75,0,inf
32994,60,9,69,0,inf
32995,51,7,58,1,0.0002563513709716858
32996,63,8,71,0,inf
32997,62,13,75,0,inf
32998,55,7,62,1,5.180533174015494
32999,53,7,60,0,inf
33000,63,13,76,0,inf
33001,58,13,71,0,inf
33002,63,7,70,0,inf
33003,67,5,72,0,inf
33004,52,8,60,0,inf
33005,65,7,72,0,inf
33006,50,5,55,0,inf
33007,58,9,67,0,inf
33008,61,12,73,0,inf
33009,67,12,79,0,inf
33010,64,6,70,0,inf
33011,62,5,67,0,inf
33012,64,12,76,0,inf
33013,64,13,77,0,inf
33014,51,5,56,0,inf
33015,63,11,74,0,inf
33016,53,10,63,0,inf
33017,60,10,70,0,inf
33018,67,7,74,0,inf
33019,56,8,64,0,inf
33020,56,6,62,0,inf
33021,61,5,66,0,inf
33022,61,9,70,0,inf
33023,54,6,60,0,inf
33024,63,9,72,0,inf
33025,63,10,73,0,inf
33026,60,9,69,0,inf
33027,61,5,66,0,inf
33028,57,7,64,0,inf
33029,53,8,61,0,inf
33030,66,13,79,0,inf
33031,55,11,66,0,inf
33032,55,7,62,0,inf
33033,67,5,72,0,inf
33034,67,6,73,0,inf
33035,67,11,78,0,inf
33036,50,5,55,0,inf
33037,60,10,70,0,inf
33038,58,13,71,0,inf
33039,52,13,65,0,inf
33040,57,8,65,0,inf
33041,66,12,78,0,inf
33042,53,11,64,0,inf
33043,50,6,56,0,inf
33044,65,7,72,0,inf
33045,55,6,61,0,inf
33046,63,12,75,0,inf
33047,62,5,67,0,inf
33048,66,8,74,0,inf
33049,64,13,77,0,inf
33050,54,5,59,0,inf
33051,64,11,75,0,inf
33052,58,12,70,0,inf
33053,55,8,63,0,inf
33054,63,6,69,0,inf
33055,56,12,68,0,inf
33056,57,9,66,0,inf
33057,67,5,72,0,inf
33058,54,13,67,1,1.0893970326226352
33059,59,7,66,0,inf
33060,53,7,60,0,inf
33061,55,8,63,0,inf
33062,54,8,62,0,inf
33063,67,7,74,0,inf
33064,63,9,72,0,inf
33065,62,8,70,0,inf
33066,58,13,71,0,inf
33067,50,11,61,0,inf
33068,51,5,56,0,inf
33069,57,6,63,0,inf
33070,64,12,76,0,inf
33071,56,6,62,0,inf
33072,52,13,65,0,inf
33073,52,10,62,0,inf
33074,58,12,70,0,inf
33075,55,6,61,0,inf
33076,50,9,59,0,inf
33077,62,6,68,0,inf
33078,65,5,70,0,inf
33079,51,12,63,0,inf
33080,65,8,73,0,inf
33081,59,7,66,0,inf
33082,65,5,70,0,inf
33083,53,9,62,0,inf
33084,54,7,61,0,inf
33085,64,10,74,0,inf
33086,58,12,70,0,inf
33087,61,12,73,0,inf
33088,66,9,75,0,inf
33089,52,9,61,0,inf
33090,54,10,64,0,inf
33091,67,12,79,0,inf
33092,53,7,60,0,inf
33093,59,8,67,0,inf
33094,50,9,59,0,inf
33095,51,7,58,0,inf
33096,50,11,61,0,inf
33097,61,12,73,0,inf
33098,65,8,73,0,inf
33099,51,11,62,0,inf
33100,61,6,67,0,inf
33101,51,13,64,0,inf
33102,63,7,70,0,inf
33103,50,13,63,0,inf
33104,62,6,68,0,inf
33105,60,7,67,0,inf
33106,55,9,64,0,inf
33107,60,8,68,1,2.818011457223008
33108,59,10,69,0,inf
33109,53,9,62,0,inf
33110,55,8,63,0,inf
33111,62,8,70,0,inf
33112,62,11,73,0,inf
33113,60,11,71,0,inf
33114,55,5,60,0,inf
33115,58,11,69,0,inf
33116,59,10,69,0,inf
33117,66,7,73,0,inf
33118,62,8,70,0,inf
33119,62,7,69,0,inf
33120,63,5,68,0,inf
33121,56,12,68,0,inf
33122,64,8,72,0,inf
33123,63,13,76,0,inf
33124,65,8,73,0,inf
33125,57,13,70,0,inf
33126,60,13,73,0,inf
33127,57,5,62,0,inf
33128,64,7,71,0,inf
33129,55,8,63,0,inf
33130,58,7,65,0,inf
33131,65,11,76,0,inf
33132,59,13,72,0,inf
33133,59,8,67,0,inf
33134,65,13,78,0,inf
33135,64,13,77,0,inf
33136,67,8,75,0,inf
33137,59,8,67,0,inf
33138,54,5,59,0,inf
33139,53,11,64,0,inf
33140,54,6,60,0,inf
33141,66,11,77,0,inf
33142,62,11,73,0,inf
33143,53,8,61,0,inf
33144,62,13,75,0,inf
33145,50,8,58,0,inf
33146,67,9,76,0,inf
33147,62,9,71,0,inf
33148,50,10,60,0,inf
33149,51,6,57,0,inf
33150,64,5,69,0,inf
33151,61,13,74,0,inf
33152,60,9,69,0,inf
33153,63,8,71,0,inf
33154,62,6,68,1,5.3951723458629175
33155,55,8,63,0,inf
33156,55,5,60,0,inf
33157,61,5,66,0,inf
33158,52,10,62,0,inf
33159,67,7,74,0,inf
33160,62,8,70,0,inf
33161,64,8,72,0,inf
33162,58,12,70,0,inf
33163,50,7,57,0,inf
33164,57,9,66,0,inf
33165,67,12,79,1,7.940510056540447
33166,67,5,72,0,inf
33167,52,12,64,0,inf
33168,54,8,62,0,inf
33169,55,10,65,0,inf
33170,65,5,70,0,inf
33171,67,12,79,0,inf
33172,62,11,73,0,inf
33173,64,10,74,0,inf
33174,56,8,64,0,inf
33175,64,6,70,0,inf
33176,65,13,78,0,inf
33177,51,7,58,0,inf
33178,61,12,73,0,inf
33179,58,13,71,0,inf
33180,63,5,68,0,inf
33181,58,10,68,0,inf
33182,63,12,75,0,inf
33183,62,7,69,0,inf
33184,67,12,79,0,inf
33185,64,8,72,0,inf
33186,50,12,62,0,inf
33187,51,10,61,0,inf
33188,64,10,74,0,inf
33189,66,6,72,0,inf
33190,56,7,63,0,inf
33191,50,6,56,0,inf
33192,66,9,75,0,inf
33193,58,6,64,0,inf
33194,64,7,71,0,inf
33195,54,9,63,0,inf
33196,63,12,75,0,inf
33197,52,5,57,0,inf
33198,65,13,78,0,inf
33199,64,7,71,0,inf
33200,57,12,69,0,inf
33201,67,10,77,0,inf
33202,59,7,66,0,inf
33203,53,7,60,0,inf
33204,53,9,62,0,inf
33205,62,10,72,0,inf
33206,60,12,72,0,inf
33207,56,11,67,0,inf
33208,65,7,72,0,inf
33209,67,6,73,0,inf
33210,58,7,65,0,inf
33211,56,8,64,0,inf
33212,67,8,75,0,inf
33213,53,12,65,0,inf
33214,55,9,64,0,inf
33215,59,10,69,0,inf
33216,51,7,58,0,inf
33217,57,6,63,0,inf
33218,61,9,70,0,inf
33219,56,6,62,0,inf
33220,62,13,75,0,inf
33221,54,10,64,0,inf
33222,65,12,77,0,inf
33223,60,7,67,0,inf
33224,61,11,72,0,inf
33225,62,9,71,0,inf
33226,54,5,59,0,inf
33227,63,7,70,0,inf
33228,59,9,68,0,inf
33229,65,12,77,0,inf
33230,67,11,78,0,inf
33231,52,13,65,0,inf
33232,64,9,73,0,inf
33233,64,8,72,0,inf
33234,55,13,68,0,inf
33235,64,7,71,0,inf
33236,54,12,66,1,8.982310298583222
33237,66,12,78,0,inf
33238,57,6,63,0,inf
33239,54,8,62,0,inf
33240,51,13,64,0,inf
33241,65,12,77,0,inf
33242,58,12,70,0,inf
33243,65,5,70,0,inf
33244,59,8,67,0,inf
33245,66,12,78,0,inf
33246,61,9,70,0,inf
33247,55,8,63,0,inf
33248,60,9,69,0,inf
33249,52,5,57,0,inf
33250,57,8,65,0,inf
33251,60,11,71,0,inf
33252,59,13,72,0,inf
33253,64,8,72,0,inf
33254,52,13,65,0,inf
33255,60,13,73,0,inf
33256,64,11,75,0,inf
33257,58,8,66,0,inf
33258,65,13,78,0,inf
33259,50,6,56,0,inf
33260,51,12,63,0,inf
33261,51,9,60,0,inf
33262,61,7,68,0,inf
33263,58,10,68,0,inf
33264,50,6,56,0,inf
33265,66,11,77,0,inf
33266,56,8,64,0,inf
33267,57,9,66,0,inf
33268,65,11,76,0,inf
33269,57,13,70,0,inf
33270,61,10,71,0,inf
33271,59,5,64,0,inf
33272,57,6,63,0,inf
33273,61,10,71,0,inf
33274,52,6,58,0,inf
33275,61,6,67,0,inf
33276,56,11,67,0,inf
33277,62,13,75,0,inf
33278,58,7,65,0,inf
33279,59,6,65,0,inf
33280,54,5,59,0,inf
33281,58,7,65,0,inf
33282,62,12,74,0,inf
33283,65,5,70,0,inf
33284,67,12,79,0,inf
33285,59,9,68,0,inf
33286,51,10,61,0,inf
33287,67,7,74,0,inf
33288,58,6,64,0,inf
33289,66,12,78,0,inf
33290,56,8,64,0,inf
33291,63,13,76,0,inf
33292,59,6,65,0,inf
33293,58,9,67,0,inf
33294,60,13,73,0,inf
33295,66,6,72,0,inf
33296,61,12,73,0,inf
33297,56,11,67,0,inf
33298,56,10,66,0,inf
33299,59,5,64,0,inf
33300,64,5,69,0,inf
33301,52,12,64,0,inf
33302,50,12,62,0,inf
33303,50,5,55,0,inf
33304,51,12,63,0,inf
33305,57,11,68,0,inf
33306,66,6,72,0,inf
33307,54,8,62,0,inf
33308,50,12,62,0,inf
33309,54,6,60,0,inf
33310,60,6,66,0,inf
33311,57,7,64,0,inf
33312,61,9,70,0,inf
33313,63,6,69,0,inf
33314,53,5,58,0,inf
33315,54,9,63,0,inf
33316,66,8,74,0,inf
33317,61,5,66,0,inf
33318,59,8,67,0,inf
33319,55,12,67,0,inf
33320,56,6,62,0,inf
33321,51,7,58,0,inf
33322,50,11,61,0,inf
33323,52,9,61,0,inf
33324,53,12,65,0,inf
33325,55,11,66,0,inf
33326,66,12,78,0,inf
33327,56,8,64,0,inf
33328,51,11,62,0,inf
33329,61,12,73,0,inf
33330,63,12,75,0,inf
33331,54,8,62,0,inf
33332,59,6,65,0,inf
33333,63,11,74,0,inf
33334,57,13,70,0,inf
33335,57,5,62,0,inf
33336,52,5,57,0,inf
33337,66,13,79,0,inf
33338,62,11,73,0,inf
33339,50,10,60,0,inf
33340,54,9,63,0,inf
33341,53,6,59,1,3.363364766943704
33342,60,7,67,0,inf
33343,54,6,60,0,inf
33344,55,8,63,0,inf
33345,64,5,69,0,inf
33346,61,5,66,0,inf
33347,63,13,76,0,inf
33348,55,9,64,0,inf
33349,53,8,61,0,inf
33350,60,10,70,0,inf
33351,64,7,71,0,inf
33352,63,10,73,0,inf
33353,56,7,63,0,inf
33354,62,5,67,0,inf
33355,60,6,66,0,inf
33356,67,12,79,0,inf
33357,52,8,60,0,inf
33358,52,8,60,0,inf
33359,60,10,70,0,inf
33360,56,13,69,0,inf
33361,64,5,69,0,inf
33362,61,6,67,0,inf
33363,54,13,67,0,inf
33364,64,11,75,0,inf
33365,59,7,66,0,inf
33366,52,6,58,0,inf
33367,51,13,64,0,inf
33368,54,11,65,0,inf
33369,66,13,79,0,inf
33370,51,8,59,0,inf
33371,55,7,62,0,inf
33372,64,9,73,0,inf
33373,59,12,71,0,inf
33374,67,11,78,0,inf
33375,55,12,67,0,inf
33376,54,10,64,0,inf
33377,66,5,71,0,inf
33378,61,12,73,0,inf
33379,67,8,75,0,inf
33380,66,9,75,0,inf
33381,55,11,66,0,inf
33382,60,10,70,1,6.181261262603755
33383,65,13,78,0,inf
33384,51,13,64,0,inf
33385,52,10,62,0,inf
33386,67,13,80,0,inf
33387,61,5,66,0,inf
33388,50,13,63,0,inf
33389,59,8,67,0,inf
33390,66,10,76,0,inf
33391,52,7,59,0,inf
33392,60,11,71,0,inf
33393,61,13,74,0,inf
33394,61,5,66,0,inf
33395,67,5,72,0,inf
33396,55,11,66,0,inf
33397,66,6,72,0,inf
33398,59,11,70,0,inf
33399,63,8,71,0,inf
33400,55,11,66,0,inf
33401,66,10,76,0,inf
33402,66,5,71,0,inf
33403,50,11,61,0,inf
33404,52,9,61,0,inf
33405,59,13,72,0,inf
33406,60,13,73,0,inf
33407,53,9,62,0,inf
33408,60,13,73,0,inf
33409,64,5,69,0,inf
33410,62,9,71,0,inf
33411,51,12,63,0,inf
33412,50,11,61,0,inf
33413,67,5,72,0,inf
33414,61,6,67,0,inf
33415,64,11,75,1,3.834161572760763
33416,51,13,64,0,inf
33417,50,6,56,0,inf
33418,61,8,69,0,inf
33419,56,7,63,0,inf
33420,54,13,67,0,inf
33421,64,11,75,0,inf
33422,61,8,69,0,inf
33423,54,8,62,0,inf
33424,52,7,59,0,inf
33425,59,7,66,0,inf
33426,62,8,70,0,inf
33427,66,10,76,0,inf
33428,55,12,67,0,inf
33429,53,5,58,0,inf
33430,65,8,73,1,1.031908594267847
33431,57,9,66,0,inf
33432,62,8,70,0,inf
33433,50,5,55,0,inf
33434,62,12,74,0,inf
33435,60,5,65,0,inf
33436,60,9,69,0,inf
33437,53,13,66,0,inf
33438,62,9,71,0,inf
33439,63,8,71,0,inf
33440,51,13,64,0,inf
33441,56,12,68,0,inf
33442,67,7,74,0,inf
33443,50,10,60,0,inf
33444,62,11,73,1,7.581137598713411
33445,52,9,61,0,inf
33446,54,10,64,1,2.3205897023028683
33447,67,12,79,0,inf
33448,55,7,62,0,inf
33449,62,12,74,0,inf
33450,54,5,59,0,inf
33451,64,9,73,0,inf
33452,52,9,61,0,inf
33453,67,13,80,0,inf
33454,52,10,62,0,inf
33455,54,7,61,1,0.11439788185928279
33456,54,6,60,0,inf
33457,59,12,71,0,inf
33458,60,7,67,0,inf
33459,62,13,75,0,inf
33460,60,5,65,0,inf
33461,57,11,68,0,inf
33462,53,11,64,0,inf
33463,58,10,68,0,inf
33464,52,10,62,0,inf
33465,67,6,73,0,inf
33466,50,9,59,0,inf
33467,58,10,68,0,inf
33468,59,7,66,0,inf
33469,67,5,72,0,inf
33470,55,8,63,1,1.9305864018889736
33471,51,7,58,0,inf
33472,57,10,67,0,inf
33473,55,9,64,0,inf
33474,55,7,62,0,inf
33475,63,5,68,0,inf
33476,50,11,61,0,inf
33477,57,9,66,0,inf
33478,59,11,70,0,inf
33479,64,10,74,0,inf
33480,51,11,62,0,inf
33481,58,11,69,0,inf
33482,56,7,63,0,inf
33483,63,9,72,0,inf
33484,56,9,65,0,inf
33485,54,6,60,0,inf
33486,52,12,64,0,inf
33487,65,10,75,0,inf
33488,66,12,78,0,inf
33489,52,10,62,0,inf
33490,50,5,55,0,inf
33491,51,12,63,0,inf
33492,62,13,75,0,inf
33493,50,10,60,0,inf
33494,56,12,68,0,inf
33495,54,13,67,0,inf
33496,57,10,67,0,inf
33497,53,7,60,0,inf
33498,56,5,61,0,inf
33499,63,9,72,0,inf
33500,59,10,69,0,inf
33501,66,11,77,0,inf
33502,66,8,74,0,inf
33503,56,12,68,0,inf
33504,54,12,66,0,inf
33505,53,11,64,0,inf
33506,57,11,68,0,inf
33507,55,6,61,0,inf
33508,51,12,63,0,inf
33509,52,10,62,0,inf
33510,62,11,73,0,inf
33511,62,10,72,0,inf
33512,59,7,66,0,inf
33513,57,10,67,1,2.0454754318446007
33514,53,5,58,0,inf
33515,56,7,63,0,inf
33516,62,7,69,0,inf
33517,54,9,63,0,inf
33518,63,11,74,0,inf
33519,50,8,58,0,inf
33520,65,13,78,0,inf
33521,55,6,61,0,inf
33522,65,9,74,0,inf
33523,54,11,65,0,inf
33524,50,12,62,0,inf
33525,58,10,68,0,inf
33526,51,9,60,0,inf
33527,52,8,60,0,inf
33528,54,10,64,0,inf
33529,57,5,62,0,inf
33530,63,10,73,0,inf
33531,53,7,60,0,inf
33532,67,13,80,0,inf
33533,62,7,69,0,inf
33534,62,12,74,0,inf
33535,59,8,67,0,inf
33536,54,9,63,0,inf
33537,64,13,77,0,inf
33538,61,5,66,0,inf
33539,56,12,68,1,7.676500277308364
33540,65,5,70,0,inf
33541,50,7,57,0,inf
33542,53,8,61,0,inf
33543,56,12,68,0,inf
33544,59,5,64,0,inf
33545,64,6,70,0,inf
33546,63,7,70,0,inf
33547,65,8,73,0,inf
33548,57,5,62,0,inf
33549,59,9,68,0,inf
33550,57,10,67,0,inf
33551,60,10,70,0,inf
33552,65,11,76,0,inf
33553,53,10,63,0,inf
33554,67,9,76,0,inf
33555,64,11,75,0,inf
33556,52,7,59,0,inf
33557,61,7,68,0,inf
33558,51,5,56,0,inf
33559,60,8,68,0,inf
33560,51,9,60,0,inf
33561,57,8,65,0,inf
33562,51,6,57,0,inf
33563,54,7,61,0,inf
33564,65,9,74,0,inf
33565,59,12,71,0,inf
33566,54,8,62,0,inf
33567,55,5,60,0,inf
33568,50,6,56,0,inf
33569,64,6,70,0,inf
33570,66,11,77,0,inf
33571,59,5,64,0,inf
33572,63,13,76,0,inf
33573,55,7,62,0,inf
33574,60,13,73,0,inf
33575,56,6,62,0,inf
33576,67,5,72,0,inf
33577,66,10,76,0,inf
33578,52,13,65,0,inf
33579,58,6,64,0,inf
33580,58,11,69,0,inf
33581,55,5,60,0,inf
33582,58,6,64,0,inf
33583,53,6,59,0,inf
33584,58,10,68,0,inf
33585,50,9,59,0,inf
33586,62,7,69,0,inf
33587,62,8,70,0,inf
33588,59,9,68,0,inf
33589,54,6,60,0,inf
33590,60,9,69,0,inf
33591,56,7,63,0,inf
33592,65,12,77,0,inf
33593,56,6,62,0,inf
33594,65,8,73,0,inf
33595,53,6,59,0,inf
33596,50,9,59,0,inf
33597,55,13,68,0,inf
33598,61,11,72,0,inf
33599,60,7,67,0,inf
33600,51,9,60,0,inf
33601,55,13,68,0,inf
33602,60,10,70,0,inf
33603,64,13,77,0,inf
33604,52,11,63,1,6.559226954338996
33605,58,11,69,0,inf
33606,56,7,63,0,inf
33607,57,11,68,0,inf
33608,51,13,64,0,inf
33609,60,8,68,0,inf
33610,51,12,63,0,inf
33611,54,10,64,0,inf
33612,55,9,64,0,inf
33613,54,6,60,0,inf
33614,52,5,57,0,inf
33615,52,9,61,0,inf
33616,67,9,76,0,inf
33617,59,5,64,0,inf
33618,50,10,60,0,inf
33619,61,8,69,0,inf
33620,66,7,73,0,inf
33621,53,13,66,0,inf
33622,66,7,73,0,inf
33623,60,7,67,0,inf
33624,64,12,76,0,inf
33625,50,13,63,0,inf
33626,52,13,65,0,inf
33627,56,6,62,0,inf
33628,66,11,77,0,inf
33629,60,5,65,0,inf
33630,60,8,68,0,inf
33631,67,9,76,0,inf
33632,51,5,56,0,inf
33633,50,12,62,0,inf
33634,61,12,73,0,inf
33635,58,10,68,0,inf
33636,55,6,61,0,inf
33637,65,10,75,0,inf
33638,65,11,76,0,inf
33639,59,7,66,0,inf
33640,54,8,62,0,inf
33641,56,13,69,0,inf
33642,56,8,64,0,inf
33643,62,7,69,0,inf
33644,56,10,66,0,inf
33645,57,11,68,0,inf
33646,62,9,71,0,inf
33647,55,7,62,0,inf
33648,55,5,60,0,inf
33649,66,8,74,0,inf
33650,64,6,70,0,inf
33651,64,12,76,0,inf
33652,61,9,70,0,inf
33653,52,11,63,0,inf
33654,58,12,70,0,inf
33655,61,7,68,0,inf
33656,51,10,61,0,inf
33657,62,6,68,0,inf
33658,59,7,66,0,inf
33659,62,7,69,0,inf
33660,50,10,60,0,inf
33661,66,12,78,1,6.875678408433188
33662,51,13,64,0,inf
33663,59,11,70,0,inf
33664,67,12,79,1,8.69843356557719
33665,61,12,73,0,inf
33666,52,8,60,0,inf
33667,55,9,64,0,inf
33668,60,11,71,0,inf
33669,66,10,76,0,inf
33670,50,7,57,0,inf
33671,54,7,61,0,inf
33672,55,11,66,0,inf
33673,67,10,77,0,inf
33674,66,12,78,0,inf
33675,65,5,70,0,inf
33676,56,5,61,0,inf
33677,58,13,71,0,inf
33678,55,7,62,0,inf
33679,50,8,58,0,inf
33680,54,10,64,0,inf
33681,58,11,69,0,inf
33682,50,5,55,0,inf
33683,66,6,72,0,inf
33684,58,10,68,0,inf
33685,64,9,73,0,inf
33686,64,6,70,0,inf
33687,50,9,59,0,inf
33688,55,9,64,0,inf
33689,65,12,77,0,inf
33690,51,8,59,0,inf
33691,52,5,57,0,inf
33692,67,7,74,0,inf
33693,64,8,72,0,inf
33694,61,5,66,0,inf
33695,64,9,73,0,inf
33696,50,9,59,0,inf
33697,57,5,62,0,inf
33698,51,10,61,0,inf
33699,53,6,59,0,inf
33700,66,9,75,0,inf
33701,65,11,76,0,inf
33702,55,9,64,0,inf
33703,50,12,62,0,inf
33704,60,6,66,0,inf
33705,53,11,64,0,inf
33706,51,13,64,0,inf
33707,57,5,62,0,inf
33708,58,5,63,0,inf
33709,57,6,63,0,inf
33710,64,5,69,0,inf
33711,64,6,70,0,inf
33712,56,13,69,0,inf
33713,58,6,64,0,inf
33714,56,7,63,0,inf
33715,50,11,61,0,inf
33716,58,9,67,0,inf
33717,67,5,72,0,inf
33718,61,7,68,0,inf
33719,64,13,77,0,inf
33720,58,12,70,0,inf
33721,53,10,63,0,inf
33722,58,8,66,0,inf
33723,52,13,65,0,inf
33724,52,11,63,0,inf
33725,56,9,65,0,inf
33726,64,11,75,0,inf
33727,65,6,71,0,inf
33728,57,12,69,0,inf
33729,58,13,71,0,inf
33730,60,9,69,0,inf
33731,67,9,76,0,inf
33732,63,11,74,0,inf
33733,56,8,64,1,0.6430671287395455
33734,63,6,69,0,inf
33735,60,6,66,0,inf
33736,50,5,55,0,inf
33737,54,12,66,0,inf
33738,52,10,62,0,inf
33739,53,9,62,0,inf
33740,67,7,74,0,inf
33741,67,6,73,0,inf
33742,50,6,56,0,inf
33743,67,7,74,0,inf
33744,64,5,69,0,inf
33745,50,5,55,0,inf
33746,62,7,69,1,5.195737434391091
33747,61,6,67,0,inf
33748,54,13,67,0,inf
33749,64,6,70,0,inf
33750,66,13,79,0,inf
33751,66,6,72,0,inf
33752,61,5,66,0,inf
33753,55,13,68,1,12.71311042403643
33754,55,5,60,0,inf
33755,57,11,68,0,inf
33756,55,13,68,0,inf
33757,67,5,72,0,inf
33758,51,9,60,0,inf
33759,61,7,68,0,inf
33760,53,12,65,0,inf
33761,65,5,70,0,inf
33762,54,8,62,0,inf
33763,66,8,74,0,inf
33764,58,8,66,0,inf
33765,56,8,64,0,inf
33766,52,8,60,0,inf
33767,61,10,71,0,inf
33768,56,8,64,0,inf
33769,62,8,70,0,inf
33770,61,11,72,0,inf
33771,57,8,65,0,inf
33772,67,10,77,0,inf
33773,63,12,75,0,inf
33774,67,8,75,0,inf
33775,59,10,69,0,inf
33776,52,9,61,0,inf
33777,51,7,58,0,inf
33778,59,8,67,0,inf
33779,53,7,60,0,inf
33780,57,12,69,0,inf
33781,50,8,58,0,inf
33782,55,11,66,0,inf
33783,51,12,63,0,inf
33784,65,7,72,0,inf
33785,59,9,68,0,inf
33786,64,11,75,0,inf
33787,64,10,74,0,inf
33788,61,11,72,0,inf
33789,62,7,69,0,inf
33790,53,9,62,0,inf
33791,63,5,68,0,inf
33792,52,9,61,0,inf
33793,50,5,55,0,inf
33794,63,7,70,0,inf
33795,50,5,55,0,inf
33796,50,10,60,0,inf
33797,64,9,73,0,inf
33798,66,9,75,0,inf
33799,54,13,67,0,inf
33800,53,9,62,0,inf
33801,51,7,58,0,inf
33802,58,6,64,0,inf
33803,66,6,72,0,inf
33804,60,10,70,0,inf
33805,58,12,70,0,inf
33806,67,6,73,0,inf
33807,51,7,58,0,inf
33808,50,13,63,0,inf
33809,52,5,57,0,inf
33810,66,9,75,0,inf
33811,52,9,61,0,inf
33812,59,12,71,0,inf
33813,61,12,73,0,inf
33814,63,11,74,0,inf
33815,55,10,65,0,inf
33816,55,13,68,0,inf
33817,65,8,73,0,inf
33818,67,5,72,0,inf
33819,59,12,71,0,inf
33820,65,8,73,0,inf
33821,51,9,60,0,inf
33822,52,8,60,0,inf
33823,59,8,67,0,inf
33824,60,13,73,0,inf
33825,63,11,74,0,inf
33826,54,13,67,0,inf
33827,59,11,70,0,inf
33828,59,6,65,0,inf
33829,57,6,63,0,inf
33830,56,5,61,0,inf
33831,66,8,74,0,inf
33832,63,7,70,0,inf
33833,67,9,76,0,inf
33834,64,9,73,0,inf
33835,57,5,62,0,inf
33836,62,10,72,0,inf
33837,64,12,76,0,inf
33838,66,6,72,0,inf
33839,63,7,70,0,inf
33840,52,11,63,0,inf
33841,54,6,60,0,inf
33842,57,13,70,0,inf
33843,52,11,63,0,inf
33844,62,5,67,0,inf
33845,67,5,72,0,inf
33846,54,8,62,0,inf
33847,63,12,75,0,inf
33848,54,13,67,0,inf
33849,57,7,64,0,inf
33850,60,7,67,0,inf
33851,66,9,75,0,inf
33852,60,8,68,0,inf
33853,64,13,77,0,inf
33854,63,11,74,0,inf
33855,51,11,62,0,inf
33856,58,12,70,0,inf
33857,50,7,57,0,inf
33858,52,9,61,0,inf
33859,53,6,59,0,inf
33860,58,7,65,0,inf
33861,65,7,72,0,inf
33862,60,8,68,0,inf
33863,59,5,64,0,inf
33864,66,5,71,0,inf
33865,63,5,68,0,inf
33866,50,11,61,0,inf
33867,53,10,63,0,inf
33868,60,10,70,0,inf
33869,57,6,63,0,inf
33870,59,13,72,0,inf
33871,67,12,79,0,inf
33872,59,9,68,0,inf
33873,65,13,78,0,inf
33874,51,7,58,0,inf
33875,60,10,70,0,inf
33876,56,9,65,0,inf
33877,59,11,70,0,inf
33878,63,8,71,0,inf
33879,63,10,73,0,inf
33880,51,11,62,0,inf
33881,63,13,76,0,inf
33882,55,13,68,0,inf
33883,64,8,72,0,inf
33884,51,11,62,0,inf
33885,66,7,73,0,inf
33886,57,9,66,0,inf
33887,58,13,71,0,inf
33888,57,10,67,0,inf
33889,61,5,66,0,inf
33890,60,8,68,0,inf
33891,59,12,71,0,inf
33892,60,6,66,0,inf
33893,53,8,61,0,inf
33894,58,7,65,0,inf
33895,51,11,62,0,inf
33896,53,10,63,0,inf
33897,53,12,65,0,inf
33898,58,10,68,0,inf
33899,54,7,61,0,inf
33900,55,10,65,0,inf
33901,65,6,71,0,inf
33902,62,13,75,0,inf
33903,52,9,61,0,inf
33904,60,5,65,0,inf
33905,58,7,65,0,inf
33906,65,9,74,0,inf
33907,57,5,62,0,inf
33908,57,8,65,1,4.619790995075519
33909,65,9,74,0,inf
33910,58,11,69,0,inf
33911,52,13,65,0,inf
33912,51,9,60,0,inf
33913,64,8,72,0,inf
33914,57,10,67,0,inf
33915,60,6,66,0,inf
33916,63,8,71,1,4.607171849970086
33917,58,13,71,0,inf
33918,65,5,70,0,inf
33919,58,13,71,0,inf
33920,64,13,77,0,inf
33921,54,9,63,0,inf
33922,57,10,67,0,inf
33923,62,9,71,1,3.06588626752432
33924,52,5,57,0,inf
33925,50,8,58,0,inf
33926,55,13,68,0,inf
33927,51,6,57,0,inf
33928,60,10,70,0,inf
33929,63,11,74,0,inf
33930,56,11,67,0,inf
33931,51,5,56,0,inf
33932,54,12,66,0,inf
33933,59,9,68,0,inf
33934,67,7,74,0,inf
33935,63,11,74,0,inf
33936,59,5,64,0,inf
33937,50,5,55,0,inf
33938,51,6,57,0,inf
33939,67,8,75,0,inf
33940,66,7,73,0,inf
33941,66,11,77,0,inf
33942,55,11,66,0,inf
33943,51,8,59,0,inf
33944,53,7,60,0,inf
33945,55,8,63,0,inf
33946,58,7,65,0,inf
33947,66,7,73,0,inf
33948,67,6,73,0,inf
33949,65,6,71,0,inf
33950,66,9,75,0,inf
33951,60,5,65,0,inf
33952,58,10,68,0,inf
33953,51,13,64,0,inf
33954,54,10,64,0,inf
33955,63,10,73,0,inf
33956,60,11,71,0,inf
33957,66,13,79,0,inf
33958,57,10,67,0,inf
33959,60,5,65,0,inf
33960,60,10,70,0,inf
33961,51,5,56,0,inf
33962,60,8,68,0,inf
33963,63,12,75,0,inf
33964,63,11,74,0,inf
33965,52,8,60,0,inf
33966,54,9,63,0,inf
33967,64,10,74,0,inf
33968,56,13,69,0,inf
33969,61,7,68,0,inf
33970,64,7,71,0,inf
33971,51,6,57,0,inf
33972,62,12,74,0,inf
33973,50,9,59,0,inf
33974,61,13,74,0,inf
33975,52,9,61,0,inf
33976,67,13,80,0,inf
33977,52,11,63,0,inf
33978,55,13,68,0,inf
33979,58,5,63,0,inf
33980,52,10,62,0,inf
33981,62,6,68,0,inf
33982,67,11,78,0,inf
33983,57,5,62,0,inf
33984,50,12,62,0,inf
33985,56,11,67,0,inf
33986,66,9,75,0,inf
33987,58,6,64,0,inf
33988,57,11,68,0,inf
33989,60,8,68,0,inf
33990,54,13,67,0,inf
33991,57,8,65,0,inf
33992,64,9,73,0,inf
33993,55,11,66,1,4.357831950140621
33994,56,7,63,0,inf
33995,55,13,68,0,inf
33996,66,7,73,0,inf
33997,54,8,62,0,inf
33998,60,10,70,0,inf
33999,62,7,69,0,inf
34000,50,13,63,0,inf
34001,62,11,73,0,inf
34002,58,7,65,0,inf
34003,56,11,67,0,inf
34004,57,11,68,0,inf
34005,54,8,62,1,4.884970705796398
34006,64,7,71,0,inf
34007,50,13,63,0,inf
34008,54,9,63,0,inf
34009,51,7,58,0,inf
34010,54,9,63,0,inf
34011,59,13,72,0,inf
34012,54,13,67,0,inf
34013,58,7,65,1,1.203089911304275
34014,57,8,65,0,inf
34015,50,6,56,0,inf
34016,57,8,65,0,inf
34017,54,9,63,0,inf
34018,60,12,72,0,inf
34019,51,10,61,0,inf
34020,64,8,72,0,inf
34021,62,10,72,0,inf
34022,59,8,67,0,inf
34023,64,7,71,0,inf
34024,66,13,79,0,inf
34025,59,13,72,0,inf
34026,50,13,63,0,inf
34027,54,10,64,0,inf
34028,63,7,70,0,inf
34029,64,8,72,0,inf
34030,61,9,70,0,inf
34031,66,12,78,0,inf
34032,55,7,62,0,inf
34033,65,8,73,0,inf
34034,55,8,63,0,inf
34035,50,13,63,0,inf
34036,64,9,73,0,inf
34037,56,6,62,0,inf
34038,61,12,73,0,inf
34039,60,13,73,0,inf
34040,55,10,65,0,inf
34041,60,13,73,0,inf
34042,66,8,74,0,inf
34043,50,10,60,0,inf
34044,61,9,70,0,inf
34045,51,9,60,0,inf
34046,67,9,76,0,inf
34047,62,12,74,0,inf
34048,59,12,71,0,inf
34049,66,11,77,0,inf
34050,54,12,66,0,inf
34051,58,13,71,0,inf
34052,67,9,76,0,inf
34053,63,9,72,0,inf
34054,54,6,60,1,3.3743072428299
34055,50,10,60,0,inf
34056,57,12,69,0,inf
34057,62,5,67,0,inf
34058,66,5,71,0,inf
34059,61,9,70,0,inf
34060,51,6,57,0,inf
34061,61,8,69,0,inf
34062,67,10,77,0,inf
34063,61,11,72,0,inf
34064,64,7,71,0,inf
34065,65,10,75,0,inf
34066,66,9,75,0,inf
34067,67,6,73,0,inf
34068,59,13,72,0,inf
34069,58,10,68,0,inf
34070,52,5,57,0,inf
34071,67,6,73,0,inf
34072,54,13,67,0,inf
34073,50,12,62,0,inf
34074,53,7,60,1,2.1133403513523206
34075,58,13,71,0,inf
34076,55,7,62,0,inf
34077,55,7,62,0,inf
34078,67,5,72,0,inf
34079,55,7,62,0,inf
34080,57,10,67,0,inf
34081,56,9,65,0,inf
34082,53,9,62,0,inf
34083,60,5,65,0,inf
34084,66,9,75,0,inf
34085,67,12,79,0,inf
34086,53,12,65,0,inf
34087,52,11,63,0,inf
34088,57,13,70,0,inf
34089,64,12,76,0,inf
34090,67,5,72,0,inf
34091,64,5,69,0,inf
34092,55,13,68,0,inf
34093,63,7,70,0,inf
34094,66,7,73,0,inf
34095,57,8,65,0,inf
34096,63,13,76,0,inf
34097,62,5,67,0,inf
34098,61,7,68,0,inf
34099,66,11,77,0,inf
34100,65,8,73,0,inf
34101,51,8,59,0,inf
34102,59,12,71,0,inf
34103,60,5,65,0,inf
34104,61,9,70,0,inf
34105,61,9,70,0,inf
34106,65,12,77,0,inf
34107,52,7,59,0,inf
34108,61,5,66,0,inf
34109,66,12,78,0,inf
34110,55,9,64,0,inf
34111,60,13,73,0,inf
34112,60,6,66,0,inf
34113,67,7,74,0,inf
34114,50,12,62,0,inf
34115,65,5,70,0,inf
34116,51,7,58,1,6.415620975516241
34117,60,13,73,0,inf
34118,56,12,68,0,inf
34119,58,12,70,0,inf
34120,51,9,60,0,inf
34121,54,11,65,0,inf
34122,58,11,69,0,inf
34123,67,13,80,0,inf
34124,61,9,70,0,inf
34125,57,6,63,0,inf
34126,56,9,65,0,inf
34127,58,11,69,0,inf
34128,61,11,72,0,inf
34129,53,7,60,0,inf
34130,56,10,66,0,inf
34131,57,12,69,0,inf
34132,60,8,68,0,inf
34133,64,11,75,1,4.316571767256804
34134,57,12,69,0,inf
34135,50,10,60,0,inf
34136,52,6,58,0,inf
34137,61,6,67,0,inf
34138,66,13,79,0,inf
34139,63,12,75,0,inf
34140,59,5,64,0,inf
34141,60,8,68,0,inf
34142,53,9,62,0,inf
34143,58,6,64,0,inf
34144,66,7,73,0,inf
34145,65,7,72,0,inf
34146,55,7,62,0,inf
34147,57,10,67,0,inf
34148,55,7,62,0,inf
34149,65,6,71,0,inf
34150,51,13,64,0,inf
34151,54,11,65,0,inf
34152,52,8,60,0,inf
34153,59,10,69,0,inf
34154,56,13,69,0,inf
34155,63,8,71,0,inf
34156,64,10,74,0,inf
34157,62,10,72,0,inf
34158,59,7,66,0,inf
34159,67,11,78,0,inf
34160,51,13,64,0,inf
34161,59,13,72,0,inf
34162,66,9,75,0,inf
34163,61,13,74,0,inf
34164,50,7,57,0,inf
34165,60,12,72,0,inf
34166,58,11,69,0,inf
34167,55,12,67,0,inf
34168,55,8,63,0,inf
34169,54,11,65,0,inf
34170,59,13,72,0,inf
34171,52,7,59,0,inf
34172,62,9,71,0,inf
34173,61,5,66,0,inf
34174,54,7,61,0,inf
34175,59,8,67,0,inf
34176,50,11,61,0,inf
34177,58,7,65,0,inf
34178,59,6,65,0,inf
34179,66,12,78,0,inf
34180,56,5,61,0,inf
34181,66,8,74,0,inf
34182,65,9,74,0,inf
34183,55,10,65,0,inf
34184,67,8,75,0,inf
34185,61,11,72,0,inf
34186,66,7,73,0,inf
34187,51,8,59,0,inf
34188,59,11,70,0,inf
34189,64,10,74,0,inf
34190,64,5,69,0,inf
34191,62,10,72,0,inf
34192,67,11,78,0,inf
34193,63,7,70,0,inf
34194,56,5,61,0,inf
34195,63,7,70,0,inf
34196,59,9,68,0,inf
34197,54,10,64,0,inf
34198,50,8,58,0,inf
34199,66,10,76,0,inf
34200,56,8,64,0,inf
34201,56,8,64,0,inf
34202,63,11,74,0,inf
34203,59,12,71,0,inf
34204,56,5,61,0,inf
34205,59,11,70,0,inf
34206,61,9,70,0,inf
34207,52,7,59,0,inf
34208,56,13,69,0,inf
34209,60,9,69,0,inf
34210,58,12,70,0,inf
34211,50,10,60,0,inf
34212,53,6,59,0,inf
34213,67,6,73,0,inf
34214,62,7,69,0,inf
34215,56,12,68,0,inf
34216,52,8,60,0,inf
34217,66,10,76,0,inf
34218,66,8,74,0,inf
34219,59,9,68,0,inf
34220,52,6,58,0,inf
34221,51,5,56,0,inf
34222,50,5,55,0,inf
34223,58,7,65,0,inf
34224,60,7,67,0,inf
34225,50,9,59,0,inf
34226,51,5,56,0,inf
34227,53,12,65,0,inf
34228,67,7,74,0,inf
34229,64,7,71,1,1.134755616951665
34230,58,13,71,0,inf
34231,54,9,63,0,inf
34232,55,13,68,0,inf
34233,67,10,77,0,inf
34234,55,13,68,0,inf
34235,61,7,68,0,inf
34236,55,6,61,0,inf
34237,64,11,75,0,inf
34238,57,8,65,0,inf
34239,50,8,58,0,inf
34240,54,9,63,0,inf
34241,51,6,57,0,inf
34242,63,8,71,0,inf
34243,51,8,59,0,inf
34244,66,6,72,0,inf
34245,54,7,61,0,inf
34246,66,11,77,0,inf
34247,53,5,58,0,inf
34248,67,11,78,0,inf
34249,65,11,76,0,inf
34250,60,6,66,0,inf
34251,55,11,66,0,inf
34252,61,12,73,0,inf
34253,65,10,75,0,inf
34254,61,6,67,0,inf
34255,67,8,75,0,inf
34256,54,8,62,0,inf
34257,66,8,74,0,inf
34258,62,8,70,0,inf
34259,53,11,64,0,inf
34260,55,7,62,0,inf
34261,63,8,71,0,inf
34262,60,7,67,0,inf
34263,65,12,77,0,inf
34264,59,10,69,0,inf
34265,53,8,61,0,inf
34266,64,8,72,0,inf
34267,54,9,63,0,inf
34268,67,11,78,0,inf
34269,67,9,76,0,inf
34270,62,7,69,0,inf
34271,52,8,60,0,inf
34272,57,9,66,0,inf
34273,62,9,71,0,inf
34274,59,5,64,0,inf
34275,58,8,66,0,inf
34276,64,10,74,0,inf
34277,51,7,58,0,inf
34278,56,6,62,0,inf
34279,55,10,65,0,inf
34280,64,5,69,0,inf
34281,65,9,74,0,inf
34282,55,7,62,0,inf
34283,65,10,75,0,inf
34284,64,6,70,0,inf
34285,55,5,60,0,inf
34286,54,6,60,0,inf
34287,58,6,64,0,inf
34288,52,11,63,0,inf
34289,65,13,78,0,inf
34290,60,7,67,0,inf
34291,65,12,77,0,inf
34292,50,13,63,0,inf
34293,51,13,64,0,inf
34294,57,9,66,1,7.7253256531221695
34295,67,7,74,0,inf
34296,65,13,78,0,inf
34297,62,9,71,0,inf
34298,55,9,64,0,inf
34299,63,12,75,0,inf
34300,58,11,69,0,inf
34301,56,11,67,0,inf
34302,58,12,70,0,inf
34303,61,9,70,0,inf
34304,54,7,61,0,inf
34305,54,13,67,0,inf
34306,51,8,59,0,inf
34307,63,12,75,0,inf
34308,56,5,61,0,inf
34309,51,11,62,0,inf
34310,59,11,70,0,inf
34311,60,9,69,0,inf
34312,50,6,56,0,inf
34313,55,5,60,0,inf
34314,55,8,63,0,inf
34315,56,10,66,0,inf
34316,63,11,74,0,inf
34317,59,10,69,0,inf
34318,54,11,65,0,inf
34319,59,8,67,0,inf
34320,64,12,76,0,inf
34321,58,6,64,0,inf
34322,64,5,69,0,inf
34323,59,10,69,0,inf
34324,63,7,70,0,inf
34325,54,5,59,0,inf
34326,59,6,65,0,inf
34327,59,5,64,0,inf
34328,56,5,61,0,inf
34329,66,8,74,0,inf
34330,53,9,62,0,inf
34331,66,13,79,0,inf
34332,66,9,75,0,inf
34333,66,13,79,0,inf
34334,56,9,65,0,inf
34335,50,9,59,1,8.329658633298457
34336,64,13,77,0,inf
34337,63,8,71,0,inf
34338,61,11,72,0,inf
34339,61,13,74,0,inf
34340,56,13,69,0,inf
34341,62,5,67,0,inf
34342,56,6,62,0,inf
34343,54,5,59,0,inf
34344,57,6,63,0,inf
34345,66,10,76,0,inf
34346,66,10,76,0,inf
34347,63,6,69,0,inf
34348,64,12,76,1,8.719574725237663
34349,63,11,74,0,inf
34350,60,9,69,0,inf
34351,60,11,71,0,inf
34352,61,7,68,0,inf
34353,66,5,71,0,inf
34354,54,6,60,0,inf
34355,50,5,55,0,inf
34356,65,10,75,0,inf
34357,56,11,67,0,inf
34358,57,10,67,0,inf
34359,55,10,65,0,inf
34360,53,6,59,0,inf
34361,66,11,77,0,inf
34362,57,5,62,0,inf
34363,55,10,65,0,inf
34364,59,5,64,0,inf
34365,60,12,72,0,inf
34366,59,10,69,0,inf
34367,50,8,58,0,inf
34368,57,10,67,0,inf
34369,66,5,71,0,inf
34370,65,6,71,0,inf
34371,65,10,75,0,inf
34372,55,12,67,0,inf
34373,60,9,69,0,inf
34374,66,11,77,0,inf
34375,66,10,76,0,inf
34376,60,8,68,0,inf
34377,58,6,64,0,inf
34378,50,8,58,0,inf
34379,56,9,65,0,inf
34380,59,5,64,0,inf
34381,52,10,62,0,inf
34382,61,13,74,0,inf
34383,51,8,59,0,inf
34384,67,8,75,0,inf
34385,50,10,60,0,inf
34386,56,7,63,0,inf
34387,60,5,65,1,4.246542930358444
34388,55,10,65,0,inf
34389,50,8,58,0,inf
34390,60,13,73,0,inf
34391,56,9,65,0,inf
34392,63,9,72,0,inf
34393,50,10,60,0,inf
34394,57,10,67,0,inf
34395,65,11,76,0,inf
34396,61,13,74,0,inf
34397,64,7,71,0,inf
34398,54,10,64,0,inf
34399,59,6,65,0,inf
34400,55,13,68,0,inf
34401,64,5,69,0,inf
34402,66,11,77,0,inf
34403,50,11,61,0,inf
34404,63,7,70,0,inf
34405,65,8,73,1,2.369381626302797
34406,54,7,61,0,inf
34407,66,6,72,0,inf
34408,54,12,66,0,inf
34409,62,8,70,0,inf
34410,58,5,63,0,inf
34411,56,7,63,0,inf
34412,66,12,78,0,inf
34413,67,11,78,0,inf
34414,50,11,61,0,inf
34415,50,5,55,0,inf
34416,66,12,78,0,inf
34417,54,6,60,0,inf
34418,54,13,67,0,inf
34419,61,8,69,0,inf
34420,56,10,66,0,inf
34421,65,12,77,0,inf
34422,56,9,65,0,inf
34423,60,6,66,0,inf
34424,53,5,58,0,inf
34425,51,12,63,0,inf
34426,65,12,77,0,inf
34427,51,9,60,0,inf
34428,55,9,64,0,inf
34429,65,11,76,0,inf
34430,66,5,71,0,inf
34431,65,8,73,0,inf
34432,66,8,74,0,inf
34433,66,10,76,0,inf
34434,55,10,65,0,inf
34435,54,10,64,0,inf
34436,56,11,67,0,inf
34437,59,8,67,0,inf
34438,53,13,66,0,inf
34439,51,5,56,0,inf
34440,60,13,73,0,inf
34441,53,5,58,0,inf
34442,64,8,72,0,inf
34443,61,12,73,0,inf
34444,65,11,76,0,inf
34445,66,7,73,0,inf
34446,55,12,67,0,inf
34447,58,13,71,0,inf
34448,50,11,61,0,inf
34449,61,13,74,0,inf
34450,65,11,76,0,inf
34451,55,9,64,0,inf
34452,55,7,62,0,inf
34453,59,7,66,0,inf
34454,52,8,60,0,inf
34455,51,10,61,0,inf
34456,63,8,71,1,2.4905389320963423
34457,66,11,77,0,inf
34458,67,10,77,0,inf
34459,55,13,68,0,inf
34460,62,8,70,0,inf
34461,50,6,56,0,inf
34462,51,9,60,0,inf
34463,60,10,70,0,inf
34464,61,7,68,0,inf
34465,63,5,68,0,inf
34466,62,6,68,0,inf
34467,67,9,76,0,inf
34468,60,9,69,0,inf
34469,54,8,62,0,inf
34470,54,13,67,0,inf
34471,57,13,70,0,inf
34472,56,11,67,0,inf
34473,58,9,67,0,inf
34474,59,12,71,0,inf
34475,54,11,65,0,inf
34476,56,13,69,0,inf
34477,55,9,64,0,inf
34478,67,13,80,0,inf
34479,50,6,56,0,inf
34480,66,5,71,0,inf
34481,58,6,64,0,inf
34482,66,12,78,0,inf
34483,51,7,58,0,inf
34484,65,7,72,0,inf
34485,66,10,76,0,inf
34486,62,13,75,0,inf
34487,59,13,72,0,inf
34488,61,12,73,0,inf
34489,58,5,63,0,inf
34490,67,11,78,0,inf
34491,57,8,65,0,inf
34492,54,8,62,0,inf
34493,57,12,69,0,inf
34494,59,12,71,0,inf
34495,56,6,62,0,inf
34496,60,9,69,1,5.640427212151735
34497,55,9,64,0,inf
34498,67,6,73,0,inf
34499,55,11,66,0,inf
34500,66,13,79,0,inf
34501,64,10,74,0,inf
34502,63,12,75,1,9.675425313635486
34503,64,8,72,0,inf
34504,61,7,68,1,1.8938326295723584
34505,51,7,58,0,inf
34506,56,7,63,1,5.341138232050703
34507,57,6,63,0,inf
34508,65,8,73,0,inf
34509,60,11,71,0,inf
34510,62,13,75,0,inf
34511,66,13,79,0,inf
34512,59,11,70,0,inf
34513,67,5,72,0,inf
34514,51,5,56,0,inf
34515,51,7,58,0,inf
34516,55,12,67,0,inf
34517,55,9,64,0,inf
34518,66,11,77,0,inf
34519,56,10,66,0,inf
34520,54,11,65,0,inf
34521,59,9,68,0,inf
34522,53,10,63,0,inf
34523,57,6,63,0,inf
34524,64,12,76,0,inf
34525,52,5,57,0,inf
34526,54,11,65,0,inf
34527,61,6,67,0,inf
34528,57,8,65,0,inf
34529,56,8,64,0,inf
34530,67,11,78,0,inf
34531,53,12,65,0,inf
34532,65,13,78,0,inf
34533,66,11,77,0,inf
34534,63,7,70,0,inf
34535,65,11,76,0,inf
34536,51,10,61,0,inf
34537,57,9,66,0,inf
34538,50,9,59,0,inf
34539,67,8,75,0,inf
34540,67,12,79,0,inf
34541,51,13,64,0,inf
34542,59,9,68,0,inf
34543,57,6,63,0,inf
34544,58,11,69,0,inf
34545,62,5,67,0,inf
34546,61,5,66,0,inf
34547,52,11,63,0,inf
34548,66,7,73,0,inf
34549,67,9,76,0,inf
34550,66,12,78,0,inf
34551,58,7,65,0,inf
34552,62,5,67,0,inf
34553,54,13,67,0,inf
34554,57,10,67,0,inf
34555,62,11,73,0,inf
34556,64,6,70,0,inf
34557,57,13,70,0,inf
34558,67,11,78,0,inf
34559,65,10,75,0,inf
34560,61,12,73,0,inf
34561,57,7,64,0,inf
34562,60,6,66,0,inf
34563,51,9,60,1,6.653323908099402
34564,66,10,76,0,inf
34565,65,9,74,0,inf
34566,62,13,75,0,inf
34567,53,10,63,0,inf
34568,51,9,60,0,inf
34569,63,13,76,0,inf
34570,65,6,71,0,inf
34571,67,7,74,0,inf
34572,57,7,64,0,inf
34573,57,8,65,0,inf
34574,52,11,63,0,inf
34575,61,10,71,0,inf
34576,62,12,74,0,inf
34577,54,10,64,0,inf
34578,61,11,72,0,inf
34579,60,10,70,0,inf
34580,53,7,60,0,inf
34581,53,13,66,0,inf
34582,58,10,68,0,inf
34583,65,7,72,0,inf
34584,57,10,67,0,inf
34585,64,10,74,0,inf
34586,54,6,60,0,inf
34587,59,5,64,0,inf
34588,52,7,59,0,inf
34589,56,13,69,0,inf
34590,60,13,73,0,inf
34591,55,6,61,0,inf
34592,61,8,69,0,inf
34593,54,5,59,0,inf
34594,58,10,68,0,inf
34595,51,12,63,1,11.7232133369114
34596,67,11,78,0,inf
34597,50,7,57,0,inf
34598,62,9,71,0,inf
34599,60,11,71,0,inf
34600,64,9,73,0,inf
34601,55,10,65,0,inf
34602,57,6,63,0,inf
34603,58,13,71,0,inf
34604,53,8,61,0,inf
34605,56,11,67,0,inf
34606,65,8,73,0,inf
34607,57,13,70,0,inf
34608,67,12,79,0,inf
34609,53,7,60,0,inf
34610,56,12,68,0,inf
34611,52,12,64,0,inf
34612,53,10,63,0,inf
34613,55,10,65,1,4.689671106052813
34614,63,9,72,0,inf
34615,50,11,61,0,inf
34616,58,7,65,0,inf
34617,63,9,72,0,inf
34618,54,8,62,0,inf
34619,53,10,63,0,inf
34620,56,7,63,0,inf
34621,54,7,61,0,inf
34622,62,6,68,0,inf
34623,52,7,59,0,inf
34624,58,12,70,0,inf
34625,62,12,74,0,inf
34626,62,13,75,0,inf
34627,67,11,78,0,inf
34628,56,10,66,0,inf
34629,58,13,71,0,inf
34630,64,7,71,0,inf
34631,60,8,68,0,inf
34632,51,5,56,0,inf
34633,57,8,65,0,inf
34634,53,5,58,0,inf
34635,58,7,65,0,inf
34636,50,11,61,0,inf
34637,62,6,68,0,inf
34638,64,11,75,0,inf
34639,61,6,67,0,inf
34640,65,9,74,0,inf
34641,58,11,69,0,inf
34642,59,10,69,0,inf
34643,50,6,56,0,inf
34644,59,13,72,0,inf
34645,52,11,63,0,inf
34646,61,11,72,0,inf
34647,50,5,55,0,inf
34648,56,5,61,0,inf
34649,61,10,71,0,inf
34650,62,8,70,0,inf
34651,54,6,60,0,inf
34652,50,7,57,0,inf
34653,61,11,72,0,inf
34654,52,13,65,0,inf
34655,62,13,75,0,inf
34656,64,11,75,0,inf
34657,62,5,67,0,inf
34658,54,9,63,0,inf
34659,60,13,73,0,inf
34660,55,9,64,0,inf
34661,62,10,72,0,inf
34662,57,6,63,0,inf
34663,65,5,70,0,inf
34664,56,13,69,0,inf
34665,67,13,80,0,inf
34666,64,6,70,0,inf
34667,51,11,62,0,inf
34668,52,10,62,0,inf
34669,51,10,61,0,inf
34670,58,12,70,0,inf
34671,66,9,75,0,inf
34672,58,13,71,0,inf
34673,54,5,59,0,inf
34674,61,7,68,1,6.7097917147471975
34675,51,9,60,0,inf
34676,52,13,65,0,inf
34677,66,7,73,0,inf
34678,55,11,66,0,inf
34679,54,10,64,0,inf
34680,52,6,58,0,inf
34681,59,13,72,0,inf
34682,54,12,66,0,inf
34683,66,8,74,0,inf
34684,50,7,57,0,inf
34685,53,13,66,0,inf
34686,54,6,60,0,inf
34687,55,13,68,1,5.401192637726297
34688,64,6,70,0,inf
34689,56,12,68,0,inf
34690,65,5,70,0,inf
34691,50,10,60,0,inf
34692,62,10,72,0,inf
34693,65,9,74,0,inf
34694,60,6,66,0,inf
34695,58,12,70,0,inf
34696,52,12,64,0,inf
34697,59,9,68,0,inf
34698,62,5,67,0,inf
34699,67,12,79,0,inf
34700,63,5,68,0,inf
34701,63,11,74,0,inf
34702,64,9,73,0,inf
34703,58,7,65,0,inf
34704,59,13,72,0,inf
34705,62,5,67,0,inf
34706,55,8,63,0,inf
34707,53,10,63,0,inf
34708,64,11,75,0,inf
34709,65,11,76,0,inf
34710,66,12,78,0,inf
34711,65,12,77,0,inf
34712,55,11,66,0,inf
34713,65,7,72,0,inf
34714,64,12,76,0,inf
34715,58,8,66,1,7.7739485128201835
34716,60,9,69,0,inf
34717,54,12,66,0,inf
34718,56,8,64,0,inf
34719,63,6,69,0,inf
34720,50,11,61,0,inf
34721,51,13,64,0,inf
34722,52,13,65,0,inf
34723,61,12,73,0,inf
34724,55,7,62,0,inf
34725,62,9,71,0,inf
34726,57,6,63,0,inf
34727,58,5,63,0,inf
34728,51,7,58,0,inf
34729,61,6,67,0,inf
34730,62,7,69,0,inf
34731,62,8,70,0,inf
34732,55,12,67,0,inf
34733,55,10,65,0,inf
34734,65,9,74,0,inf
34735,57,11,68,0,inf
34736,59,11,70,0,inf
34737,56,13,69,0,inf
34738,62,11,73,0,inf
34739,62,9,71,1,5.141262476707766
34740,62,8,70,0,inf
34741,60,10,70,0,inf
34742,54,9,63,0,inf
34743,61,9,70,0,inf
34744,50,10,60,0,inf
34745,59,12,71,0,inf
34746,66,9,75,0,inf
34747,63,7,70,0,inf
34748,67,8,75,0,inf
34749,54,11,65,0,inf
34750,62,11,73,0,inf
34751,50,11,61,0,inf
34752,55,8,63,0,inf
34753,62,11,73,0,inf
34754,62,12,74,0,inf
34755,63,12,75,0,inf
34756,64,7,71,0,inf
34757,58,12,70,0,inf
34758,57,9,66,0,inf
34759,62,5,67,0,inf
34760,55,11,66,0,inf
34761,65,9,74,0,inf
34762,67,6,73,0,inf
34763,59,11,70,0,inf
34764,58,8,66,0,inf
34765,65,5,70,0,inf
34766,66,12,78,0,inf
34767,62,11,73,0,inf
34768,67,12,79,0,inf
34769,51,5,56,0,inf
34770,58,13,71,0,inf
34771,60,8,68,0,inf
34772,58,13,71,0,inf
34773,62,8,70,0,inf
34774,53,9,62,0,inf
34775,60,12,72,0,inf
34776,61,7,68,0,inf
34777,61,7,68,0,inf
34778,57,12,69,0,inf
34779,55,5,60,0,inf
34780,59,12,71,0,inf
34781,50,8,58,0,inf
34782,51,10,61,0,inf
34783,64,10,74,0,inf
34784,50,12,62,0,inf
34785,66,9,75,0,inf
34786,62,11,73,0,inf
34787,65,10,75,1,1.3803073056885609
34788,56,11,67,0,inf
34789,57,13,70,0,inf
34790,64,12,76,0,inf
34791,54,9,63,0,inf
34792,57,11,68,0,inf
34793,61,13,74,0,inf
34794,51,6,57,0,inf
34795,53,9,62,0,inf
34796,65,6,71,0,inf
34797,52,7,59,0,inf
34798,61,7,68,0,inf
34799,63,7,70,0,inf
34800,61,9,70,0,inf
34801,67,5,72,0,inf
34802,67,7,74,0,inf
34803,65,10,75,0,inf
34804,62,12,74,0,inf
34805,67,10,77,0,inf
34806,57,5,62,0,inf
34807,55,6,61,0,inf
34808,67,13,80,0,inf
34809,67,7,74,0,inf
34810,53,11,64,0,inf
34811,65,13,78,0,inf
34812,64,8,72,0,inf
34813,58,12,70,1,8.241055144248818
34814,67,13,80,0,inf
34815,57,9,66,0,inf
34816,57,9,66,0,inf
34817,52,10,62,0,inf
34818,50,8,58,0,inf
34819,51,8,59,0,inf
34820,61,13,74,1,0.002698794430003204
34821,60,6,66,0,inf
34822,56,9,65,0,inf
34823,55,12,67,0,inf
34824,55,13,68,0,inf
34825,51,10,61,0,inf
34826,58,9,67,0,inf
34827,53,13,66,0,inf
34828,50,7,57,0,inf
34829,57,12,69,0,inf
34830,65,8,73,0,inf
34831,67,8,75,0,inf
34832,54,6,60,0,inf
34833,65,7,72,0,inf
34834,53,8,61,0,inf
34835,50,7,57,0,inf
34836,65,6,71,0,inf
34837,64,5,69,0,inf
34838,53,10,63,0,inf
34839,55,13,68,0,inf
34840,57,10,67,0,inf
34841,50,6,56,0,inf
34842,66,9,75,0,inf
34843,60,12,72,1,4.467531303798367
34844,58,6,64,0,inf
34845,53,6,59,0,inf
34846,56,13,69,0,inf
34847,62,13,75,0,inf
34848,61,6,67,0,inf
34849,65,9,74,0,inf
34850,54,10,64,0,inf
34851,61,9,70,0,inf
34852,64,6,70,0,inf
34853,60,9,69,0,inf
34854,64,13,77,0,inf
34855,64,11,75,0,inf
34856,67,13,80,0,inf
34857,60,10,70,0,inf
34858,51,12,63,0,inf
34859,57,12,69,0,inf
34860,66,12,78,0,inf
34861,66,5,71,0,inf
34862,67,5,72,0,inf
34863,59,7,66,0,inf
34864,51,6,57,0,inf
34865,51,13,64,0,inf
34866,66,8,74,0,inf
34867,59,8,67,0,inf
34868,61,11,72,0,inf
34869,52,10,62,0,inf
34870,51,12,63,0,inf
34871,66,5,71,0,inf
34872,53,6,59,0,inf
34873,55,9,64,0,inf
34874,62,11,73,0,inf
34875,59,12,71,0,inf
34876,56,8,64,0,inf
34877,52,9,61,0,inf
34878,63,9,72,0,inf
34879,55,13,68,0,inf
34880,52,10,62,0,inf
34881,50,12,62,0,inf
34882,57,10,67,0,inf
34883,63,13,76,0,inf
34884,60,12,72,0,inf
34885,63,6,69,0,inf
34886,55,13,68,0,inf
34887,53,5,58,0,inf
34888,66,5,71,0,inf
34889,66,5,71,0,inf
34890,52,9,61,0,inf
34891,66,7,73,0,inf
34892,55,5,60,0,inf
34893,59,7,66,0,inf
34894,63,11,74,0,inf
34895,53,13,66,0,inf
34896,52,7,59,0,inf
34897,59,7,66,0,inf
34898,59,12,71,0,inf
34899,52,7,59,0,inf
34900,61,13,74,0,inf
34901,54,11,65,0,inf
34902,57,10,67,0,inf
34903,67,6,73,0,inf
34904,66,13,79,0,inf
34905,57,9,66,0,inf
34906,59,8,67,0,inf
34907,61,6,67,0,inf
34908,57,5,62,0,inf
34909,61,5,66,0,inf
34910,50,13,63,0,inf
34911,59,10,69,0,inf
34912,56,5,61,0,inf
34913,59,9,68,0,inf
34914,54,6,60,0,inf
34915,54,11,65,0,inf
34916,58,9,67,0,inf
34917,59,6,65,0,inf
34918,64,9,73,0,inf
34919,54,7,61,0,inf
34920,55,12,67,0,inf
34921,55,5,60,0,inf
34922,62,6,68,0,inf
34923,62,9,71,0,inf
34924,52,11,63,0,inf
34925,67,8,75,0,inf
34926,57,12,69,0,inf
34927,65,13,78,0,inf
34928,67,8,75,1,7.714679526206524
34929,53,8,61,0,inf
34930,59,8,67,0,inf
34931,59,12,71,0,inf
34932,64,9,73,0,inf
34933,63,6,69,0,inf
34934,51,13,64,0,inf
34935,54,8,62,0,inf
34936,61,13,74,0,inf
34937,65,6,71,0,inf
34938,55,10,65,0,inf
34939,53,12,65,0,inf
34940,51,10,61,0,inf
34941,55,10,65,0,inf
34942,66,11,77,0,inf
34943,65,7,72,0,inf
34944,52,7,59,0,inf
34945,58,11,69,0,inf
34946,60,8,68,0,inf
34947,64,8,72,0,inf
34948,61,10,71,0,inf
34949,51,9,60,0,inf
34950,57,12,69,0,inf
34951,53,5,58,0,inf
34952,67,9,76,0,inf
34953,66,7,73,0,inf
34954,66,11,77,0,inf
34955,63,10,73,1,4.645205669196656
34956,57,5,62,0,inf
34957,54,11,65,0,inf
34958,51,9,60,0,inf
34959,62,13,75,0,inf
34960,63,12,75,0,inf
34961,55,11,66,0,inf
34962,63,8,71,0,inf
34963,57,8,65,0,inf
34964,60,12,72,0,inf
34965,62,9,71,0,inf
34966,51,10,61,0,inf
34967,61,8,69,0,inf
34968,55,5,60,0,inf
34969,54,13,67,0,inf
34970,55,12,67,0,inf
34971,53,8,61,0,inf
34972,60,12,72,0,inf
34973,56,9,65,0,inf
34974,64,12,76,0,inf
34975,50,13,63,0,inf
34976,58,12,70,0,inf
34977,65,9,74,0,inf
34978,64,8,72,0,inf
34979,55,6,61,0,inf
34980,58,5,63,0,inf
34981,61,5,66,0,inf
34982,60,13,73,0,inf
34983,64,13,77,0,inf
34984,60,6,66,0,inf
34985,51,6,57,0,inf
34986,54,7,61,0,inf
34987,52,7,59,0,inf
34988,66,12,78,0,inf
34989,55,7,62,0,inf
34990,51,10,61,0,inf
34991,59,9,68,0,inf
34992,64,6,70,0,inf
34993,62,7,69,0,inf
34994,63,9,72,0,inf
34995,66,10,76,0,inf
34996,65,11,76,0,inf
34997,61,6,67,0,inf
34998,53,11,64,1,4.336587457993218
34999,55,5,60,0,inf
35000,64,13,77,0,inf
35001,67,13,80,0,inf
35002,56,9,65,0,inf
35003,59,9,68,0,inf
35004,52,5,57,0,inf
35005,56,8,64,0,inf
35006,56,6,62,0,inf
35007,59,11,70,0,inf
35008,55,6,61,0,inf
35009,59,13,72,0,inf
35010,50,13,63,0,inf
35011,63,13,76,0,inf
35012,54,10,64,0,inf
35013,60,12,72,0,inf
35014,54,13,67,0,inf
35015,67,10,77,0,inf
35016,65,7,72,0,inf
35017,66,9,75,0,inf
35018,60,7,67,0,inf
35019,55,12,67,0,inf
35020,55,9,64,0,inf
35021,52,11,63,0,inf
35022,52,12,64,0,inf
35023,58,12,70,0,inf
35024,54,6,60,0,inf
35025,64,11,75,0,inf
35026,66,5,71,0,inf
35027,62,7,69,0,inf
35028,50,12,62,0,inf
35029,50,5,55,0,inf
35030,61,5,66,0,inf
35031,50,12,62,0,inf
35032,57,12,69,0,inf
35033,59,8,67,0,inf
35034,63,6,69,0,inf
35035,61,8,69,0,inf
35036,58,7,65,0,inf
35037,65,13,78,0,inf
35038,67,9,76,0,inf
35039,52,8,60,0,inf
35040,58,10,68,0,inf
35041,57,5,62,0,inf
35042,62,12,74,0,inf
35043,52,11,63,0,inf
35044,61,9,70,0,inf
35045,65,12,77,0,inf
35046,54,11,65,0,inf
35047,50,7,57,0,inf
35048,57,5,62,0,inf
35049,60,11,71,0,inf
35050,51,12,63,0,inf
35051,67,6,73,0,inf
35052,60,10,70,0,inf
35053,54,12,66,0,inf
35054,52,6,58,0,inf
35055,51,10,61,0,inf
35056,65,10,75,0,inf
35057,55,8,63,0,inf
35058,63,12,75,0,inf
35059,56,5,61,0,inf
35060,66,10,76,0,inf
35061,56,6,62,0,inf
35062,66,5,71,0,inf
35063,58,13,71,0,inf
35064,67,8,75,0,inf
35065,67,9,76,0,inf
35066,65,5,70,0,inf
35067,62,5,67,0,inf
35068,55,5,60,0,inf
35069,67,10,77,1,0.9383536263076877
35070,56,7,63,0,inf
35071,67,7,74,0,inf
35072,58,11,69,0,inf
35073,55,6,61,0,inf
35074,52,11,63,0,inf
35075,64,5,69,0,inf
35076,55,7,62,0,inf
35077,62,12,74,1,7.4147549186070165
35078,53,7,60,0,inf
35079,58,7,65,0,inf
35080,54,7,61,0,inf
35081,50,12,62,0,inf
35082,56,13,69,0,inf
35083,62,6,68,0,inf
35084,62,6,68,0,inf
35085,53,7,60,0,inf
35086,66,6,72,0,inf
35087,60,8,68,0,inf
35088,55,11,66,0,inf
35089,62,5,67,0,inf
35090,55,7,62,0,inf
35091,54,8,62,0,inf
35092,59,5,64,0,inf
35093,62,11,73,0,inf
35094,65,7,72,0,inf
35095,57,9,66,0,inf
35096,59,5,64,0,inf
35097,50,7,57,0,inf
35098,64,12,76,0,inf
35099,55,8,63,0,inf
35100,67,9,76,0,inf
35101,65,9,74,0,inf
35102,56,11,67,0,inf
35103,57,13,70,0,inf
35104,51,5,56,0,inf
35105,53,8,61,0,inf
35106,60,11,71,0,inf
35107,55,10,65,0,inf
35108,61,12,73,0,inf
35109,63,6,69,0,inf
35110,65,10,75,0,inf
35111,53,11,64,0,inf
35112,54,5,59,0,inf
35113,51,5,56,0,inf
35114,50,5,55,0,inf
35115,50,12,62,0,inf
35116,58,8,66,0,inf
35117,57,6,63,0,inf
35118,66,12,78,0,inf
35119,57,13,70,0,inf
35120,61,13,74,0,inf
35121,64,9,73,0,inf
35122,66,9,75,0,inf
35123,58,8,66,0,inf
35124,53,9,62,0,inf
35125,51,7,58,0,inf
35126,56,9,65,0,inf
35127,66,11,77,0,inf
35128,65,12,77,0,inf
35129,62,5,67,0,inf
35130,59,8,67,0,inf
35131,56,12,68,0,inf
35132,55,12,67,0,inf
35133,58,13,71,0,inf
35134,66,11,77,0,inf
35135,63,8,71,0,inf
35136,50,6,56,0,inf
35137,50,9,59,0,inf
35138,67,12,79,0,inf
35139,60,12,72,0,inf
35140,51,10,61,0,inf
35141,63,11,74,0,inf
35142,54,10,64,0,inf
35143,52,6,58,0,inf
35144,59,7,66,0,inf
35145,66,8,74,0,inf
35146,60,8,68,0,inf
35147,55,13,68,0,inf
35148,66,13,79,0,inf
35149,59,13,72,0,inf
35150,50,12,62,0,inf
35151,60,10,70,0,inf
35152,65,9,74,0,inf
35153,54,5,59,0,inf
35154,53,11,64,0,inf
35155,65,13,78,0,inf
35156,58,13,71,0,inf
35157,58,12,70,0,inf
35158,67,9,76,0,inf
35159,67,9,76,0,inf
35160,56,13,69,0,inf
35161,52,11,63,0,inf
35162,53,10,63,0,inf
35163,54,8,62,0,inf
35164,60,6,66,0,inf
35165,64,12,76,0,inf
35166,61,13,74,1,0.8056005906053016
35167,56,8,64,0,inf
35168,58,11,69,0,inf
35169,56,8,64,0,inf
35170,61,13,74,0,inf
35171,52,9,61,0,inf
35172,67,10,77,0,inf
35173,52,6,58,0,inf
35174,53,5,58,0,inf
35175,63,11,74,0,inf
35176,65,8,73,0,inf
35177,61,12,73,0,inf
35178,59,7,66,0,inf
35179,52,8,60,0,inf
35180,55,6,61,0,inf
35181,58,5,63,0,inf
35182,62,8,70,0,inf
35183,67,10,77,0,inf
35184,58,9,67,0,inf
35185,50,9,59,0,inf
35186,67,12,79,0,inf
35187,59,10,69,0,inf
35188,53,10,63,0,inf
35189,54,7,61,0,inf
35190,59,13,72,0,inf
35191,51,10,61,1,4.269876186259772
35192,66,7,73,0,inf
35193,58,11,69,0,inf
35194,58,5,63,0,inf
35195,53,12,65,0,inf
35196,58,10,68,0,inf
35197,59,8,67,0,inf
35198,53,6,59,0,inf
35199,57,6,63,0,inf
35200,60,6,66,0,inf
35201,56,11,67,0,inf
35202,52,5,57,1,4.746485469268876
35203,57,9,66,0,inf
35204,63,12,75,0,inf
35205,53,10,63,0,inf
35206,52,11,63,0,inf
35207,57,8,65,1,0.6012963307271733
35208,53,6,59,0,inf
35209,62,12,74,0,inf
35210,57,8,65,0,inf
35211,63,13,76,0,inf
35212,52,7,59,0,inf
35213,67,5,72,0,inf
35214,53,8,61,0,inf
35215,56,9,65,0,inf
35216,61,5,66,0,inf
35217,60,12,72,0,inf
35218,51,12,63,1,7.0785390962979875
35219,64,6,70,0,inf
35220,60,5,65,0,inf
35221,54,6,60,0,inf
35222,66,5,71,0,inf
35223,64,13,77,0,inf
35224,63,11,74,0,inf
35225,61,6,67,0,inf
35226,65,11,76,0,inf
35227,56,10,66,0,inf
35228,66,9,75,0,inf
35229,54,9,63,0,inf
35230,62,5,67,0,inf
35231,51,9,60,0,inf
35232,57,11,68,0,inf
35233,53,6,59,0,inf
35234,64,6,70,0,inf
35235,59,12,71,0,inf
35236,64,8,72,0,inf
35237,50,13,63,0,inf
35238,50,11,61,0,inf
35239,51,12,63,0,inf
35240,61,9,70,0,inf
35241,57,13,70,0,inf
35242,58,9,67,0,inf
35243,53,9,62,0,inf
35244,51,9,60,1,0.4001787806930466
35245,52,9,61,0,inf
35246,53,13,66,0,inf
35247,64,7,71,0,inf
35248,54,11,65,0,inf
35249,63,8,71,0,inf
35250,65,8,73,0,inf
35251,51,5,56,0,inf
35252,62,11,73,0,inf
35253,60,8,68,0,inf
35254,57,7,64,0,inf
35255,59,9,68,0,inf
35256,64,5,69,0,inf
35257,52,11,63,0,inf
35258,64,9,73,0,inf
35259,62,13,75,0,inf
35260,57,11,68,0,inf
35261,60,12,72,0,inf
35262,55,13,68,0,inf
35263,64,5,69,0,inf
35264,63,5,68,0,inf
35265,63,10,73,0,inf
35266,63,10,73,0,inf
35267,50,6,56,0,inf
35268,64,10,74,0,inf
35269,62,12,74,0,inf
35270,56,7,63,0,inf
35271,59,8,67,0,inf
35272,67,7,74,0,inf
35273,67,6,73,0,inf
35274,59,12,71,0,inf
35275,64,11,75,0,inf
35276,60,5,65,0,inf
35277,62,10,72,0,inf
35278,63,5,68,0,inf
35279,67,9,76,0,inf
35280,51,5,56,0,inf
35281,56,13,69,0,inf
35282,51,8,59,0,inf
35283,56,12,68,0,inf
35284,65,6,71,0,inf
35285,63,7,70,0,inf
35286,63,7,70,0,inf
35287,62,7,69,0,inf
35288,53,12,65,0,inf
35289,59,7,66,0,inf
35290,57,5,62,0,inf
35291,61,9,70,0,inf
35292,67,9,76,0,inf
35293,63,13,76,0,inf
35294,51,10,61,0,inf
35295,61,7,68,1,5.085383467427491
35296,62,13,75,0,inf
35297,61,5,66,0,inf
35298,54,13,67,0,inf
35299,56,5,61,0,inf
35300,51,6,57,0,inf
35301,59,13,72,0,inf
35302,66,9,75,0,inf
35303,64,10,74,0,inf
35304,63,8,71,0,inf
35305,64,9,73,0,inf
35306,54,5,59,0,inf
35307,54,8,62,0,inf
35308,57,12,69,0,inf
35309,56,9,65,0,inf
35310,59,7,66,0,inf
35311,50,6,56,0,inf
35312,62,8,70,0,inf
35313,64,13,77,0,inf
35314,64,5,69,0,inf
35315,54,7,61,0,inf
35316,58,13,71,0,inf
35317,58,11,69,0,inf
35318,61,10,71,0,inf
35319,51,12,63,0,inf
35320,63,7,70,0,inf
35321,63,10,73,0,inf
35322,66,6,72,0,inf
35323,67,13,80,0,inf
35324,55,9,64,0,inf
35325,53,12,65,0,inf
35326,51,13,64,0,inf
35327,65,12,77,0,inf
35328,52,12,64,0,inf
35329,53,9,62,0,inf
35330,55,5,60,0,inf
35331,65,6,71,0,inf
35332,66,10,76,0,inf
35333,67,11,78,0,inf
35334,51,5,56,0,inf
35335,53,7,60,0,inf
35336,60,10,70,0,inf
35337,59,5,64,0,inf
35338,59,13,72,0,inf
35339,64,11,75,0,inf
35340,67,10,77,0,inf
35341,51,11,62,0,inf
35342,51,7,58,0,inf
35343,67,13,80,0,inf
35344,53,9,62,0,inf
35345,52,6,58,0,inf
35346,65,5,70,0,inf
35347,59,6,65,0,inf
35348,50,10,60,0,inf
35349,52,5,57,0,inf
35350,67,12,79,0,inf
35351,60,9,69,0,inf
35352,52,9,61,0,inf
35353,66,11,77,0,inf
35354,58,11,69,0,inf
35355,63,10,73,0,inf
35356,51,11,62,0,inf
35357,60,11,71,0,inf
35358,58,6,64,0,inf
35359,54,13,67,0,inf
35360,65,11,76,0,inf
35361,59,12,71,0,inf
35362,57,11,68,0,inf
35363,59,7,66,0,inf
35364,55,7,62,0,inf
35365,53,8,61,0,inf
35366,62,13,75,0,inf
35367,56,8,64,0,inf
35368,55,9,64,0,inf
35369,67,8,75,0,inf
35370,56,9,65,0,inf
35371,56,9,65,0,inf
35372,51,9,60,0,inf
35373,53,9,62,0,inf
35374,50,13,63,0,inf
35375,51,7,58,0,inf
35376,56,10,66,1,1.0430729223716497
35377,57,10,67,0,inf
35378,63,11,74,0,inf
35379,62,5,67,0,inf
35380,56,8,64,0,inf
35381,58,13,71,0,inf
35382,66,8,74,0,inf
35383,51,7,58,0,inf
35384,65,5,70,0,inf
35385,54,6,60,0,inf
35386,63,13,76,0,inf
35387,51,8,59,0,inf
35388,65,5,70,0,inf
35389,56,8,64,0,inf
35390,62,9,71,0,inf
35391,65,8,73,0,inf
35392,52,10,62,0,inf
35393,57,12,69,0,inf
35394,63,13,76,1,10.510303879440457
35395,50,6,56,0,inf
35396,57,6,63,0,inf
35397,58,7,65,0,inf
35398,52,5,57,0,inf
35399,51,7,58,0,inf
35400,56,5,61,0,inf
35401,64,6,70,0,inf
35402,54,5,59,0,inf
35403,58,12,70,0,inf
35404,59,12,71,0,inf
35405,65,10,75,0,inf
35406,56,9,65,0,inf
35407,50,13,63,0,inf
35408,67,7,74,0,inf
35409,54,12,66,0,inf
35410,60,9,69,0,inf
35411,58,7,65,0,inf
35412,60,6,66,0,inf
35413,62,9,71,0,inf
35414,55,6,61,0,inf
35415,65,10,75,0,inf
35416,60,9,69,0,inf
35417,61,5,66,0,inf
35418,58,10,68,0,inf
35419,54,6,60,0,inf
35420,57,6,63,0,inf
35421,64,10,74,0,inf
35422,52,13,65,0,inf
35423,55,7,62,0,inf
35424,60,6,66,0,inf
35425,50,10,60,0,inf
35426,65,12,77,0,inf
35427,57,13,70,0,inf
35428,64,12,76,0,inf
35429,59,8,67,0,inf
35430,63,11,74,1,2.6175874138003934
35431,51,7,58,0,inf
35432,55,12,67,0,inf
35433,51,6,57,0,inf
35434,54,5,59,0,inf
35435,51,9,60,0,inf
35436,56,12,68,0,inf
35437,59,6,65,0,inf
35438,64,7,71,0,inf
35439,59,6,65,0,inf
35440,64,10,74,0,inf
35441,64,7,71,0,inf
35442,60,6,66,0,inf
35443,51,7,58,0,inf
35444,64,5,69,0,inf
35445,62,9,71,0,inf
35446,61,9,70,0,inf
35447,65,8,73,0,inf
35448,61,9,70,0,inf
35449,63,11,74,1,4.7878881958573345
35450,50,12,62,0,inf
35451,51,8,59,0,inf
35452,63,12,75,0,inf
35453,67,11,78,0,inf
35454,65,12,77,0,inf
35455,53,10,63,0,inf
35456,57,8,65,0,inf
35457,61,8,69,0,inf
35458,59,7,66,0,inf
35459,65,13,78,0,inf
35460,66,6,72,0,inf
35461,56,5,61,0,inf
35462,66,12,78,0,inf
35463,56,9,65,0,inf
35464,67,12,79,0,inf
35465,58,6,64,0,inf
35466,51,8,59,0,inf
35467,62,10,72,0,inf
35468,61,12,73,0,inf
35469,53,11,64,0,inf
35470,56,5,61,0,inf
35471,64,5,69,0,inf
35472,56,13,69,0,inf
35473,50,9,59,0,inf
35474,63,7,70,0,inf
35475,53,10,63,0,inf
35476,50,8,58,0,inf
35477,57,13,70,0,inf
35478,54,5,59,0,inf
35479,52,7,59,0,inf
35480,65,5,70,0,inf
35481,54,9,63,0,inf
35482,54,8,62,0,inf
35483,50,6,56,0,inf
35484,61,13,74,0,inf
35485,55,9,64,0,inf
35486,59,9,68,0,inf
35487,60,11,71,1,4.906615522463994
35488,60,9,69,0,inf
35489,62,11,73,0,inf
35490,51,11,62,0,inf
35491,52,6,58,0,inf
35492,61,6,67,0,inf
35493,65,10,75,0,inf
35494,62,13,75,0,inf
35495,52,7,59,0,inf
35496,57,5,62,0,inf
35497,53,12,65,0,inf
35498,53,12,65,0,inf
35499,63,8,71,0,inf
35500,65,8,73,0,inf
35501,62,13,75,0,inf
35502,50,13,63,0,inf
35503,65,6,71,0,inf
35504,56,11,67,0,inf
35505,64,12,76,0,inf
35506,62,6,68,0,inf
35507,62,11,73,0,inf
35508,57,13,70,0,inf
35509,61,13,74,0,inf
35510,65,9,74,0,inf
35511,56,6,62,0,inf
35512,63,8,71,0,inf
35513,64,5,69,0,inf
35514,50,6,56,0,inf
35515,52,5,57,0,inf
35516,58,10,68,0,inf
35517,59,10,69,0,inf
35518,54,8,62,0,inf
35519,67,9,76,0,inf
35520,57,8,65,0,inf
35521,56,9,65,0,inf
35522,54,6,60,0,inf
35523,52,5,57,0,inf
35524,62,8,70,0,inf
35525,53,13,66,0,inf
35526,63,5,68,0,inf
35527,56,9,65,0,inf
35528,66,11,77,0,inf
35529,53,11,64,0,inf
35530,58,12,70,0,inf
35531,54,7,61,0,inf
35532,58,8,66,0,inf
35533,54,13,67,0,inf
35534,53,11,64,0,inf
35535,51,11,62,0,inf
35536,61,6,67,0,inf
35537,65,13,78,0,inf
35538,59,8,67,0,inf
35539,64,9,73,0,inf
35540,59,5,64,0,inf
35541,58,11,69,0,inf
35542,50,6,56,0,inf
35543,52,12,64,0,inf
35544,65,13,78,0,inf
35545,58,6,64,0,inf
35546,63,12,75,0,inf
35547,52,13,65,0,inf
35548,66,12,78,0,inf
35549,53,8,61,0,inf
35550,65,12,77,0,inf
35551,58,5,63,0,inf
35552,56,8,64,0,inf
35553,56,12,68,0,inf
35554,59,7,66,0,inf
35555,55,6,61,0,inf
35556,50,13,63,0,inf
35557,65,7,72,0,inf
35558,54,9,63,0,inf
35559,63,11,74,0,inf
35560,63,11,74,0,inf
35561,56,8,64,0,inf
35562,59,9,68,0,inf
35563,65,5,70,0,inf
35564,64,7,71,0,inf
35565,67,7,74,0,inf
35566,63,10,73,0,inf
35567,66,13,79,0,inf
35568,65,13,78,0,inf
35569,58,6,64,0,inf
35570,60,10,70,0,inf
35571,61,8,69,0,inf
35572,56,13,69,0,inf
35573,57,6,63,0,inf
35574,54,5,59,0,inf
35575,63,13,76,0,inf
35576,57,13,70,1,10.096679045509845
35577,65,13,78,0,inf
35578,65,12,77,0,inf
35579,50,8,58,0,inf
35580,62,13,75,0,inf
35581,59,9,68,0,inf
35582,55,5,60,0,inf
35583,62,9,71,0,inf
35584,67,13,80,0,inf
35585,61,10,71,0,inf
35586,57,6,63,0,inf
35587,59,11,70,0,inf
35588,51,6,57,0,inf
35589,62,10,72,0,inf
35590,56,8,64,0,inf
35591,58,6,64,0,inf
35592,62,7,69,0,inf
35593,60,11,71,0,inf
35594,65,7,72,0,inf
35595,66,12,78,0,inf
35596,64,6,70,0,inf
35597,59,8,67,0,inf
35598,56,6,62,0,inf
35599,50,5,55,0,inf
35600,58,8,66,0,inf
35601,63,5,68,0,inf
35602,52,13,65,1,1.4464668113132433
35603,66,9,75,0,inf
35604,64,12,76,0,inf
35605,56,5,61,0,inf
35606,65,10,75,0,inf
35607,52,6,58,0,inf
35608,50,10,60,0,inf
35609,55,13,68,0,inf
35610,55,8,63,0,inf
35611,59,5,64,0,inf
35612,52,5,57,0,inf
35613,67,13,80,0,inf
35614,54,6,60,0,inf
35615,54,7,61,0,inf
35616,64,5,69,0,inf
35617,65,10,75,0,inf
35618,50,5,55,0,inf
35619,57,11,68,0,inf
35620,66,6,72,0,inf
35621,65,9,74,1,5.713506883472434
35622,58,7,65,0,inf
35623,62,8,70,0,inf
35624,67,9,76,0,inf
35625,66,8,74,0,inf
35626,62,12,74,0,inf
35627,60,10,70,0,inf
35628,55,5,60,0,inf
35629,55,11,66,0,inf
35630,64,13,77,1,10.603764456803816
35631,64,13,77,0,inf
35632,62,9,71,0,inf
35633,50,10,60,0,inf
35634,57,12,69,0,inf
35635,59,5,64,0,inf
35636,61,13,74,0,inf
35637,61,7,68,0,inf
35638,67,8,75,0,inf
35639,59,5,64,0,inf
35640,56,13,69,0,inf
35641,55,5,60,0,inf
35642,65,11,76,0,inf
35643,60,13,73,0,inf
35644,67,11,78,0,inf
35645,55,8,63,0,inf
35646,53,9,62,0,inf
35647,65,7,72,0,inf
35648,62,10,72,0,inf
35649,50,5,55,0,inf
35650,58,6,64,0,inf
35651,58,8,66,0,inf
35652,55,12,67,0,inf
35653,50,6,56,0,inf
35654,61,11,72,0,inf
35655,53,8,61,0,inf
35656,52,6,58,0,inf
35657,65,9,74,0,inf
35658,65,6,71,0,inf
35659,66,6,72,0,inf
35660,53,13,66,0,inf
35661,63,7,70,0,inf
35662,56,6,62,0,inf
35663,60,11,71,0,inf
35664,65,10,75,0,inf
35665,58,7,65,0,inf
35666,55,9,64,0,inf
35667,57,8,65,0,inf
35668,64,11,75,0,inf
35669,63,11,74,0,inf
35670,56,10,66,0,inf
35671,65,12,77,0,inf
35672,52,11,63,0,inf
35673,58,13,71,0,inf
35674,64,12,76,0,inf
35675,57,6,63,0,inf
35676,59,8,67,0,inf
35677,51,13,64,0,inf
35678,52,13,65,0,inf
35679,56,7,63,0,inf
35680,53,8,61,0,inf
35681,59,12,71,0,inf
35682,53,12,65,0,inf
35683,51,10,61,0,inf
35684,52,8,60,0,inf
35685,58,9,67,0,inf
35686,63,11,74,0,inf
35687,58,6,64,0,inf
35688,58,11,69,0,inf
35689,52,11,63,0,inf
35690,57,11,68,0,inf
35691,61,11,72,0,inf
35692,59,8,67,0,inf
35693,58,10,68,0,inf
35694,66,11,77,0,inf
35695,66,9,75,0,inf
35696,55,6,61,0,inf
35697,54,11,65,1,0.44473261616261084
35698,59,13,72,0,inf
35699,56,9,65,0,inf
35700,61,8,69,0,inf
35701,55,13,68,0,inf
35702,62,10,72,0,inf
35703,61,5,66,0,inf
35704,52,6,58,0,inf
35705,67,11,78,0,inf
35706,53,5,58,0,inf
35707,54,6,60,0,inf
35708,56,13,69,0,inf
35709,59,10,69,0,inf
35710,62,7,69,0,inf
35711,59,11,70,0,inf
35712,62,11,73,0,inf
35713,58,9,67,0,inf
35714,55,13,68,0,inf
35715,62,7,69,0,inf
35716,50,10,60,1,0.03095639438697617
35717,56,9,65,0,inf
35718,63,7,70,0,inf
35719,66,12,78,0,inf
35720,61,8,69,0,inf
35721,51,12,63,0,inf
35722,65,7,72,0,inf
35723,59,13,72,0,inf
35724,64,13,77,0,inf
35725,58,7,65,0,inf
35726,50,7,57,0,inf
35727,62,8,70,0,inf
35728,64,13,77,0,inf
35729,52,8,60,0,inf
35730,66,12,78,0,inf
35731,58,9,67,0,inf
35732,65,13,78,0,inf
35733,58,10,68,0,inf
35734,63,12,75,0,inf
35735,53,8,61,0,inf
35736,60,12,72,0,inf
35737,52,7,59,0,inf
35738,50,8,58,0,inf
35739,51,13,64,0,inf
35740,64,13,77,0,inf
35741,52,8,60,1,2.0187372525426
35742,52,13,65,0,inf
35743,59,8,67,0,inf
35744,53,7,60,0,inf
35745,60,12,72,0,inf
35746,59,5,64,0,inf
35747,59,10,69,0,inf
35748,51,11,62,0,inf
35749,54,11,65,0,inf
35750,50,12,62,0,inf
35751,62,6,68,0,inf
35752,63,13,76,0,inf
35753,51,5,56,0,inf
35754,52,12,64,0,inf
35755,50,12,62,0,inf
35756,51,6,57,0,inf
35757,57,13,70,0,inf
35758,65,10,75,0,inf
35759,63,8,71,0,inf
35760,63,13,76,0,inf
35761,50,6,56,0,inf
35762,58,9,67,0,inf
35763,50,6,56,0,inf
35764,62,5,67,0,inf
35765,50,6,56,0,inf
35766,67,7,74,0,inf
35767,65,6,71,0,inf
35768,50,9,59,0,inf
35769,65,5,70,0,inf
35770,53,5,58,0,inf
35771,65,9,74,0,inf
35772,58,11,69,1,10.449182058804482
35773,54,5,59,0,inf
35774,62,11,73,0,inf
35775,59,9,68,0,inf
35776,56,9,65,0,inf
35777,60,9,69,0,inf
35778,63,13,76,0,inf
35779,53,6,59,0,inf
35780,60,9,69,0,inf
35781,56,10,66,0,inf
35782,50,12,62,0,inf
35783,59,9,68,0,inf
35784,51,13,64,0,inf
35785,57,11,68,0,inf
35786,57,10,67,0,inf
35787,51,5,56,0,inf
35788,50,6,56,0,inf
35789,53,6,59,0,inf
35790,65,10,75,0,inf
35791,59,10,69,0,inf
35792,56,12,68,0,inf
35793,59,8,67,0,inf
35794,66,6,72,0,inf
35795,63,13,76,0,inf
35796,54,11,65,0,inf
35797,56,12,68,0,inf
35798,66,7,73,0,inf
35799,58,6,64,0,inf
35800,65,8,73,0,inf
35801,62,13,75,0,inf
35802,61,10,71,0,inf
35803,58,7,65,0,inf
35804,50,9,59,0,inf
35805,65,11,76,0,inf
35806,64,8,72,0,inf
35807,50,10,60,0,inf
35808,56,13,69,0,inf
35809,59,8,67,0,inf
35810,53,9,62,0,inf
35811,57,12,69,0,inf
35812,67,13,80,0,inf
35813,65,11,76,0,inf
35814,63,8,71,0,inf
35815,65,12,77,1,5.607789904685177
35816,57,9,66,0,inf
35817,64,5,69,0,inf
35818,55,8,63,0,inf
35819,65,10,75,0,inf
35820,62,13,75,0,inf
35821,50,8,58,0,inf
35822,63,10,73,0,inf
35823,63,12,75,0,inf
35824,63,6,69,0,inf
35825,63,8,71,0,inf
35826,56,6,62,0,inf
35827,51,9,60,0,inf
35828,58,9,67,0,inf
35829,58,13,71,0,inf
35830,56,9,65,0,inf
35831,65,6,71,0,inf
35832,53,12,65,0,inf
35833,51,6,57,0,inf
35834,66,9,75,0,inf
35835,67,13,80,0,inf
35836,63,7,70,0,inf
35837,58,12,70,0,inf
35838,57,6,63,0,inf
35839,58,12,70,0,inf
35840,58,9,67,0,inf
35841,66,6,72,0,inf
35842,66,11,77,0,inf
35843,51,7,58,0,inf
35844,53,13,66,0,inf
35845,64,12,76,0,inf
35846,59,13,72,0,inf
35847,55,12,67,0,inf
35848,65,10,75,0,inf
35849,66,11,77,0,inf
35850,53,8,61,0,inf
35851,59,11,70,0,inf
35852,57,7,64,0,inf
35853,65,11,76,0,inf
35854,66,10,76,0,inf
35855,65,12,77,0,inf
35856,65,11,76,0,inf
35857,53,11,64,0,inf
35858,60,6,66,0,inf
35859,61,12,73,0,inf
35860,67,8,75,0,inf
35861,50,9,59,0,inf
35862,61,5,66,0,inf
35863,66,7,73,0,inf
35864,60,12,72,0,inf
35865,63,12,75,0,inf
35866,59,13,72,1,7.782195142946392
35867,66,6,72,0,inf
35868,67,9,76,0,inf
35869,58,6,64,0,inf
35870,65,8,73,0,inf
35871,63,10,73,0,inf
35872,56,11,67,0,inf
35873,62,8,70,0,inf
35874,54,10,64,0,inf
35875,58,9,67,0,inf
35876,53,7,60,0,inf
35877,64,11,75,0,inf
35878,52,11,63,0,inf
35879,55,13,68,0,inf
35880,66,9,75,0,inf
35881,57,12,69,0,inf
35882,62,10,72,0,inf
35883,51,5,56,0,inf
35884,56,5,61,0,inf
35885,64,10,74,0,inf
35886,66,7,73,0,inf
35887,60,9,69,0,inf
35888,62,5,67,0,inf
35889,56,11,67,0,inf
35890,58,9,67,0,inf
35891,67,10,77,0,inf
35892,51,5,56,0,inf
35893,58,8,66,0,inf
35894,62,11,73,0,inf
35895,64,12,76,0,inf
35896,63,6,69,0,inf
35897,52,13,65,0,inf
35898,62,11,73,0,inf
35899,67,9,76,0,inf
35900,57,7,64,0,inf
35901,63,13,76,0,inf
35902,60,9,69,0,inf
35903,55,9,64,0,inf
35904,56,13,69,1,10.038595409318134
35905,67,9,76,0,inf
35906,61,11,72,0,inf
35907,55,9,64,0,inf
35908,63,12,75,0,inf
35909,59,8,67,0,inf
35910,64,6,70,0,inf
35911,60,7,67,0,inf
35912,55,7,62,0,inf
35913,52,13,65,1,4.534057680320316
35914,65,9,74,0,inf
35915,53,7,60,0,inf
35916,54,7,61,0,inf
35917,63,11,74,0,inf
35918,52,9,61,0,inf
35919,66,8,74,0,inf
35920,50,9,59,0,inf
35921,51,5,56,0,inf
35922,67,9,76,0,inf
35923,59,13,72,0,inf
35924,63,7,70,0,inf
35925,61,13,74,0,inf
35926,64,5,69,0,inf
35927,50,11,61,0,inf
35928,60,8,68,0,inf
35929,67,12,79,0,inf
35930,61,11,72,0,inf
35931,66,12,78,0,inf
35932,61,5,66,0,inf
35933,59,7,66,0,inf
35934,67,13,80,0,inf
35935,63,11,74,0,inf
35936,65,13,78,0,inf
35937,52,7,59,0,inf
35938,59,13,72,0,inf
35939,58,13,71,0,inf
35940,67,6,73,0,inf
35941,53,9,62,0,inf
35942,50,8,58,0,inf
35943,50,5,55,0,inf
35944,57,10,67,0,inf
35945,63,5,68,0,inf
35946,60,10,70,0,inf
35947,50,7,57,0,inf
35948,60,9,69,0,inf
35949,52,9,61,0,inf
35950,62,9,71,0,inf
35951,59,7,66,0,inf
35952,54,5,59,0,inf
35953,52,10,62,0,inf
35954,51,7,58,0,inf
35955,61,7,68,0,inf
35956,65,7,72,0,inf
35957,52,8,60,0,inf
35958,67,7,74,0,inf
35959,59,6,65,0,inf
35960,60,11,71,0,inf
35961,65,9,74,0,inf
35962,64,11,75,0,inf
35963,54,6,60,0,inf
35964,50,9,59,0,inf
35965,51,12,63,0,inf
35966,50,9,59,0,inf
35967,63,10,73,1,8.802427421682609
35968,67,10,77,0,inf
35969,52,7,59,0,inf
35970,64,9,73,0,inf
35971,56,12,68,0,inf
35972,56,12,68,0,inf
35973,61,10,71,0,inf
35974,56,7,63,0,inf
35975,55,5,60,0,inf
35976,62,10,72,0,inf
35977,59,10,69,0,inf
35978,65,10,75,0,inf
35979,58,5,63,0,inf
35980,52,6,58,0,inf
35981,66,6,72,0,inf
35982,56,9,65,0,inf
35983,59,10,69,0,inf
35984,57,10,67,1,1.3102615910988717
35985,53,9,62,0,inf
35986,55,12,67,0,inf
35987,60,10,70,0,inf
35988,56,8,64,0,inf
35989,54,9,63,0,inf
35990,58,7,65,0,inf
35991,63,5,68,0,inf
35992,58,11,69,0,inf
35993,64,9,73,0,inf
35994,56,7,63,0,inf
35995,65,7,72,0,inf
35996,52,13,65,0,inf
35997,61,9,70,0,inf
35998,57,8,65,0,inf
35999,67,11,78,0,inf
36000,50,11,61,0,inf
36001,53,10,63,0,inf
36002,51,8,59,0,inf
36003,50,6,56,0,inf
36004,64,10,74,0,inf
36005,63,5,68,0,inf
36006,53,9,62,0,inf
36007,63,10,73,0,inf
36008,53,9,62,0,inf
36009,57,5,62,0,inf
36010,61,9,70,0,inf
36011,64,7,71,0,inf
36012,51,8,59,0,inf
36013,54,12,66,0,inf
36014,66,11,77,0,inf
36015,55,7,62,0,inf
36016,57,13,70,0,inf
36017,65,13,78,1,11.361771617113419
36018,65,7,72,0,inf
36019,66,13,79,0,inf
36020,64,8,72,0,inf
36021,56,5,61,0,inf
36022,63,7,70,0,inf
36023,59,10,69,0,inf
36024,66,12,78,0,inf
36025,59,5,64,0,inf
36026,53,8,61,0,inf
36027,52,8,60,0,inf
36028,62,5,67,0,inf
36029,53,11,64,0,inf
36030,63,5,68,0,inf
36031,59,12,71,0,inf
36032,61,8,69,0,inf
36033,62,13,75,0,inf
36034,66,12,78,0,inf
36035,62,12,74,0,inf
36036,54,12,66,0,inf
36037,54,10,64,0,inf
36038,65,9,74,0,inf
36039,62,6,68,0,inf
36040,66,12,78,0,inf
36041,58,10,68,0,inf
36042,54,9,63,0,inf
36043,63,10,73,0,inf
36044,51,5,56,0,inf
36045,64,8,72,0,inf
36046,57,7,64,0,inf
36047,58,6,64,0,inf
36048,66,11,77,1,7.064693909707046
36049,51,10,61,0,inf
36050,54,9,63,0,inf
36051,56,13,69,0,inf
36052,51,12,63,0,inf
36053,64,6,70,0,inf
36054,63,11,74,0,inf
36055,66,11,77,0,inf
36056,67,11,78,0,inf
36057,61,9,70,0,inf
36058,60,13,73,0,inf
36059,65,13,78,0,inf
36060,57,10,67,0,inf
36061,56,9,65,0,inf
36062,51,9,60,0,inf
36063,52,6,58,0,inf
36064,66,7,73,0,inf
36065,56,7,63,0,inf
36066,54,9,63,0,inf
36067,50,5,55,0,inf
36068,51,7,58,1,5.731841097033616
36069,55,10,65,0,inf
36070,67,13,80,1,7.336373612288398
36071,54,13,67,0,inf
36072,50,7,57,0,inf
36073,54,11,65,0,inf
36074,51,6,57,0,inf
36075,57,5,62,0,inf
36076,67,10,77,0,inf
36077,64,11,75,0,inf
36078,66,8,74,0,inf
36079,57,12,69,0,inf
36080,50,8,58,0,inf
36081,52,5,57,0,inf
36082,60,11,71,0,inf
36083,65,11,76,0,inf
36084,64,9,73,0,inf
36085,67,5,72,0,inf
36086,51,13,64,0,inf
36087,56,7,63,0,inf
36088,66,10,76,0,inf
36089,53,7,60,0,inf
36090,65,13,78,0,inf
36091,52,7,59,0,inf
36092,65,8,73,0,inf
36093,60,5,65,0,inf
36094,54,7,61,0,inf
36095,57,9,66,0,inf
36096,53,7,60,0,inf
36097,57,5,62,0,inf
36098,65,7,72,0,inf
36099,63,7,70,0,inf
36100,57,8,65,0,inf
36101,61,11,72,0,inf
36102,53,8,61,0,inf
36103,62,10,72,0,inf
36104,64,7,71,0,inf
36105,62,10,72,0,inf
36106,54,12,66,0,inf
36107,63,10,73,0,inf
36108,61,12,73,0,inf
36109,50,10,60,0,inf
36110,54,10,64,0,inf
36111,56,8,64,0,inf
36112,51,5,56,0,inf
36113,65,7,72,0,inf
36114,64,6,70,0,inf
36115,62,7,69,0,inf
36116,58,10,68,0,inf
36117,63,7,70,1,5.122405044304472
36118,64,13,77,0,inf
36119,65,5,70,0,inf
36120,60,12,72,0,inf
36121,67,7,74,0,inf
36122,53,9,62,0,inf
36123,59,7,66,0,inf
36124,62,8,70,0,inf
36125,61,6,67,0,inf
36126,63,9,72,0,inf
36127,61,8,69,0,inf
36128,59,8,67,0,inf
36129,65,6,71,0,inf
36130,50,12,62,0,inf
36131,57,10,67,0,inf
36132,60,12,72,0,inf
36133,66,5,71,0,inf
36134,60,12,72,0,inf
36135,52,5,57,0,inf
36136,65,5,70,0,inf
36137,50,6,56,0,inf
36138,59,9,68,0,inf
36139,55,13,68,0,inf
36140,51,6,57,0,inf
36141,65,11,76,0,inf
36142,60,7,67,0,inf
36143,59,12,71,0,inf
36144,55,7,62,0,inf
36145,62,12,74,0,inf
36146,64,12,76,0,inf
36147,64,6,70,0,inf
36148,66,6,72,0,inf
36149,62,12,74,1,5.630664978096561
36150,64,6,70,0,inf
36151,51,13,64,0,inf
36152,61,5,66,0,inf
36153,62,13,75,0,inf
36154,54,10,64,0,inf
36155,55,6,61,0,inf
36156,65,5,70,0,inf
36157,53,12,65,0,inf
36158,67,11,78,0,inf
36159,67,8,75,1,3.794701522424475
36160,55,7,62,0,inf
36161,51,5,56,0,inf
36162,57,13,70,0,inf
36163,51,13,64,0,inf
36164,52,9,61,0,inf
36165,59,7,66,0,inf
36166,58,10,68,0,inf
36167,64,7,71,0,inf
36168,53,5,58,0,inf
36169,62,10,72,0,inf
36170,51,7,58,0,inf
36171,55,7,62,0,inf
36172,54,13,67,0,inf
36173,62,11,73,1,3.0785722740706802
36174,53,6,59,0,inf
36175,52,10,62,0,inf
36176,53,9,62,0,inf
36177,65,7,72,0,inf
36178,61,6,67,0,inf
36179,62,11,73,0,inf
36180,63,6,69,0,inf
36181,63,5,68,0,inf
36182,50,11,61,0,inf
36183,65,13,78,0,inf
36184,56,5,61,0,inf
36185,62,11,73,0,inf
36186,62,9,71,0,inf
36187,50,6,56,0,inf
36188,60,5,65,0,inf
36189,55,10,65,0,inf
36190,63,11,74,0,inf
36191,55,10,65,0,inf
36192,65,7,72,0,inf
36193,55,9,64,0,inf
36194,55,8,63,0,inf
36195,60,12,72,0,inf
36196,50,10,60,0,inf
36197,60,8,68,0,inf
36198,55,10,65,0,inf
36199,52,11,63,0,inf
36200,61,11,72,0,inf
36201,62,6,68,0,inf
36202,66,13,79,0,inf
36203,61,7,68,0,inf
36204,59,13,72,0,inf
36205,63,12,75,0,inf
36206,53,12,65,0,inf
36207,59,11,70,0,inf
36208,63,7,70,0,inf
36209,53,6,59,0,inf
36210,60,9,69,0,inf
36211,62,9,71,0,inf
36212,58,5,63,0,inf
36213,59,10,69,0,inf
36214,56,12,68,0,inf
36215,67,13,80,0,inf
36216,61,8,69,0,inf
36217,53,10,63,0,inf
36218,56,9,65,0,inf
36219,59,6,65,0,inf
36220,66,11,77,0,inf
36221,56,6,62,0,inf
36222,54,8,62,0,inf
36223,54,5,59,0,inf
36224,61,10,71,0,inf
36225,63,9,72,0,inf
36226,52,8,60,0,inf
36227,50,10,60,0,inf
36228,56,9,65,0,inf
36229,62,11,73,0,inf
36230,52,11,63,0,inf
36231,50,12,62,0,inf
36232,56,12,68,0,inf
36233,57,6,63,0,inf
36234,50,13,63,0,inf
36235,62,10,72,0,inf
36236,59,13,72,0,inf
36237,65,7,72,0,inf
36238,53,9,62,0,inf
36239,66,13,79,0,inf
36240,61,11,72,0,inf
36241,67,12,79,1,1.1778898473885278
36242,55,9,64,0,inf
36243,63,5,68,0,inf
36244,55,13,68,0,inf
36245,55,9,64,0,inf
36246,59,9,68,0,inf
36247,52,11,63,0,inf
36248,58,5,63,0,inf
36249,56,11,67,0,inf
36250,63,7,70,0,inf
36251,64,8,72,0,inf
36252,65,8,73,0,inf
36253,65,10,75,0,inf
36254,54,12,66,0,inf
36255,58,11,69,0,inf
36256,52,8,60,1,3.1799627656472396
36257,50,10,60,0,inf
36258,55,11,66,0,inf
36259,62,9,71,0,inf
36260,60,10,70,0,inf
36261,52,7,59,0,inf
36262,63,5,68,0,inf
36263,60,6,66,0,inf
36264,59,11,70,0,inf
36265,59,10,69,0,inf
36266,62,10,72,0,inf
36267,63,13,76,0,inf
36268,54,12,66,0,inf
36269,62,7,69,0,inf
36270,52,5,57,0,inf
36271,55,11,66,0,inf
36272,65,11,76,0,inf
36273,58,6,64,1,0.005823040045171979
36274,52,12,64,0,inf
36275,51,13,64,0,inf
36276,57,8,65,0,inf
36277,64,12,76,0,inf
36278,59,5,64,0,inf
36279,50,13,63,0,inf
36280,64,10,74,0,inf
36281,63,10,73,0,inf
36282,63,12,75,1,9.7904952365937
36283,52,11,63,0,inf
36284,67,9,76,0,inf
36285,65,13,78,0,inf
36286,60,10,70,0,inf
36287,60,10,70,0,inf
36288,58,8,66,0,inf
36289,65,13,78,0,inf
36290,66,9,75,0,inf
36291,53,8,61,0,inf
36292,58,8,66,0,inf
36293,60,10,70,0,inf
36294,64,10,74,0,inf
36295,59,10,69,0,inf
36296,51,10,61,0,inf
36297,62,13,75,0,inf
36298,64,9,73,1,5.759870858748556
36299,58,9,67,0,inf
36300,62,5,67,0,inf
36301,67,12,79,0,inf
36302,57,6,63,0,inf
36303,57,5,62,1,3.035342243250028
36304,61,12,73,0,inf
36305,50,10,60,0,inf
36306,64,6,70,0,inf
36307,50,12,62,0,inf
36308,53,13,66,0,inf
36309,60,10,70,0,inf
36310,56,9,65,0,inf
36311,55,9,64,0,inf
36312,66,8,74,0,inf
36313,59,8,67,0,inf
36314,57,12,69,0,inf
36315,65,7,72,0,inf
36316,63,12,75,0,inf
36317,50,7,57,0,inf
36318,67,12,79,0,inf
36319,51,13,64,0,inf
36320,67,9,76,1,6.09079441147928
36321,51,7,58,0,inf
36322,56,6,62,0,inf
36323,67,6,73,0,inf
36324,63,12,75,0,inf
36325,60,8,68,0,inf
36326,55,6,61,0,inf
36327,59,7,66,0,inf
36328,67,8,75,0,inf
36329,56,12,68,0,inf
36330,50,8,58,0,inf
36331,67,7,74,0,inf
36332,60,10,70,0,inf
36333,58,12,70,1,8.05386831811063
36334,59,13,72,0,inf
36335,50,13,63,0,inf
36336,60,13,73,0,inf
36337,55,7,62,0,inf
36338,52,12,64,0,inf
36339,53,9,62,0,inf
36340,55,9,64,0,inf
36341,58,9,67,0,inf
36342,63,11,74,1,6.08364726022063
36343,50,13,63,0,inf
36344,56,9,65,0,inf
36345,61,13,74,0,inf
36346,61,8,69,0,inf
36347,63,12,75,0,inf
36348,64,8,72,0,inf
36349,63,7,70,0,inf
36350,60,9,69,0,inf
36351,58,10,68,0,inf
36352,59,11,70,0,inf
36353,52,11,63,0,inf
36354,57,7,64,0,inf
36355,51,11,62,0,inf
36356,56,8,64,0,inf
36357,65,13,78,0,inf
36358,57,13,70,0,inf
36359,63,13,76,0,inf
36360,52,7,59,0,inf
36361,65,13,78,0,inf
36362,65,8,73,1,6.8946985194480135
36363,55,13,68,0,inf
36364,53,5,58,0,inf
36365,67,5,72,1,3.112305851011314
36366,62,10,72,0,inf
36367,60,8,68,0,inf
36368,60,5,65,0,inf
36369,65,13,78,0,inf
36370,50,11,61,0,inf
36371,63,13,76,0,inf
36372,58,8,66,0,inf
36373,53,13,66,0,inf
36374,61,9,70,0,inf
36375,63,11,74,0,inf
36376,57,5,62,0,inf
36377,56,13,69,0,inf
36378,62,6,68,0,inf
36379,66,11,77,0,inf
36380,59,6,65,0,inf
36381,62,13,75,0,inf
36382,55,13,68,0,inf
36383,66,12,78,0,inf
36384,59,12,71,0,inf
36385,54,9,63,0,inf
36386,63,7,70,0,inf
36387,65,12,77,0,inf
36388,64,9,73,0,inf
36389,67,6,73,0,inf
36390,58,5,63,0,inf
36391,59,8,67,0,inf
36392,67,11,78,0,inf
36393,55,12,67,0,inf
36394,54,7,61,0,inf
36395,67,9,76,0,inf
36396,50,7,57,0,inf
36397,51,5,56,0,inf
36398,61,13,74,0,inf
36399,59,5,64,0,inf
36400,67,7,74,0,inf
36401,58,12,70,0,inf
36402,62,10,72,0,inf
36403,57,5,62,0,inf
36404,59,7,66,0,inf
36405,53,12,65,0,inf
36406,50,9,59,0,inf
36407,58,12,70,0,inf
36408,60,10,70,0,inf
36409,63,7,70,0,inf
36410,65,5,70,0,inf
36411,63,12,75,0,inf
36412,51,5,56,1,2.900610810729866
36413,64,11,75,0,inf
36414,60,10,70,0,inf
36415,66,9,75,0,inf
36416,56,13,69,0,inf
36417,50,7,57,0,inf
36418,65,8,73,0,inf
36419,62,7,69,0,inf
36420,62,10,72,0,inf
36421,64,13,77,0,inf
36422,63,11,74,0,inf
36423,61,6,67,0,inf
36424,56,12,68,0,inf
36425,51,8,59,0,inf
36426,67,8,75,0,inf
36427,62,9,71,0,inf
36428,57,8,65,0,inf
36429,56,7,63,0,inf
36430,65,7,72,0,inf
36431,59,10,69,0,inf
36432,66,6,72,0,inf
36433,59,6,65,0,inf
36434,56,10,66,0,inf
36435,65,9,74,0,inf
36436,56,7,63,0,inf
36437,52,7,59,0,inf
36438,63,5,68,0,inf
36439,53,5,58,0,inf
36440,67,11,78,0,inf
36441,56,8,64,0,inf
36442,54,5,59,0,inf
36443,65,8,73,0,inf
36444,62,13,75,0,inf
36445,50,9,59,0,inf
36446,51,8,59,0,inf
36447,50,11,61,0,inf
36448,59,5,64,0,inf
36449,67,13,80,0,inf
36450,56,5,61,0,inf
36451,66,12,78,0,inf
36452,65,11,76,0,inf
36453,59,11,70,0,inf
36454,57,13,70,0,inf
36455,60,12,72,0,inf
36456,65,13,78,0,inf
36457,52,7,59,0,inf
36458,63,7,70,0,inf
36459,57,5,62,0,inf
36460,52,5,57,0,inf
36461,52,7,59,0,inf
36462,56,13,69,0,inf
36463,52,5,57,0,inf
36464,66,9,75,0,inf
36465,55,6,61,0,inf
36466,59,6,65,0,inf
36467,57,9,66,0,inf
36468,67,11,78,0,inf
36469,61,13,74,0,inf
36470,51,11,62,0,inf
36471,52,8,60,0,inf
36472,50,10,60,0,inf
36473,53,13,66,0,inf
36474,56,6,62,1,2.2803812485938977
36475,58,6,64,0,inf
36476,52,6,58,0,inf
36477,53,12,65,0,inf
36478,50,7,57,0,inf
36479,56,6,62,0,inf
36480,55,10,65,0,inf
36481,51,10,61,0,inf
36482,51,12,63,0,inf
36483,66,9,75,0,inf
36484,58,8,66,0,inf
36485,63,13,76,0,inf
36486,51,12,63,0,inf
36487,50,10,60,0,inf
36488,53,6,59,0,inf
36489,58,12,70,0,inf
36490,57,9,66,0,inf
36491,62,13,75,0,inf
36492,65,6,71,0,inf
36493,51,9,60,0,inf
36494,53,11,64,0,inf
36495,65,12,77,0,inf
36496,50,12,62,0,inf
36497,58,10,68,0,inf
36498,61,8,69,0,inf
36499,63,8,71,0,inf
36500,53,11,64,0,inf
36501,65,12,77,0,inf
36502,57,12,69,0,inf
36503,57,11,68,0,inf
36504,67,8,75,0,inf
36505,50,10,60,0,inf
36506,58,5,63,0,inf
36507,55,13,68,0,inf
36508,63,7,70,0,inf
36509,61,9,70,0,inf
36510,54,12,66,0,inf
36511,56,5,61,0,inf
36512,53,10,63,0,inf
36513,66,6,72,0,inf
36514,54,9,63,0,inf
36515,63,9,72,0,inf
36516,59,11,70,0,inf
36517,67,7,74,0,inf
36518,66,6,72,0,inf
36519,50,7,57,0,inf
36520,51,7,58,0,inf
36521,64,5,69,0,inf
36522,64,13,77,0,inf
36523,55,9,64,0,inf
36524,63,11,74,0,inf
36525,67,11,78,0,inf
36526,63,5,68,0,inf
36527,66,13,79,0,inf
36528,61,11,72,0,inf
36529,63,11,74,0,inf
36530,51,11,62,0,inf
36531,65,8,73,0,inf
36532,63,5,68,0,inf
36533,54,10,64,0,inf
36534,58,7,65,0,inf
36535,64,13,77,0,inf
36536,53,8,61,0,inf
36537,50,7,57,1,3.5151669192932644
36538,59,10,69,0,inf
36539,53,8,61,0,inf
36540,56,7,63,0,inf
36541,51,8,59,0,inf
36542,51,6,57,0,inf
36543,66,9,75,0,inf
36544,51,11,62,0,inf
36545,65,9,74,0,inf
36546,65,11,76,1,1.1980551671664443
36547,59,10,69,0,inf
36548,51,9,60,1,0.4212560626856643
36549,65,13,78,0,inf
36550,53,9,62,0,inf
36551,60,9,69,0,inf
36552,61,8,69,0,inf
36553,54,10,64,0,inf
36554,58,5,63,0,inf
36555,64,10,74,0,inf
36556,61,7,68,0,inf
36557,56,5,61,0,inf
36558,61,5,66,0,inf
36559,65,7,72,0,inf
36560,53,12,65,0,inf
36561,58,8,66,0,inf
36562,56,10,66,0,inf
36563,55,6,61,0,inf
36564,61,5,66,0,inf
36565,67,12,79,0,inf
36566,66,10,76,0,inf
36567,53,6,59,0,inf
36568,54,12,66,0,inf
36569,57,5,62,0,inf
36570,55,8,63,0,inf
36571,50,9,59,0,inf
36572,53,8,61,0,inf
36573,50,7,57,0,inf
36574,64,12,76,0,inf
36575,63,7,70,0,inf
36576,55,9,64,0,inf
36577,54,10,64,0,inf
36578,52,8,60,0,inf
36579,57,5,62,0,inf
36580,57,12,69,0,inf
36581,57,10,67,0,inf
36582,50,6,56,0,inf
36583,66,8,74,0,inf
36584,53,8,61,0,inf
36585,67,6,73,0,inf
36586,67,12,79,0,inf
36587,56,5,61,0,inf
36588,58,9,67,0,inf
36589,67,6,73,0,inf
36590,52,7,59,0,inf
36591,66,12,78,0,inf
36592,60,8,68,0,inf
36593,54,7,61,0,inf
36594,54,8,62,0,inf
36595,53,13,66,0,inf
36596,65,8,73,0,inf
36597,64,12,76,0,inf
36598,66,8,74,0,inf
36599,58,13,71,0,inf
36600,63,11,74,0,inf
36601,63,10,73,0,inf
36602,60,11,71,1,9.69335117169426
36603,63,6,69,0,inf
36604,59,7,66,0,inf
36605,61,5,66,0,inf
36606,67,11,78,0,inf
36607,51,7,58,0,inf
36608,67,5,72,0,inf
36609,57,12,69,0,inf
36610,55,7,62,0,inf
36611,64,11,75,0,inf
36612,67,6,73,0,inf
36613,60,11,71,0,inf
36614,66,5,71,0,inf
36615,57,9,66,0,inf
36616,56,12,68,0,inf
36617,63,8,71,0,inf
36618,56,5,61,0,inf
36619,59,10,69,0,inf
36620,53,10,63,0,inf
36621,53,5,58,0,inf
36622,55,7,62,0,inf
36623,66,7,73,0,inf
36624,59,10,69,0,inf
36625,67,9,76,0,inf
36626,58,13,71,0,inf
36627,55,11,66,0,inf
36628,63,11,74,0,inf
36629,60,5,65,0,inf
36630,66,7,73,0,inf
36631,61,9,70,0,inf
36632,59,6,65,1,3.3518605162937334
36633,54,6,60,0,inf
36634,55,13,68,0,inf
36635,53,6,59,0,inf
36636,55,9,64,0,inf
36637,60,13,73,0,inf
36638,60,6,66,0,inf
36639,58,11,69,0,inf
36640,63,7,70,0,inf
36641,59,8,67,0,inf
36642,63,7,70,0,inf
36643,56,7,63,0,inf
36644,59,8,67,0,inf
36645,53,5,58,0,inf
36646,56,6,62,0,inf
36647,63,8,71,0,inf
36648,64,7,71,0,inf
36649,66,10,76,0,inf
36650,60,11,71,0,inf
36651,50,11,61,0,inf
36652,65,5,70,0,inf
36653,64,13,77,0,inf
36654,59,6,65,0,inf
36655,67,10,77,0,inf
36656,52,5,57,0,inf
36657,52,7,59,0,inf
36658,53,10,63,0,inf
36659,61,11,72,0,inf
36660,55,7,62,0,inf
36661,67,8,75,0,inf
36662,64,11,75,0,inf
36663,67,8,75,0,inf
36664,53,10,63,0,inf
36665,56,8,64,0,inf
36666,56,11,67,0,inf
36667,67,8,75,0,inf
36668,56,10,66,0,inf
36669,60,13,73,0,inf
36670,54,5,59,0,inf
36671,51,11,62,0,inf
36672,54,5,59,0,inf
36673,54,8,62,0,inf
36674,58,9,67,0,inf
36675,53,8,61,0,inf
36676,53,12,65,0,inf
36677,59,7,66,0,inf
36678,62,8,70,0,inf
36679,67,10,77,0,inf
36680,65,12,77,0,inf
36681,52,10,62,0,inf
36682,63,6,69,0,inf
36683,60,8,68,0,inf
36684,62,5,67,0,inf
36685,55,9,64,0,inf
36686,58,13,71,0,inf
36687,63,12,75,0,inf
36688,56,6,62,0,inf
36689,61,7,68,0,inf
36690,59,9,68,0,inf
36691,55,8,63,0,inf
36692,62,11,73,0,inf
36693,58,12,70,0,inf
36694,64,13,77,0,inf
36695,62,7,69,0,inf
36696,53,12,65,0,inf
36697,51,12,63,0,inf
36698,51,12,63,0,inf
36699,53,13,66,1,2.147367581799756
36700,60,6,66,0,inf
36701,54,10,64,0,inf
36702,52,9,61,0,inf
36703,67,7,74,1,5.066219570528261
36704,57,7,64,1,2.4103722756852193
36705,57,6,63,0,inf
36706,56,7,63,0,inf
36707,50,10,60,0,inf
36708,65,8,73,0,inf
36709,56,11,67,0,inf
36710,63,6,69,0,inf
36711,53,5,58,0,inf
36712,65,10,75,0,inf
36713,61,7,68,0,inf
36714,61,12,73,0,inf
36715,62,9,71,0,inf
36716,52,9,61,0,inf
36717,60,12,72,0,inf
36718,57,9,66,0,inf
36719,54,6,60,0,inf
36720,65,12,77,0,inf
36721,53,7,60,0,inf
36722,50,5,55,0,inf
36723,56,10,66,0,inf
36724,66,12,78,0,inf
36725,55,6,61,0,inf
36726,53,7,60,0,inf
36727,53,12,65,0,inf
36728,62,6,68,0,inf
36729,55,13,68,0,inf
36730,57,6,63,0,inf
36731,51,8,59,0,inf
36732,58,8,66,0,inf
36733,62,9,71,0,inf
36734,51,9,60,0,inf
36735,61,10,71,0,inf
36736,67,7,74,0,inf
36737,64,7,71,0,inf
36738,56,11,67,0,inf
36739,58,5,63,0,inf
36740,56,7,63,0,inf
36741,66,11,77,0,inf
36742,56,13,69,0,inf
36743,53,10,63,0,inf
36744,55,9,64,0,inf
36745,66,6,72,0,inf
36746,65,13,78,0,inf
36747,59,5,64,0,inf
36748,63,6,69,0,inf
36749,67,6,73,0,inf
36750,66,11,77,0,inf
36751,60,5,65,0,inf
36752,58,5,63,0,inf
36753,63,5,68,0,inf
36754,64,5,69,0,inf
36755,51,13,64,0,inf
36756,50,8,58,0,inf
36757,55,5,60,0,inf
36758,56,7,63,0,inf
36759,62,12,74,0,inf
36760,55,7,62,0,inf
36761,66,6,72,0,inf
36762,56,11,67,0,inf
36763,52,12,64,0,inf
36764,67,9,76,1,5.311742918323134
36765,59,8,67,0,inf
36766,52,8,60,0,inf
36767,67,13,80,0,inf
36768,67,8,75,0,inf
36769,53,12,65,0,inf
36770,55,11,66,0,inf
36771,55,13,68,0,inf
36772,65,5,70,0,inf
36773,66,12,78,0,inf
36774,65,11,76,0,inf
36775,58,13,71,0,inf
36776,67,12,79,0,inf
36777,62,10,72,0,inf
36778,62,12,74,0,inf
36779,63,6,69,0,inf
36780,51,10,61,0,inf
36781,66,8,74,0,inf
36782,52,10,62,0,inf
36783,67,8,75,0,inf
36784,59,12,71,0,inf
36785,50,9,59,0,inf
36786,62,8,70,0,inf
36787,66,12,78,0,inf
36788,64,5,69,1,0.7128425690131479
36789,59,5,64,0,inf
36790,60,13,73,0,inf
36791,63,10,73,0,inf
36792,60,12,72,0,inf
36793,67,12,79,0,inf
36794,63,9,72,0,inf
36795,60,9,69,0,inf
36796,61,10,71,0,inf
36797,57,6,63,0,inf
36798,50,12,62,0,inf
36799,60,9,69,0,inf
36800,55,8,63,0,inf
36801,50,10,60,0,inf
36802,55,6,61,0,inf
36803,53,8,61,0,inf
36804,51,8,59,0,inf
36805,52,13,65,0,inf
36806,65,10,75,0,inf
36807,62,5,67,0,inf
36808,66,9,75,0,inf
36809,52,13,65,0,inf
36810,57,9,66,0,inf
36811,60,6,66,0,inf
36812,57,10,67,0,inf
36813,57,6,63,0,inf
36814,52,12,64,0,inf
36815,51,6,57,0,inf
36816,60,8,68,0,inf
36817,64,7,71,0,inf
36818,62,8,70,0,inf
36819,58,5,63,0,inf
36820,52,12,64,0,inf
36821,53,11,64,0,inf
36822,67,9,76,0,inf
36823,53,6,59,0,inf
36824,60,10,70,0,inf
36825,67,13,80,0,inf
36826,63,9,72,0,inf
36827,62,8,70,0,inf
36828,52,9,61,0,inf
36829,58,7,65,0,inf
36830,66,7,73,0,inf
36831,50,8,58,0,inf
36832,63,13,76,0,inf
36833,50,10,60,0,inf
36834,55,9,64,0,inf
36835,60,7,67,0,inf
36836,63,8,71,0,inf
36837,50,12,62,0,inf
36838,62,8,70,0,inf
36839,55,7,62,0,inf
36840,52,5,57,0,inf
36841,55,10,65,0,inf
36842,58,8,66,0,inf
36843,62,7,69,0,inf
36844,52,9,61,0,inf
36845,67,12,79,0,inf
36846,65,8,73,0,inf
36847,64,10,74,0,inf
36848,60,8,68,0,inf
36849,62,7,69,0,inf
36850,59,10,69,1,3.7423662324236133
36851,60,11,71,0,inf
36852,54,12,66,0,inf
36853,67,6,73,0,inf
36854,65,5,70,0,inf
36855,55,9,64,0,inf
36856,53,6,59,0,inf
36857,65,9,74,0,inf
36858,54,10,64,0,inf
36859,50,7,57,0,inf
36860,59,6,65,0,inf
36861,60,11,71,0,inf
36862,65,6,71,0,inf
36863,62,13,75,0,inf
36864,50,5,55,0,inf
36865,55,7,62,0,inf
36866,64,9,73,0,inf
36867,66,10,76,0,inf
36868,63,10,73,0,inf
36869,57,12,69,0,inf
36870,57,12,69,0,inf
36871,51,10,61,0,inf
36872,56,13,69,0,inf
36873,55,8,63,0,inf
36874,58,11,69,0,inf
36875,52,5,57,0,inf
36876,50,8,58,0,inf
36877,50,8,58,0,inf
36878,51,11,62,0,inf
36879,60,12,72,0,inf
36880,54,9,63,0,inf
36881,55,8,63,0,inf
36882,55,10,65,0,inf
36883,60,8,68,0,inf
36884,55,13,68,0,inf
36885,67,8,75,0,inf
36886,52,6,58,0,inf
36887,64,7,71,0,inf
36888,53,8,61,0,inf
36889,54,8,62,0,inf
36890,53,11,64,0,inf
36891,65,13,78,0,inf
36892,61,13,74,0,inf
36893,67,12,79,0,inf
36894,60,10,70,0,inf
36895,63,10,73,0,inf
36896,67,5,72,0,inf
36897,54,5,59,0,inf
36898,57,7,64,0,inf
36899,50,5,55,0,inf
36900,61,6,67,0,inf
36901,56,5,61,0,inf
36902,51,13,64,0,inf
36903,64,6,70,0,inf
36904,60,9,69,0,inf
36905,66,11,77,0,inf
36906,67,7,74,0,inf
36907,57,9,66,0,inf
36908,62,7,69,0,inf
36909,57,8,65,0,inf
36910,58,5,63,0,inf
36911,62,10,72,0,inf
36912,56,7,63,0,inf
36913,50,9,59,0,inf
36914,67,8,75,0,inf
36915,58,9,67,0,inf
36916,59,8,67,0,inf
36917,61,10,71,0,inf
36918,56,5,61,0,inf
36919,53,7,60,0,inf
36920,61,12,73,0,inf
36921,65,11,76,0,inf
36922,63,13,76,0,inf
36923,52,8,60,0,inf
36924,53,5,58,0,inf
36925,56,13,69,0,inf
36926,58,9,67,0,inf
36927,58,10,68,0,inf
36928,58,12,70,0,inf
36929,59,13,72,0,inf
36930,61,8,69,0,inf
36931,67,12,79,0,inf
36932,59,12,71,0,inf
36933,63,8,71,0,inf
36934,53,6,59,0,inf
36935,62,8,70,0,inf
36936,50,12,62,0,inf
36937,62,12,74,0,inf
36938,63,11,74,0,inf
36939,52,10,62,1,0.3504049033236498
36940,64,12,76,0,inf
36941,63,11,74,0,inf
36942,65,5,70,1,0.010559949045955364
36943,64,5,69,0,inf
36944,66,10,76,0,inf
36945,53,12,65,0,inf
36946,58,7,65,0,inf
36947,60,10,70,0,inf
36948,54,11,65,0,inf
36949,59,6,65,0,inf
36950,51,11,62,0,inf
36951,63,8,71,0,inf
36952,62,13,75,0,inf
36953,63,10,73,0,inf
36954,54,5,59,0,inf
36955,51,12,63,0,inf
36956,51,6,57,0,inf
36957,56,12,68,0,inf
36958,56,9,65,0,inf
36959,55,13,68,0,inf
36960,63,13,76,0,inf
36961,57,12,69,0,inf
36962,59,13,72,0,inf
36963,54,13,67,0,inf
36964,65,9,74,0,inf
36965,60,8,68,0,inf
36966,61,13,74,0,inf
36967,57,11,68,0,inf
36968,55,8,63,0,inf
36969,58,9,67,0,inf
36970,60,10,70,0,inf
36971,65,11,76,0,inf
36972,50,6,56,0,inf
36973,57,11,68,0,inf
36974,52,13,65,0,inf
36975,61,7,68,0,inf
36976,57,10,67,0,inf
36977,56,7,63,0,inf
36978,61,5,66,0,inf
36979,57,6,63,0,inf
36980,58,9,67,0,inf
36981,61,10,71,0,inf
36982,61,11,72,0,inf
36983,57,5,62,0,inf
36984,58,8,66,0,inf
36985,60,12,72,0,inf
36986,57,5,62,0,inf
36987,52,11,63,0,inf
36988,60,6,66,0,inf
36989,65,6,71,0,inf
36990,59,5,64,0,inf
36991,51,13,64,0,inf
36992,53,11,64,0,inf
36993,55,6,61,0,inf
36994,65,5,70,0,inf
36995,61,8,69,0,inf
36996,58,6,64,0,inf
36997,64,9,73,0,inf
36998,62,11,73,0,inf
36999,52,6,58,0,inf
37000,62,5,67,0,inf
37001,53,5,58,0,inf
37002,64,9,73,0,inf
37003,59,13,72,0,inf
37004,64,7,71,0,inf
37005,52,12,64,0,inf
37006,53,11,64,0,inf
37007,67,11,78,0,inf
37008,67,7,74,0,inf
37009,63,8,71,0,inf
37010,56,8,64,0,inf
37011,60,6,66,0,inf
37012,51,13,64,0,inf
37013,61,11,72,0,inf
37014,58,7,65,0,inf
37015,58,5,63,0,inf
37016,67,7,74,0,inf
37017,57,13,70,0,inf
37018,63,6,69,0,inf
37019,58,12,70,0,inf
37020,58,9,67,0,inf
37021,50,8,58,0,inf
37022,52,5,57,0,inf
37023,57,6,63,0,inf
37024,60,5,65,0,inf
37025,56,10,66,0,inf
37026,64,10,74,0,inf
37027,50,9,59,0,inf
37028,61,12,73,0,inf
37029,58,7,65,0,inf
37030,55,10,65,0,inf
37031,64,8,72,0,inf
37032,55,9,64,0,inf
37033,62,12,74,0,inf
37034,55,5,60,0,inf
37035,67,5,72,0,inf
37036,64,9,73,0,inf
37037,55,12,67,0,inf
37038,50,9,59,0,inf
37039,50,7,57,0,inf
37040,55,12,67,0,inf
37041,60,11,71,0,inf
37042,60,11,71,0,inf
37043,61,7,68,0,inf
37044,53,13,66,0,inf
37045,50,7,57,0,inf
37046,51,7,58,0,inf
37047,53,13,66,0,inf
37048,55,13,68,0,inf
37049,61,12,73,0,inf
37050,58,10,68,0,inf
37051,60,8,68,0,inf
37052,58,11,69,0,inf
37053,50,6,56,0,inf
37054,61,7,68,0,inf
37055,61,6,67,0,inf
37056,52,11,63,0,inf
37057,60,9,69,0,inf
37058,64,10,74,0,inf
37059,59,11,70,0,inf
37060,62,12,74,0,inf
37061,52,7,59,0,inf
37062,58,8,66,1,7.416075148289565
37063,60,9,69,0,inf
37064,54,8,62,0,inf
37065,63,8,71,0,inf
37066,62,8,70,0,inf
37067,52,6,58,0,inf
37068,61,9,70,1,4.5817271089658504
37069,59,6,65,0,inf
37070,55,6,61,0,inf
37071,65,6,71,0,inf
37072,62,10,72,0,inf
37073,56,9,65,0,inf
37074,57,8,65,0,inf
37075,58,8,66,0,inf
37076,61,8,69,0,inf
37077,53,10,63,0,inf
37078,58,10,68,0,inf
37079,59,13,72,0,inf
37080,58,12,70,1,8.464287842137082
37081,58,10,68,0,inf
37082,61,13,74,0,inf
37083,66,9,75,0,inf
37084,53,6,59,0,inf
37085,56,11,67,0,inf
37086,63,13,76,0,inf
37087,55,8,63,0,inf
37088,53,8,61,0,inf
37089,62,12,74,0,inf
37090,62,5,67,0,inf
37091,66,12,78,0,inf
37092,55,12,67,0,inf
37093,65,13,78,0,inf
37094,51,10,61,0,inf
37095,53,6,59,0,inf
37096,58,11,69,0,inf
37097,50,9,59,0,inf
37098,54,11,65,0,inf
37099,67,6,73,0,inf
37100,62,12,74,0,inf
37101,53,6,59,0,inf
37102,53,6,59,0,inf
37103,64,7,71,0,inf
37104,53,5,58,0,inf
37105,63,8,71,0,inf
37106,54,9,63,0,inf
37107,60,5,65,0,inf
37108,65,9,74,0,inf
37109,51,10,61,0,inf
37110,61,11,72,0,inf
37111,50,10,60,0,inf
37112,50,13,63,0,inf
37113,59,7,66,0,inf
37114,51,5,56,0,inf
37115,58,8,66,0,inf
37116,55,9,64,0,inf
37117,60,9,69,0,inf
37118,67,6,73,0,inf
37119,59,6,65,0,inf
37120,67,9,76,0,inf
37121,64,6,70,0,inf
37122,55,6,61,0,inf
37123,62,11,73,0,inf
37124,65,11,76,0,inf
37125,59,8,67,0,inf
37126,53,10,63,0,inf
37127,59,13,72,0,inf
37128,60,5,65,0,inf
37129,52,9,61,0,inf
37130,55,13,68,0,inf
37131,57,8,65,0,inf
37132,51,5,56,0,inf
37133,66,7,73,0,inf
37134,56,12,68,0,inf
37135,60,13,73,0,inf
37136,56,11,67,0,inf
37137,61,6,67,0,inf
37138,60,6,66,0,inf
37139,61,10,71,0,inf
37140,63,13,76,0,inf
37141,50,7,57,0,inf
37142,61,5,66,0,inf
37143,55,6,61,0,inf
37144,60,10,70,0,inf
37145,53,6,59,0,inf
37146,54,9,63,1,3.3893956229566484
37147,57,8,65,0,inf
37148,56,9,65,0,inf
37149,58,11,69,0,inf
37150,67,13,80,0,inf
37151,53,13,66,0,inf
37152,65,8,73,0,inf
37153,66,8,74,0,inf
37154,61,11,72,0,inf
37155,51,9,60,0,inf
37156,55,7,62,0,inf
37157,59,10,69,0,inf
37158,67,11,78,0,inf
37159,67,8,75,0,inf
37160,53,10,63,0,inf
37161,55,7,62,0,inf
37162,52,5,57,0,inf
37163,52,5,57,0,inf
37164,62,13,75,0,inf
37165,60,11,71,0,inf
37166,61,13,74,0,inf
37167,59,9,68,0,inf
37168,52,5,57,0,inf
37169,65,7,72,0,inf
37170,60,7,67,0,inf
37171,51,12,63,0,inf
37172,55,10,65,0,inf
37173,57,6,63,0,inf
37174,51,5,56,0,inf
37175,65,8,73,0,inf
37176,59,9,68,0,inf
37177,65,11,76,0,inf
37178,59,12,71,0,inf
37179,51,8,59,0,inf
37180,65,9,74,0,inf
37181,54,6,60,0,inf
37182,61,6,67,0,inf
37183,66,7,73,0,inf
37184,57,5,62,0,inf
37185,54,6,60,0,inf
37186,64,9,73,0,inf
37187,60,5,65,0,inf
37188,64,6,70,0,inf
37189,50,11,61,0,inf
37190,66,10,76,0,inf
37191,57,5,62,0,inf
37192,54,7,61,0,inf
37193,67,7,74,1,3.5225992356444777
37194,52,9,61,0,inf
37195,53,8,61,0,inf
37196,57,11,68,0,inf
37197,65,5,70,0,inf
37198,50,6,56,0,inf
37199,55,6,61,0,inf
37200,52,7,59,0,inf
37201,64,12,76,0,inf
37202,62,13,75,0,inf
37203,57,8,65,0,inf
37204,65,8,73,0,inf
37205,66,6,72,0,inf
37206,53,7,60,0,inf
37207,61,10,71,0,inf
37208,52,7,59,0,inf
37209,65,10,75,0,inf
37210,50,12,62,0,inf
37211,64,8,72,0,inf
37212,59,9,68,0,inf
37213,59,13,72,0,inf
37214,60,12,72,0,inf
37215,65,5,70,0,inf
37216,60,7,67,0,inf
37217,53,12,65,0,inf
37218,57,8,65,0,inf
37219,60,12,72,0,inf
37220,55,7,62,0,inf
37221,51,7,58,0,inf
37222,66,10,76,0,inf
37223,62,7,69,0,inf
37224,65,13,78,0,inf
37225,64,11,75,0,inf
37226,59,9,68,0,inf
37227,54,5,59,0,inf
37228,55,13,68,0,inf
37229,58,5,63,0,inf
37230,54,8,62,0,inf
37231,58,10,68,0,inf
37232,58,5,63,0,inf
37233,61,13,74,0,inf
37234,67,5,72,0,inf
37235,53,5,58,0,inf
37236,57,6,63,0,inf
37237,63,6,69,0,inf
37238,53,9,62,0,inf
37239,67,7,74,0,inf
37240,58,13,71,0,inf
37241,63,7,70,0,inf
37242,66,8,74,0,inf
37243,58,8,66,0,inf
37244,66,6,72,0,inf
37245,64,9,73,0,inf
37246,58,11,69,0,inf
37247,66,9,75,1,5.073115996838837
37248,60,6,66,0,inf
37249,51,9,60,0,inf
37250,67,10,77,0,inf
37251,64,6,70,0,inf
37252,51,6,57,0,inf
37253,62,10,72,0,inf
37254,63,9,72,0,inf
37255,65,7,72,0,inf
37256,58,6,64,0,inf
37257,61,9,70,0,inf
37258,57,13,70,0,inf
37259,58,7,65,0,inf
37260,67,12,79,0,inf
37261,59,7,66,0,inf
37262,63,13,76,0,inf
37263,59,5,64,0,inf
37264,50,9,59,0,inf
37265,67,7,74,0,inf
37266,54,12,66,0,inf
37267,52,6,58,0,inf
37268,52,9,61,0,inf
37269,66,12,78,0,inf
37270,58,8,66,0,inf
37271,55,10,65,0,inf
37272,58,13,71,0,inf
37273,54,12,66,0,inf
37274,59,8,67,0,inf
37275,52,13,65,0,inf
37276,67,8,75,0,inf
37277,64,5,69,0,inf
37278,58,5,63,0,inf
37279,64,6,70,0,inf
37280,60,11,71,0,inf
37281,58,8,66,0,inf
37282,59,13,72,0,inf
37283,56,10,66,0,inf
37284,50,8,58,0,inf
37285,65,5,70,0,inf
37286,54,7,61,0,inf
37287,53,13,66,0,inf
37288,61,6,67,0,inf
37289,62,13,75,0,inf
37290,55,5,60,0,inf
37291,51,13,64,0,inf
37292,62,13,75,0,inf
37293,57,9,66,0,inf
37294,57,9,66,0,inf
37295,58,12,70,0,inf
37296,50,10,60,0,inf
37297,61,9,70,0,inf
37298,54,12,66,0,inf
37299,56,11,67,0,inf
37300,51,5,56,0,inf
37301,61,10,71,0,inf
37302,51,5,56,0,inf
37303,54,9,63,0,inf
37304,52,6,58,0,inf
37305,63,9,72,0,inf
37306,65,12,77,0,inf
37307,63,5,68,0,inf
37308,53,7,60,0,inf
37309,55,11,66,0,inf
37310,53,9,62,0,inf
37311,61,7,68,0,inf
37312,53,7,60,0,inf
37313,51,5,56,0,inf
37314,53,5,58,0,inf
37315,63,5,68,0,inf
37316,52,10,62,0,inf
37317,56,12,68,0,inf
37318,65,11,76,0,inf
37319,64,13,77,0,inf
37320,52,10,62,0,inf
37321,61,10,71,0,inf
37322,62,9,71,0,inf
37323,63,8,71,0,inf
37324,63,10,73,0,inf
37325,63,6,69,0,inf
37326,66,8,74,0,inf
37327,51,6,57,0,inf
37328,52,8,60,0,inf
37329,63,9,72,0,inf
37330,59,7,66,0,inf
37331,67,13,80,1,4.131431740679275
37332,63,6,69,1,0.4300747877684259
37333,52,6,58,0,inf
37334,58,6,64,0,inf
37335,56,13,69,0,inf
37336,56,8,64,0,inf
37337,51,10,61,0,inf
37338,65,13,78,0,inf
37339,66,12,78,0,inf
37340,55,13,68,0,inf
37341,52,13,65,0,inf
37342,64,10,74,0,inf
37343,51,8,59,0,inf
37344,67,7,74,0,inf
37345,52,10,62,0,inf
37346,60,7,67,0,inf
37347,53,5,58,0,inf
37348,63,7,70,0,inf
37349,50,9,59,0,inf
37350,59,12,71,0,inf
37351,54,9,63,0,inf
37352,67,6,73,0,inf
37353,66,13,79,0,inf
37354,56,8,64,0,inf
37355,51,13,64,0,inf
37356,63,12,75,0,inf
37357,51,13,64,0,inf
37358,60,6,66,0,inf
37359,55,5,60,0,inf
37360,60,12,72,0,inf
37361,56,11,67,0,inf
37362,62,9,71,0,inf
37363,52,8,60,0,inf
37364,57,9,66,0,inf
37365,56,11,67,0,inf
37366,59,7,66,0,inf
37367,57,8,65,0,inf
37368,54,5,59,0,inf
37369,64,8,72,0,inf
37370,67,13,80,0,inf
37371,66,6,72,0,inf
37372,54,6,60,0,inf
37373,57,7,64,0,inf
37374,54,11,65,0,inf
37375,60,11,71,0,inf
37376,66,8,74,0,inf
37377,50,13,63,0,inf
37378,50,7,57,0,inf
37379,64,9,73,0,inf
37380,54,10,64,1,1.5588779272111566
37381,54,12,66,1,9.072825887469264
37382,58,7,65,0,inf
37383,55,10,65,0,inf
37384,55,8,63,1,5.357623235636652
37385,60,10,70,0,inf
37386,59,9,68,0,inf
37387,60,11,71,0,inf
37388,54,5,59,0,inf
37389,55,6,61,0,inf
37390,66,7,73,0,inf
37391,57,9,66,0,inf
37392,56,8,64,0,inf
37393,53,12,65,0,inf
37394,60,7,67,0,inf
37395,61,9,70,0,inf
37396,65,11,76,0,inf
37397,64,6,70,0,inf
37398,63,6,69,0,inf
37399,51,13,64,0,inf
37400,64,8,72,0,inf
37401,63,7,70,0,inf
37402,52,8,60,0,inf
37403,67,5,72,0,inf
37404,51,10,61,0,inf
37405,59,6,65,0,inf
37406,65,5,70,0,inf
37407,65,12,77,0,inf
37408,60,12,72,0,inf
37409,55,11,66,0,inf
37410,64,13,77,0,inf
37411,59,11,70,0,inf
37412,54,7,61,0,inf
37413,66,6,72,0,inf
37414,60,6,66,0,inf
37415,57,10,67,0,inf
37416,63,13,76,0,inf
37417,57,13,70,0,inf
37418,50,12,62,0,inf
37419,55,10,65,0,inf
37420,67,6,73,0,inf
37421,52,8,60,0,inf
37422,67,8,75,0,inf
37423,54,6,60,0,inf
37424,65,7,72,0,inf
37425,65,7,72,0,inf
37426,56,8,64,0,inf
37427,60,12,72,0,inf
37428,50,6,56,0,inf
37429,58,6,64,0,inf
37430,62,11,73,0,inf
37431,65,11,76,0,inf
37432,64,5,69,0,inf
37433,55,7,62,0,inf
37434,66,10,76,0,inf
37435,52,13,65,0,inf
37436,61,8,69,0,inf
37437,54,7,61,0,inf
37438,67,10,77,0,inf
37439,54,11,65,0,inf
37440,60,7,67,0,inf
37441,53,5,58,0,inf
37442,61,5,66,0,inf
37443,53,11,64,0,inf
37444,54,12,66,0,inf
37445,62,12,74,1,7.2044015600695985
37446,60,11,71,0,inf
37447,51,7,58,0,inf
37448,60,8,68,0,inf
37449,55,10,65,0,inf
37450,64,5,69,0,inf
37451,59,13,72,0,inf
37452,54,7,61,0,inf
37453,60,13,73,0,inf
37454,58,6,64,0,inf
37455,53,6,59,0,inf
37456,57,12,69,1,6.271160880439005
37457,55,6,61,0,inf
37458,55,7,62,0,inf
37459,60,13,73,0,inf
37460,55,6,61,0,inf
37461,59,9,68,0,inf
37462,59,10,69,0,inf
37463,63,7,70,0,inf
37464,50,8,58,0,inf
37465,66,10,76,1,1.8755590378157194
37466,52,5,57,0,inf
37467,56,6,62,0,inf
37468,64,13,77,0,inf
37469,51,6,57,0,inf
37470,52,11,63,0,inf
37471,61,8,69,0,inf
37472,64,9,73,0,inf
37473,63,5,68,0,inf
37474,59,11,70,0,inf
37475,62,7,69,0,inf
37476,66,13,79,0,inf
37477,64,11,75,0,inf
37478,60,10,70,0,inf
37479,51,5,56,0,inf
37480,61,11,72,0,inf
37481,61,8,69,0,inf
37482,65,12,77,0,inf
37483,55,7,62,0,inf
37484,66,9,75,0,inf
37485,55,8,63,0,inf
37486,64,7,71,0,inf
37487,58,7,65,0,inf
37488,55,8,63,0,inf
37489,66,10,76,1,0.41638187278921635
37490,66,9,75,0,inf
37491,55,11,66,0,inf
37492,63,8,71,0,inf
37493,59,10,69,0,inf
37494,62,12,74,0,inf
37495,50,10,60,0,inf
37496,63,12,75,0,inf
37497,63,6,69,0,inf
37498,50,12,62,0,inf
37499,66,11,77,0,inf
37500,58,6,64,0,inf
37501,65,6,71,0,inf
37502,51,9,60,1,1.0952041977840068
37503,52,10,62,0,inf
37504,55,5,60,0,inf
37505,56,12,68,0,inf
37506,59,13,72,0,inf
37507,64,10,74,0,inf
37508,65,7,72,0,inf
37509,62,8,70,0,inf
37510,57,12,69,0,inf
37511,52,6,58,0,inf
37512,55,11,66,0,inf
37513,56,7,63,0,inf
37514,60,11,71,0,inf
37515,60,13,73,0,inf
37516,62,9,71,0,inf
37517,50,10,60,0,inf
37518,61,10,71,0,inf
37519,53,10,63,0,inf
37520,56,5,61,0,inf
37521,61,11,72,0,inf
37522,63,7,70,0,inf
37523,60,8,68,0,inf
37524,57,11,68,0,inf
37525,56,8,64,0,inf
37526,62,8,70,0,inf
37527,62,13,75,0,inf
37528,62,9,71,0,inf
37529,53,12,65,0,inf
37530,63,13,76,0,inf
37531,61,5,66,0,inf
37532,63,5,68,0,inf
37533,56,10,66,0,inf
37534,57,12,69,0,inf
37535,53,11,64,0,inf
37536,51,7,58,0,inf
37537,63,6,69,0,inf
37538,53,12,65,0,inf
37539,63,10,73,0,inf
37540,63,5,68,0,inf
37541,55,10,65,0,inf
37542,59,13,72,0,inf
37543,53,8,61,0,inf
37544,58,12,70,0,inf
37545,63,8,71,0,inf
37546,65,10,75,0,inf
37547,53,13,66,0,inf
37548,52,7,59,0,inf
37549,58,7,65,0,inf
37550,53,6,59,0,inf
37551,57,12,69,0,inf
37552,57,5,62,0,inf
37553,57,7,64,0,inf
37554,61,6,67,0,inf
37555,63,13,76,0,inf
37556,60,9,69,0,inf
37557,58,7,65,0,inf
37558,57,9,66,0,inf
37559,65,7,72,0,inf
37560,65,6,71,0,inf
37561,60,8,68,0,inf
37562,67,11,78,0,inf
37563,56,11,67,0,inf
37564,56,11,67,0,inf
37565,52,10,62,0,inf
37566,65,6,71,0,inf
37567,55,13,68,0,inf
37568,53,13,66,0,inf
37569,58,9,67,0,inf
37570,58,11,69,0,inf
37571,56,7,63,0,inf
37572,52,5,57,0,inf
37573,66,11,77,0,inf
37574,56,11,67,0,inf
37575,62,12,74,0,inf
37576,61,11,72,0,inf
37577,61,11,72,0,inf
37578,50,6,56,0,inf
37579,64,7,71,0,inf
37580,60,5,65,0,inf
37581,61,9,70,0,inf
37582,51,8,59,0,inf
37583,55,10,65,0,inf
37584,63,9,72,0,inf
37585,50,8,58,0,inf
37586,65,11,76,0,inf
37587,62,9,71,0,inf
37588,50,9,59,0,inf
37589,65,8,73,0,inf
37590,51,9,60,0,inf
37591,57,7,64,0,inf
37592,66,13,79,0,inf
37593,61,8,69,0,inf
37594,51,12,63,0,inf
37595,61,10,71,0,inf
37596,50,11,61,0,inf
37597,66,13,79,0,inf
37598,59,7,66,0,inf
37599,53,8,61,0,inf
37600,53,11,64,0,inf
37601,56,7,63,0,inf
37602,67,11,78,0,inf
37603,54,8,62,0,inf
37604,52,11,63,0,inf
37605,59,7,66,0,inf
37606,58,8,66,0,inf
37607,64,10,74,0,inf
37608,53,8,61,0,inf
37609,59,9,68,0,inf
37610,65,13,78,0,inf
37611,63,6,69,0,inf
37612,66,12,78,0,inf
37613,64,13,77,1,3.8362636315986407
37614,62,7,69,1,5.358736772223537
37615,51,13,64,1,1.1549973815499897
37616,51,10,61,0,inf
37617,65,8,73,0,inf
37618,65,13,78,0,inf
37619,52,13,65,0,inf
37620,50,6,56,0,inf
37621,52,12,64,1,1.0841183679255977
37622,63,7,70,0,inf
37623,55,5,60,0,inf
37624,52,13,65,0,inf
37625,57,11,68,0,inf
37626,54,9,63,0,inf
37627,58,13,71,1,7.217811454933795
37628,64,5,69,0,inf
37629,55,11,66,0,inf
37630,58,5,63,0,inf
37631,51,9,60,0,inf
37632,64,6,70,0,inf
37633,52,12,64,0,inf
37634,60,10,70,0,inf
37635,53,8,61,0,inf
37636,54,7,61,0,inf
37637,54,12,66,0,inf
37638,64,8,72,0,inf
37639,51,9,60,0,inf
37640,66,7,73,0,inf
37641,59,10,69,0,inf
37642,65,13,78,0,inf
37643,61,13,74,0,inf
37644,54,12,66,0,inf
37645,52,6,58,0,inf
37646,55,8,63,0,inf
37647,65,10,75,0,inf
37648,58,7,65,0,inf
37649,65,6,71,0,inf
37650,51,5,56,0,inf
37651,58,8,66,0,inf
37652,65,10,75,0,inf
37653,62,10,72,0,inf
37654,58,9,67,0,inf
37655,58,10,68,0,inf
37656,62,5,67,0,inf
37657,60,9,69,0,inf
37658,66,6,72,0,inf
37659,52,11,63,0,inf
37660,64,9,73,0,inf
37661,62,12,74,0,inf
37662,54,10,64,0,inf
37663,59,13,72,0,inf
37664,63,7,70,0,inf
37665,51,13,64,0,inf
37666,53,5,58,0,inf
37667,64,10,74,0,inf
37668,54,9,63,0,inf
37669,60,5,65,0,inf
37670,56,5,61,0,inf
37671,65,8,73,0,inf
37672,54,7,61,0,inf
37673,57,9,66,0,inf
37674,52,11,63,0,inf
37675,54,8,62,0,inf
37676,64,5,69,0,inf
37677,58,7,65,0,inf
37678,61,12,73,0,inf
37679,60,13,73,0,inf
37680,61,11,72,0,inf
37681,63,9,72,0,inf
37682,67,13,80,0,inf
37683,50,9,59,0,inf
37684,55,10,65,0,inf
37685,55,13,68,0,inf
37686,56,11,67,0,inf
37687,63,10,73,0,inf
37688,62,7,69,0,inf
37689,66,12,78,0,inf
37690,62,7,69,0,inf
37691,67,6,73,0,inf
37692,51,7,58,0,inf
37693,57,6,63,0,inf
37694,53,12,65,0,inf
37695,54,9,63,0,inf
37696,56,7,63,0,inf
37697,55,6,61,0,inf
37698,64,8,72,0,inf
37699,56,5,61,0,inf
37700,57,8,65,0,inf
37701,67,9,76,1,4.553102451760196
37702,59,6,65,0,inf
37703,51,7,58,0,inf
37704,50,8,58,1,4.124095248089965
37705,51,8,59,0,inf
37706,57,7,64,0,inf
37707,64,12,76,0,inf
37708,60,9,69,0,inf
37709,52,10,62,0,inf
37710,55,13,68,0,inf
37711,58,9,67,0,inf
37712,62,5,67,0,inf
37713,55,6,61,0,inf
37714,51,6,57,0,inf
37715,56,6,62,1,3.030568269583661
37716,60,11,71,0,inf
37717,67,10,77,0,inf
37718,53,8,61,0,inf
37719,52,5,57,0,inf
37720,56,9,65,0,inf
37721,55,12,67,0,inf
37722,67,10,77,0,inf
37723,59,7,66,0,inf
37724,58,12,70,0,inf
37725,65,5,70,0,inf
37726,67,7,74,0,inf
37727,65,9,74,0,inf
37728,64,6,70,0,inf
37729,53,10,63,0,inf
37730,56,9,65,0,inf
37731,54,5,59,0,inf
37732,54,11,65,0,inf
37733,65,6,71,0,inf
37734,63,7,70,0,inf
37735,53,7,60,0,inf
37736,61,12,73,0,inf
37737,65,12,77,0,inf
37738,55,7,62,0,inf
37739,65,6,71,0,inf
37740,63,10,73,0,inf
37741,62,13,75,0,inf
37742,62,10,72,0,inf
37743,66,10,76,0,inf
37744,67,11,78,0,inf
37745,56,8,64,0,inf
37746,52,9,61,0,inf
37747,54,8,62,0,inf
37748,59,13,72,0,inf
37749,55,9,64,0,inf
37750,58,12,70,0,inf
37751,64,13,77,0,inf
37752,56,8,64,0,inf
37753,64,8,72,0,inf
37754,54,5,59,0,inf
37755,65,5,70,0,inf
37756,58,9,67,0,inf
37757,64,7,71,0,inf
37758,57,10,67,0,inf
37759,51,11,62,0,inf
37760,56,10,66,0,inf
37761,50,13,63,0,inf
37762,54,11,65,0,inf
37763,63,12,75,0,inf
37764,51,9,60,0,inf
37765,65,7,72,0,inf
37766,50,10,60,0,inf
37767,58,6,64,0,inf
37768,54,10,64,0,inf
37769,55,6,61,0,inf
37770,59,9,68,0,inf
37771,58,6,64,0,inf
37772,51,6,57,0,inf
37773,63,11,74,0,inf
37774,56,13,69,0,inf
37775,63,11,74,0,inf
37776,60,7,67,0,inf
37777,52,9,61,0,inf
37778,65,6,71,0,inf
37779,50,9,59,0,inf
37780,65,5,70,0,inf
37781,60,7,67,0,inf
37782,55,10,65,0,inf
37783,65,10,75,0,inf
37784,61,11,72,0,inf
37785,64,13,77,0,inf
37786,57,6,63,0,inf
37787,61,11,72,0,inf
37788,65,10,75,0,inf
37789,50,13,63,0,inf
37790,58,6,64,0,inf
37791,51,5,56,0,inf
37792,57,11,68,0,inf
37793,63,9,72,0,inf
37794,54,13,67,0,inf
37795,50,8,58,0,inf
37796,50,11,61,0,inf
37797,53,7,60,0,inf
37798,57,5,62,0,inf
37799,57,13,70,0,inf
37800,64,10,74,0,inf
37801,64,9,73,0,inf
37802,56,8,64,0,inf
37803,62,9,71,0,inf
37804,59,8,67,0,inf
37805,55,8,63,0,inf
37806,52,13,65,0,inf
37807,57,5,62,0,inf
37808,59,12,71,0,inf
37809,61,5,66,0,inf
37810,53,13,66,0,inf
37811,66,8,74,0,inf
37812,51,7,58,0,inf
37813,57,13,70,0,inf
37814,61,13,74,0,inf
37815,53,13,66,0,inf
37816,50,6,56,0,inf
37817,50,11,61,0,inf
37818,64,12,76,0,inf
37819,61,11,72,0,inf
37820,54,12,66,0,inf
37821,60,8,68,0,inf
37822,59,6,65,0,inf
37823,55,12,67,0,inf
37824,64,12,76,0,inf
37825,59,11,70,1,6.6243317751010125
37826,51,6,57,0,inf
37827,54,13,67,0,inf
37828,61,8,69,0,inf
37829,65,10,75,0,inf
37830,51,9,60,0,inf
37831,53,11,64,0,inf
37832,56,12,68,0,inf
37833,54,6,60,0,inf
37834,65,8,73,0,inf
37835,50,10,60,0,inf
37836,55,10,65,0,inf
37837,57,7,64,0,inf
37838,66,13,79,0,inf
37839,64,12,76,0,inf
37840,63,6,69,0,inf
37841,52,13,65,0,inf
37842,64,8,72,0,inf
37843,56,8,64,0,inf
37844,54,12,66,0,inf
37845,63,8,71,0,inf
37846,57,5,62,0,inf
37847,53,7,60,0,inf
37848,64,12,76,0,inf
37849,67,13,80,0,inf
37850,61,5,66,0,inf
37851,66,8,74,0,inf
37852,51,7,58,0,inf
37853,54,7,61,0,inf
37854,59,7,66,0,inf
37855,55,7,62,0,inf
37856,67,11,78,0,inf
37857,59,13,72,0,inf
37858,64,6,70,0,inf
37859,56,6,62,0,inf
37860,59,11,70,0,inf
37861,61,10,71,0,inf
37862,64,13,77,0,inf
37863,52,9,61,0,inf
37864,64,9,73,0,inf
37865,55,9,64,0,inf
37866,61,13,74,0,inf
37867,53,8,61,0,inf
37868,51,10,61,0,inf
37869,62,10,72,0,inf
37870,51,10,61,0,inf
37871,55,12,67,0,inf
37872,53,10,63,0,inf
37873,54,13,67,0,inf
37874,64,10,74,0,inf
37875,56,9,65,0,inf
37876,57,13,70,0,inf
37877,55,5,60,0,inf
37878,59,11,70,0,inf
37879,56,11,67,0,inf
37880,55,7,62,0,inf
37881,52,6,58,0,inf
37882,51,13,64,0,inf
37883,67,8,75,0,inf
37884,64,12,76,0,inf
37885,54,5,59,0,inf
37886,67,10,77,0,inf
37887,57,5,62,0,inf
37888,57,10,67,0,inf
37889,53,12,65,0,inf
37890,61,5,66,0,inf
37891,63,9,72,0,inf
37892,56,12,68,0,inf
37893,60,11,71,0,inf
37894,64,6,70,0,inf
37895,52,6,58,0,inf
37896,56,8,64,0,inf
37897,59,6,65,0,inf
37898,56,11,67,0,inf
37899,57,7,64,0,inf
37900,59,8,67,0,inf
37901,60,9,69,0,inf
37902,64,10,74,0,inf
37903,66,11,77,0,inf
37904,57,8,65,0,inf
37905,58,6,64,0,inf
37906,50,7,57,0,inf
37907,55,7,62,0,inf
37908,59,13,72,0,inf
37909,59,5,64,0,inf
37910,54,6,60,0,inf
37911,51,7,58,0,inf
37912,63,6,69,0,inf
37913,58,9,67,0,inf
37914,52,13,65,0,inf
37915,64,13,77,0,inf
37916,59,8,67,0,inf
37917,66,8,74,0,inf
37918,52,8,60,0,inf
37919,56,8,64,0,inf
37920,61,7,68,0,inf
37921,62,10,72,0,inf
37922,55,11,66,0,inf
37923,64,6,70,1,5.9479062072954605
37924,61,5,66,0,inf
37925,52,10,62,1,4.591893144775852
37926,51,7,58,0,inf
37927,63,11,74,0,inf
37928,59,6,65,0,inf
37929,53,8,61,0,inf
37930,51,7,58,0,inf
37931,61,10,71,0,inf
37932,62,13,75,0,inf
37933,55,5,60,0,inf
37934,67,5,72,0,inf
37935,64,6,70,0,inf
37936,59,11,70,0,inf
37937,57,5,62,0,inf
37938,57,13,70,0,inf
37939,52,12,64,0,inf
37940,52,10,62,0,inf
37941,54,8,62,0,inf
37942,67,6,73,0,inf
37943,61,5,66,0,inf
37944,61,10,71,0,inf
37945,56,11,67,0,inf
37946,56,10,66,0,inf
37947,52,7,59,0,inf
37948,58,6,64,0,inf
37949,54,8,62,1,2.436478674417671
37950,65,10,75,0,inf
37951,50,7,57,0,inf
37952,50,6,56,0,inf
37953,66,12,78,0,inf
37954,57,7,64,0,inf
37955,55,13,68,0,inf
37956,56,8,64,0,inf
37957,59,12,71,0,inf
37958,59,13,72,0,inf
37959,65,10,75,0,inf
37960,63,8,71,0,inf
37961,56,10,66,0,inf
37962,66,8,74,0,inf
37963,59,12,71,0,inf
37964,62,5,67,0,inf
37965,62,12,74,0,inf
37966,56,13,69,0,inf
37967,50,10,60,0,inf
37968,51,6,57,0,inf
37969,59,9,68,0,inf
37970,58,5,63,0,inf
37971,55,8,63,0,inf
37972,65,6,71,0,inf
37973,53,11,64,0,inf
37974,52,5,57,0,inf
37975,55,7,62,0,inf
37976,60,13,73,0,inf
37977,50,10,60,0,inf
37978,51,12,63,0,inf
37979,66,10,76,0,inf
37980,58,7,65,0,inf
37981,64,12,76,0,inf
37982,58,12,70,0,inf
37983,64,10,74,0,inf
37984,60,13,73,0,inf
37985,50,13,63,1,11.544822118748826
37986,57,11,68,0,inf
37987,51,10,61,0,inf
37988,61,5,66,0,inf
37989,66,11,77,0,inf
37990,53,11,64,0,inf
37991,59,12,71,0,inf
37992,54,8,62,0,inf
37993,56,12,68,0,inf
37994,63,9,72,0,inf
37995,54,10,64,0,inf
37996,62,6,68,0,inf
37997,55,10,65,0,inf
37998,67,8,75,0,inf
37999,53,13,66,0,inf
38000,57,11,68,0,inf
38001,57,6,63,0,inf
38002,55,8,63,0,inf
38003,55,6,61,0,inf
38004,65,10,75,0,inf
38005,61,13,74,0,inf
38006,60,13,73,0,inf
38007,67,11,78,0,inf
38008,58,12,70,0,inf
38009,63,9,72,0,inf
38010,54,13,67,0,inf
38011,53,6,59,0,inf
38012,67,9,76,0,inf
38013,64,7,71,0,inf
38014,58,9,67,0,inf
38015,64,6,70,0,inf
38016,51,12,63,0,inf
38017,58,6,64,0,inf
38018,51,5,56,0,inf
38019,53,6,59,0,inf
38020,66,6,72,0,inf
38021,66,7,73,0,inf
38022,60,11,71,0,inf
38023,59,8,67,0,inf
38024,67,8,75,0,inf
38025,60,5,65,0,inf
38026,55,8,63,0,inf
38027,55,9,64,0,inf
38028,57,13,70,0,inf
38029,61,5,66,1,1.7809808167748145
38030,67,13,80,0,inf
38031,50,10,60,0,inf
38032,53,5,58,0,inf
38033,53,6,59,0,inf
38034,51,12,63,0,inf
38035,64,6,70,0,inf
38036,50,5,55,0,inf
38037,51,10,61,0,inf
38038,54,9,63,0,inf
38039,53,13,66,0,inf
38040,62,8,70,0,inf
38041,62,7,69,0,inf
38042,65,11,76,0,inf
38043,59,7,66,0,inf
38044,65,9,74,0,inf
38045,50,6,56,0,inf
38046,65,13,78,1,10.285305665618338
38047,51,11,62,1,8.422522624991238
38048,64,7,71,0,inf
38049,67,12,79,1,10.307571593574195
38050,62,7,69,0,inf
38051,52,5,57,0,inf
38052,59,12,71,0,inf
38053,57,7,64,0,inf
38054,53,5,58,0,inf
38055,53,7,60,0,inf
38056,64,11,75,0,inf
38057,64,10,74,0,inf
38058,56,7,63,0,inf
38059,60,13,73,0,inf
38060,57,10,67,0,inf
38061,66,13,79,0,inf
38062,50,10,60,0,inf
38063,62,12,74,1,1.322123840616996
38064,66,7,73,0,inf
38065,64,12,76,0,inf
38066,63,11,74,0,inf
38067,60,12,72,1,11.812815415733056
38068,58,8,66,0,inf
38069,60,11,71,0,inf
38070,50,13,63,0,inf
38071,63,7,70,0,inf
38072,57,5,62,0,inf
38073,53,10,63,0,inf
38074,54,13,67,0,inf
38075,65,9,74,0,inf
38076,52,11,63,0,inf
38077,62,10,72,0,inf
38078,58,7,65,1,5.574068951471411
38079,64,6,70,0,inf
38080,62,10,72,1,6.583252823282919
38081,55,6,61,0,inf
38082,59,13,72,0,inf
38083,53,11,64,0,inf
38084,66,9,75,0,inf
38085,52,12,64,0,inf
38086,56,8,64,0,inf
38087,51,8,59,0,inf
38088,58,13,71,0,inf
38089,60,9,69,1,3.879137847221479
38090,65,7,72,0,inf
38091,56,10,66,0,inf
38092,50,12,62,0,inf
38093,66,9,75,0,inf
38094,67,6,73,0,inf
38095,52,12,64,0,inf
38096,54,12,66,1,8.965244330215448
38097,55,9,64,0,inf
38098,50,6,56,0,inf
38099,62,8,70,0,inf
38100,52,7,59,0,inf
38101,63,10,73,0,inf
38102,53,6,59,0,inf
38103,53,7,60,0,inf
38104,67,11,78,0,inf
38105,56,10,66,0,inf
38106,63,7,70,0,inf
38107,61,11,72,0,inf
38108,66,7,73,0,inf
38109,63,5,68,0,inf
38110,50,13,63,0,inf
38111,55,11,66,1,7.175546071536161
38112,62,9,71,0,inf
38113,57,6,63,0,inf
38114,67,8,75,0,inf
38115,60,9,69,0,inf
38116,57,12,69,0,inf
38117,59,8,67,0,inf
38118,53,9,62,0,inf
38119,53,10,63,0,inf
38120,56,9,65,0,inf
38121,59,10,69,0,inf
38122,52,13,65,0,inf
38123,56,9,65,1,5.19785420013914
38124,58,8,66,0,inf
38125,61,11,72,0,inf
38126,51,11,62,0,inf
38127,59,5,64,0,inf
38128,52,8,60,0,inf
38129,67,5,72,0,inf
38130,51,10,61,0,inf
38131,58,7,65,0,inf
38132,56,12,68,0,inf
38133,50,10,60,0,inf
38134,63,8,71,0,inf
38135,57,8,65,0,inf
38136,61,10,71,0,inf
38137,65,7,72,0,inf
38138,55,6,61,0,inf
38139,51,13,64,0,inf
38140,62,7,69,0,inf
38141,57,13,70,0,inf
38142,56,12,68,0,inf
38143,53,9,62,0,inf
38144,58,9,67,0,inf
38145,56,13,69,0,inf
38146,52,8,60,0,inf
38147,60,9,69,1,0.354279307359441
38148,61,6,67,0,inf
38149,67,11,78,0,inf
38150,51,7,58,0,inf
38151,65,10,75,0,inf
38152,55,13,68,0,inf
38153,52,8,60,0,inf
38154,61,12,73,0,inf
38155,52,9,61,0,inf
38156,51,10,61,0,inf
38157,53,9,62,0,inf
38158,56,12,68,0,inf
38159,66,9,75,0,inf
38160,64,6,70,0,inf
38161,55,5,60,0,inf
38162,66,8,74,0,inf
38163,52,7,59,0,inf
38164,59,12,71,0,inf
38165,66,7,73,0,inf
38166,60,11,71,0,inf
38167,60,7,67,1,3.876270649722521
38168,57,5,62,0,inf
38169,65,11,76,1,7.484302594332291
38170,60,5,65,0,inf
38171,65,6,71,0,inf
38172,50,10,60,0,inf
38173,57,12,69,0,inf
38174,65,6,71,0,inf
38175,66,13,79,0,inf
38176,65,7,72,0,inf
38177,63,7,70,0,inf
38178,65,13,78,0,inf
38179,52,6,58,0,inf
38180,62,7,69,0,inf
38181,63,5,68,0,inf
38182,59,11,70,0,inf
38183,59,7,66,0,inf
38184,63,7,70,0,inf
38185,52,10,62,0,inf
38186,52,7,59,0,inf
38187,59,6,65,0,inf
38188,51,5,56,0,inf
38189,51,5,56,0,inf
38190,64,11,75,0,inf
38191,53,9,62,0,inf
38192,60,6,66,0,inf
38193,53,5,58,1,3.2430149195864075
38194,61,12,73,0,inf
38195,54,11,65,0,inf
38196,63,12,75,0,inf
38197,58,12,70,0,inf
38198,59,7,66,0,inf
38199,58,7,65,0,inf
38200,54,12,66,0,inf
38201,59,6,65,0,inf
38202,56,5,61,0,inf
38203,53,9,62,0,inf
38204,59,8,67,0,inf
38205,60,6,66,0,inf
38206,55,6,61,0,inf
38207,64,12,76,0,inf
38208,52,5,57,0,inf
38209,65,11,76,1,2.4955475844842
38210,59,8,67,0,inf
38211,50,13,63,0,inf
38212,61,8,69,0,inf
38213,51,13,64,0,inf
38214,59,5,64,0,inf
38215,62,11,73,0,inf
38216,54,9,63,0,inf
38217,58,13,71,0,inf
38218,54,7,61,0,inf
38219,62,5,67,0,inf
38220,65,10,75,0,inf
38221,65,12,77,0,inf
38222,67,11,78,0,inf
38223,66,13,79,0,inf
38224,63,8,71,0,inf
38225,65,7,72,0,inf
38226,65,6,71,0,inf
38227,59,13,72,0,inf
38228,62,11,73,0,inf
38229,66,9,75,0,inf
38230,55,13,68,0,inf
38231,53,6,59,0,inf
38232,54,10,64,0,inf
38233,66,8,74,0,inf
38234,60,7,67,0,inf
38235,52,8,60,0,inf
38236,54,11,65,0,inf
38237,62,6,68,0,inf
38238,57,11,68,0,inf
38239,67,6,73,0,inf
38240,61,13,74,0,inf
38241,50,7,57,0,inf
38242,64,5,69,0,inf
38243,51,5,56,0,inf
38244,58,5,63,0,inf
38245,55,12,67,0,inf
38246,58,8,66,0,inf
38247,61,10,71,0,inf
38248,61,12,73,0,inf
38249,52,11,63,0,inf
38250,51,7,58,0,inf
38251,58,12,70,0,inf
38252,52,8,60,0,inf
38253,64,7,71,0,inf
38254,61,10,71,1,9.80506938088584
38255,58,5,63,0,inf
38256,63,8,71,0,inf
38257,58,12,70,0,inf
38258,54,10,64,0,inf
38259,51,10,61,0,inf
38260,65,8,73,0,inf
38261,65,5,70,0,inf
38262,65,6,71,0,inf
38263,51,11,62,0,inf
38264,65,12,77,0,inf
38265,52,13,65,0,inf
38266,60,11,71,0,inf
38267,54,9,63,0,inf
38268,60,5,65,0,inf
38269,60,9,69,0,inf
38270,64,8,72,0,inf
38271,62,12,74,1,5.9357363267436085
38272,64,10,74,0,inf
38273,56,12,68,0,inf
38274,65,10,75,0,inf
38275,53,12,65,0,inf
38276,66,5,71,0,inf
38277,54,6,60,0,inf
38278,60,7,67,0,inf
38279,53,6,59,0,inf
38280,60,12,72,0,inf
38281,53,11,64,0,inf
38282,64,13,77,0,inf
38283,51,5,56,0,inf
38284,54,12,66,0,inf
38285,65,7,72,0,inf
38286,50,9,59,0,inf
38287,64,6,70,0,inf
38288,54,7,61,0,inf
38289,63,8,71,0,inf
38290,57,13,70,0,inf
38291,61,6,67,0,inf
38292,65,5,70,0,inf
38293,52,9,61,0,inf
38294,67,7,74,0,inf
38295,50,10,60,0,inf
38296,60,5,65,0,inf
38297,53,7,60,0,inf
38298,64,12,76,1,4.497777864471658
38299,67,7,74,0,inf
38300,52,9,61,0,inf
38301,60,8,68,0,inf
38302,64,12,76,0,inf
38303,58,7,65,0,inf
38304,60,5,65,0,inf
38305,62,10,72,0,inf
38306,66,10,76,0,inf
38307,51,10,61,0,inf
38308,51,8,59,0,inf
38309,56,13,69,0,inf
38310,61,6,67,0,inf
38311,62,9,71,0,inf
38312,50,9,59,0,inf
38313,62,12,74,0,inf
38314,63,7,70,0,inf
38315,59,12,71,0,inf
38316,52,13,65,0,inf
38317,61,11,72,0,inf
38318,55,6,61,0,inf
38319,55,5,60,0,inf
38320,50,8,58,0,inf
38321,65,11,76,0,inf
38322,67,10,77,0,inf
38323,57,6,63,0,inf
38324,55,9,64,0,inf
38325,66,6,72,0,inf
38326,55,10,65,0,inf
38327,54,7,61,0,inf
38328,59,9,68,0,inf
38329,60,11,71,0,inf
38330,51,12,63,0,inf
38331,59,13,72,0,inf
38332,64,5,69,0,inf
38333,65,8,73,0,inf
38334,50,7,57,0,inf
38335,53,11,64,1,4.975958310320969
38336,66,9,75,0,inf
38337,55,6,61,0,inf
38338,54,7,61,0,inf
38339,52,7,59,0,inf
38340,55,7,62,0,inf
38341,60,7,67,0,inf
38342,50,10,60,0,inf
38343,52,8,60,0,inf
38344,55,7,62,0,inf
38345,56,7,63,0,inf
38346,66,13,79,0,inf
38347,57,8,65,0,inf
38348,59,10,69,0,inf
38349,61,12,73,0,inf
38350,61,9,70,0,inf
38351,58,8,66,0,inf
38352,52,9,61,0,inf
38353,56,10,66,0,inf
38354,66,11,77,0,inf
38355,64,13,77,0,inf
38356,54,5,59,0,inf
38357,52,10,62,0,inf
38358,51,13,64,0,inf
38359,64,8,72,0,inf
38360,65,7,72,0,inf
38361,55,5,60,0,inf
38362,56,11,67,0,inf
38363,56,10,66,0,inf
38364,63,13,76,0,inf
38365,66,9,75,0,inf
38366,58,5,63,0,inf
38367,67,12,79,0,inf
38368,57,11,68,0,inf
38369,52,5,57,0,inf
38370,65,8,73,0,inf
38371,58,7,65,0,inf
38372,65,10,75,0,inf
38373,64,9,73,0,inf
38374,52,8,60,0,inf
38375,59,7,66,0,inf
38376,65,12,77,0,inf
38377,56,7,63,0,inf
38378,64,6,70,0,inf
38379,64,13,77,0,inf
38380,58,6,64,0,inf
38381,66,12,78,0,inf
38382,56,7,63,0,inf
38383,59,10,69,0,inf
38384,50,11,61,0,inf
38385,66,12,78,0,inf
38386,65,11,76,0,inf
38387,63,10,73,0,inf
38388,67,11,78,0,inf
38389,64,5,69,0,inf
38390,53,5,58,0,inf
38391,54,6,60,0,inf
38392,67,13,80,0,inf
38393,67,5,72,0,inf
38394,59,13,72,0,inf
38395,53,12,65,0,inf
38396,55,8,63,0,inf
38397,62,6,68,0,inf
38398,66,9,75,0,inf
38399,55,8,63,0,inf
38400,52,11,63,0,inf
38401,57,9,66,0,inf
38402,57,10,67,0,inf
38403,53,5,58,0,inf
38404,54,7,61,0,inf
38405,64,5,69,0,inf
38406,67,11,78,1,4.110216709487872
38407,59,11,70,0,inf
38408,55,12,67,0,inf
38409,59,13,72,0,inf
38410,67,13,80,1,5.681788065981024
38411,60,13,73,0,inf
38412,65,8,73,0,inf
38413,60,13,73,0,inf
38414,67,10,77,0,inf
38415,55,13,68,0,inf
38416,56,12,68,0,inf
38417,67,11,78,0,inf
38418,51,8,59,0,inf
38419,59,12,71,0,inf
38420,60,8,68,0,inf
38421,54,5,59,0,inf
38422,53,12,65,0,inf
38423,64,10,74,0,inf
38424,60,10,70,0,inf
38425,60,5,65,0,inf
38426,63,11,74,0,inf
38427,64,8,72,0,inf
38428,52,5,57,0,inf
38429,66,11,77,0,inf
38430,59,7,66,1,6.897371411604695
38431,51,8,59,0,inf
38432,60,8,68,0,inf
38433,52,9,61,0,inf
38434,60,9,69,0,inf
38435,51,5,56,0,inf
38436,56,11,67,0,inf
38437,66,10,76,0,inf
38438,67,11,78,0,inf
38439,61,11,72,0,inf
38440,52,9,61,0,inf
38441,61,6,67,0,inf
38442,50,9,59,0,inf
38443,65,7,72,0,inf
38444,63,12,75,0,inf
38445,61,9,70,0,inf
38446,60,8,68,0,inf
38447,51,12,63,0,inf
38448,56,9,65,0,inf
38449,62,13,75,0,inf
38450,65,7,72,0,inf
38451,51,12,63,0,inf
38452,55,8,63,0,inf
38453,67,9,76,0,inf
38454,54,5,59,0,inf
38455,62,7,69,0,inf
38456,57,7,64,0,inf
38457,54,5,59,0,inf
38458,55,5,60,0,inf
38459,53,5,58,0,inf
38460,55,5,60,0,inf
38461,57,10,67,0,inf
38462,66,6,72,0,inf
38463,50,12,62,0,inf
38464,62,8,70,0,inf
38465,56,13,69,0,inf
38466,62,10,72,0,inf
38467,55,9,64,0,inf
38468,64,8,72,0,inf
38469,63,8,71,0,inf
38470,64,5,69,0,inf
38471,63,13,76,0,inf
38472,61,7,68,0,inf
38473,63,6,69,0,inf
38474,51,8,59,0,inf
38475,53,9,62,0,inf
38476,61,13,74,0,inf
38477,53,11,64,0,inf
38478,51,13,64,0,inf
38479,55,6,61,0,inf
38480,63,8,71,0,inf
38481,52,5,57,0,inf
38482,54,9,63,0,inf
38483,60,9,69,0,inf
38484,63,9,72,0,inf
38485,63,6,69,0,inf
38486,57,10,67,0,inf
38487,62,11,73,0,inf
38488,63,5,68,0,inf
38489,64,12,76,0,inf
38490,63,10,73,0,inf
38491,64,11,75,0,inf
38492,62,12,74,0,inf
38493,51,7,58,0,inf
38494,53,6,59,0,inf
38495,62,10,72,0,inf
38496,65,12,77,0,inf
38497,56,9,65,0,inf
38498,56,10,66,1,4.437149948737392
38499,61,9,70,0,inf
38500,59,8,67,0,inf
38501,54,9,63,0,inf
38502,53,10,63,0,inf
38503,57,9,66,0,inf
38504,64,10,74,0,inf
38505,52,5,57,0,inf
38506,61,7,68,0,inf
38507,53,6,59,0,inf
38508,51,13,64,0,inf
38509,51,5,56,0,inf
38510,57,6,63,0,inf
38511,59,5,64,0,inf
38512,59,9,68,0,inf
38513,51,6,57,0,inf
38514,54,13,67,0,inf
38515,64,5,69,0,inf
38516,50,8,58,0,inf
38517,53,8,61,0,inf
38518,67,10,77,0,inf
38519,54,6,60,0,inf
38520,52,10,62,0,inf
38521,63,11,74,1,2.8930150812737168
38522,62,10,72,0,inf
38523,60,11,71,0,inf
38524,60,12,72,0,inf
38525,59,12,71,0,inf
38526,59,6,65,0,inf
38527,57,9,66,1,2.9283168937601047
38528,55,7,62,0,inf
38529,57,6,63,0,inf
38530,53,10,63,0,inf
38531,67,6,73,0,inf
38532,58,11,69,0,inf
38533,66,6,72,0,inf
38534,50,8,58,0,inf
38535,63,12,75,0,inf
38536,59,5,64,0,inf
38537,52,7,59,0,inf
38538,51,13,64,0,inf
38539,66,8,74,0,inf
38540,50,11,61,1,0.8393924254004759
38541,50,5,55,0,inf
38542,59,13,72,0,inf
38543,64,5,69,0,inf
38544,65,11,76,0,inf
38545,51,8,59,0,inf
38546,67,9,76,0,inf
38547,51,6,57,0,inf
38548,66,11,77,0,inf
38549,59,11,70,0,inf
38550,60,9,69,0,inf
38551,50,5,55,0,inf
38552,67,7,74,0,inf
38553,61,7,68,0,inf
38554,57,5,62,0,inf
38555,66,6,72,0,inf
38556,60,13,73,0,inf
38557,55,11,66,0,inf
38558,59,8,67,0,inf
38559,60,7,67,0,inf
38560,66,12,78,0,inf
38561,53,9,62,0,inf
38562,57,13,70,0,inf
38563,51,11,62,0,inf
38564,50,12,62,0,inf
38565,66,11,77,0,inf
38566,51,6,57,0,inf
38567,52,11,63,0,inf
38568,62,7,69,0,inf
38569,50,9,59,0,inf
38570,67,11,78,0,inf
38571,51,11,62,0,inf
38572,56,11,67,0,inf
38573,57,9,66,0,inf
38574,55,13,68,0,inf
38575,56,6,62,0,inf
38576,62,9,71,0,inf
38577,59,9,68,0,inf
38578,61,13,74,0,inf
38579,58,10,68,0,inf
38580,52,8,60,0,inf
38581,56,6,62,0,inf
38582,64,9,73,0,inf
38583,61,6,67,0,inf
38584,50,7,57,0,inf
38585,66,13,79,0,inf
38586,64,12,76,0,inf
38587,61,5,66,0,inf
38588,60,11,71,0,inf
38589,53,12,65,0,inf
38590,59,12,71,0,inf
38591,50,9,59,0,inf
38592,63,13,76,0,inf
38593,54,8,62,0,inf
38594,56,12,68,0,inf
38595,64,8,72,0,inf
38596,56,8,64,0,inf
38597,66,5,71,0,inf
38598,58,10,68,0,inf
38599,60,8,68,0,inf
38600,50,11,61,0,inf
38601,57,5,62,0,inf
38602,52,12,64,0,inf
38603,63,5,68,0,inf
38604,50,9,59,0,inf
38605,54,8,62,0,inf
38606,66,10,76,0,inf
38607,55,8,63,0,inf
38608,63,8,71,0,inf
38609,52,12,64,0,inf
38610,67,6,73,0,inf
38611,67,6,73,0,inf
38612,56,11,67,0,inf
38613,64,8,72,0,inf
38614,52,10,62,0,inf
38615,52,13,65,0,inf
38616,57,10,67,0,inf
38617,65,11,76,0,inf
38618,60,7,67,0,inf
38619,52,13,65,0,inf
38620,57,13,70,0,inf
38621,53,8,61,0,inf
38622,53,11,64,0,inf
38623,67,8,75,0,inf
38624,60,8,68,0,inf
38625,55,11,66,0,inf
38626,56,5,61,0,inf
38627,64,13,77,0,inf
38628,60,5,65,0,inf
38629,61,6,67,0,inf
38630,62,8,70,0,inf
38631,51,6,57,0,inf
38632,59,10,69,0,inf
38633,66,11,77,0,inf
38634,66,7,73,0,inf
38635,50,12,62,0,inf
38636,65,9,74,0,inf
38637,63,7,70,0,inf
38638,64,6,70,0,inf
38639,56,7,63,0,inf
38640,64,8,72,0,inf
38641,67,9,76,0,inf
38642,56,6,62,0,inf
38643,54,5,59,0,inf
38644,58,13,71,0,inf
38645,53,6,59,0,inf
38646,53,11,64,0,inf
38647,58,12,70,0,inf
38648,52,8,60,0,inf
38649,64,7,71,0,inf
38650,52,12,64,0,inf
38651,51,9,60,0,inf
38652,60,5,65,0,inf
38653,52,8,60,0,inf
38654,63,6,69,0,inf
38655,55,13,68,0,inf
38656,65,9,74,0,inf
38657,50,13,63,0,inf
38658,56,5,61,0,inf
38659,50,6,56,0,inf
38660,58,5,63,0,inf
38661,62,9,71,0,inf
38662,54,8,62,0,inf
38663,54,11,65,0,inf
38664,59,10,69,0,inf
38665,62,9,71,0,inf
38666,63,12,75,0,inf
38667,52,12,64,1,10.025314356485609
38668,52,13,65,0,inf
38669,64,11,75,0,inf
38670,55,7,62,0,inf
38671,52,6,58,0,inf
38672,59,7,66,0,inf
38673,54,10,64,0,inf
38674,56,13,69,0,inf
38675,61,11,72,0,inf
38676,56,8,64,0,inf
38677,51,13,64,0,inf
38678,56,9,65,0,inf
38679,62,11,73,0,inf
38680,61,12,73,1,8.24558646517383
38681,57,8,65,0,inf
38682,50,12,62,0,inf
38683,51,8,59,0,inf
38684,51,7,58,0,inf
38685,57,12,69,0,inf
38686,67,6,73,0,inf
38687,63,5,68,0,inf
38688,67,7,74,0,inf
38689,63,7,70,0,inf
38690,54,10,64,0,inf
38691,52,10,62,0,inf
38692,59,11,70,0,inf
38693,60,10,70,0,inf
38694,61,8,69,0,inf
38695,51,10,61,0,inf
38696,57,13,70,0,inf
38697,66,12,78,0,inf
38698,55,13,68,0,inf
38699,52,5,57,0,inf
38700,55,12,67,0,inf
38701,53,7,60,0,inf
38702,64,9,73,0,inf
38703,53,6,59,0,inf
38704,52,5,57,0,inf
38705,53,11,64,0,inf
38706,56,11,67,0,inf
38707,59,10,69,0,inf
38708,67,8,75,0,inf
38709,58,13,71,0,inf
38710,67,6,73,0,inf
38711,65,11,76,0,inf
38712,65,7,72,0,inf
38713,52,10,62,0,inf
38714,59,5,64,0,inf
38715,50,8,58,0,inf
38716,66,7,73,1,3.550368543295079
38717,66,11,77,0,inf
38718,58,5,63,0,inf
38719,57,11,68,0,inf
38720,57,13,70,0,inf
38721,58,6,64,0,inf
38722,55,13,68,0,inf
38723,60,8,68,0,inf
38724,60,9,69,0,inf
38725,62,9,71,0,inf
38726,65,7,72,0,inf
38727,66,9,75,0,inf
38728,63,6,69,0,inf
38729,64,11,75,0,inf
38730,61,5,66,0,inf
38731,50,11,61,0,inf
38732,57,11,68,0,inf
38733,55,7,62,0,inf
38734,63,13,76,0,inf
38735,56,12,68,0,inf
38736,51,13,64,0,inf
38737,55,6,61,0,inf
38738,63,6,69,0,inf
38739,63,6,69,0,inf
38740,65,8,73,0,inf
38741,52,12,64,0,inf
38742,57,9,66,0,inf
38743,60,10,70,0,inf
38744,52,9,61,0,inf
38745,51,7,58,0,inf
38746,60,10,70,0,inf
38747,54,10,64,0,inf
38748,61,9,70,0,inf
38749,51,10,61,0,inf
38750,52,7,59,0,inf
38751,52,8,60,0,inf
38752,51,11,62,0,inf
38753,60,7,67,0,inf
38754,56,13,69,0,inf
38755,61,7,68,0,inf
38756,66,9,75,0,inf
38757,61,12,73,0,inf
38758,56,13,69,0,inf
38759,52,5,57,0,inf
38760,60,5,65,0,inf
38761,57,5,62,0,inf
38762,62,8,70,0,inf
38763,52,7,59,0,inf
38764,55,7,62,0,inf
38765,66,7,73,0,inf
38766,50,5,55,0,inf
38767,54,6,60,0,inf
38768,61,9,70,0,inf
38769,58,11,69,0,inf
38770,53,7,60,0,inf
38771,63,5,68,0,inf
38772,61,7,68,0,inf
38773,61,9,70,0,inf
38774,58,10,68,0,inf
38775,58,13,71,0,inf
38776,64,5,69,0,inf
38777,59,6,65,0,inf
38778,62,6,68,0,inf
38779,62,12,74,0,inf
38780,53,5,58,0,inf
38781,66,7,73,0,inf
38782,60,9,69,0,inf
38783,56,6,62,0,inf
38784,56,12,68,0,inf
38785,56,7,63,0,inf
38786,61,10,71,0,inf
38787,61,6,67,0,inf
38788,51,7,58,0,inf
38789,59,10,69,0,inf
38790,58,12,70,0,inf
38791,55,11,66,0,inf
38792,57,10,67,0,inf
38793,55,6,61,0,inf
38794,67,13,80,0,inf
38795,51,12,63,0,inf
38796,60,10,70,0,inf
38797,62,12,74,0,inf
38798,62,12,74,0,inf
38799,60,12,72,0,inf
38800,54,5,59,0,inf
38801,60,12,72,0,inf
38802,54,10,64,0,inf
38803,54,5,59,0,inf
38804,50,7,57,0,inf
38805,58,11,69,0,inf
38806,52,11,63,0,inf
38807,52,10,62,0,inf
38808,50,12,62,0,inf
38809,55,9,64,0,inf
38810,58,5,63,0,inf
38811,62,10,72,0,inf
38812,52,6,58,0,inf
38813,62,6,68,0,inf
38814,52,12,64,0,inf
38815,51,8,59,0,inf
38816,66,13,79,0,inf
38817,66,13,79,0,inf
38818,62,12,74,0,inf
38819,61,8,69,0,inf
38820,52,7,59,0,inf
38821,55,13,68,0,inf
38822,63,7,70,0,inf
38823,65,9,74,0,inf
38824,51,13,64,0,inf
38825,59,6,65,0,inf
38826,63,5,68,0,inf
38827,59,8,67,0,inf
38828,61,9,70,0,inf
38829,50,13,63,0,inf
38830,63,8,71,0,inf
38831,60,13,73,0,inf
38832,51,9,60,0,inf
38833,59,9,68,0,inf
38834,53,7,60,0,inf
38835,51,9,60,0,inf
38836,67,13,80,0,inf
38837,60,8,68,0,inf
38838,63,6,69,0,inf
38839,63,7,70,0,inf
38840,61,9,70,0,inf
38841,53,13,66,0,inf
38842,53,9,62,0,inf
38843,60,7,67,0,inf
38844,66,6,72,0,inf
38845,53,10,63,0,inf
38846,65,7,72,0,inf
38847,55,13,68,0,inf
38848,50,8,58,0,inf
38849,55,7,62,0,inf
38850,50,12,62,0,inf
38851,61,12,73,0,inf
38852,55,10,65,0,inf
38853,61,10,71,0,inf
38854,59,5,64,0,inf
38855,66,11,77,0,inf
38856,56,6,62,0,inf
38857,58,10,68,0,inf
38858,58,12,70,0,inf
38859,62,8,70,0,inf
38860,58,6,64,0,inf
38861,65,10,75,0,inf
38862,50,6,56,0,inf
38863,63,9,72,0,inf
38864,65,11,76,0,inf
38865,62,7,69,1,2.2317555129948943
38866,55,13,68,0,inf
38867,56,11,67,0,inf
38868,63,8,71,0,inf
38869,60,5,65,0,inf
38870,53,13,66,0,inf
38871,57,11,68,0,inf
38872,62,12,74,0,inf
38873,58,12,70,0,inf
38874,59,5,64,0,inf
38875,60,11,71,0,inf
38876,51,5,56,0,inf
38877,58,9,67,0,inf
38878,64,8,72,0,inf
38879,57,6,63,0,inf
38880,64,8,72,0,inf
38881,67,12,79,0,inf
38882,62,10,72,0,inf
38883,62,11,73,0,inf
38884,52,7,59,0,inf
38885,57,9,66,0,inf
38886,54,10,64,1,2.2131425439701573
38887,55,10,65,0,inf
38888,54,11,65,0,inf
38889,52,12,64,0,inf
38890,52,9,61,0,inf
38891,57,6,63,0,inf
38892,50,7,57,0,inf
38893,61,11,72,0,inf
38894,53,6,59,0,inf
38895,54,7,61,0,inf
38896,60,12,72,0,inf
38897,54,6,60,0,inf
38898,53,9,62,0,inf
38899,54,7,61,0,inf
38900,66,11,77,0,inf
38901,57,7,64,0,inf
38902,62,10,72,0,inf
38903,57,13,70,0,inf
38904,56,8,64,0,inf
38905,54,6,60,0,inf
38906,59,13,72,0,inf
38907,58,9,67,0,inf
38908,55,8,63,0,inf
38909,62,5,67,0,inf
38910,59,7,66,0,inf
38911,59,9,68,0,inf
38912,51,11,62,0,inf
38913,65,12,77,0,inf
38914,58,9,67,0,inf
38915,51,13,64,0,inf
38916,52,9,61,0,inf
38917,57,7,64,0,inf
38918,52,5,57,0,inf
38919,52,12,64,0,inf
38920,53,5,58,0,inf
38921,61,8,69,0,inf
38922,53,11,64,0,inf
38923,51,13,64,0,inf
38924,66,11,77,0,inf
38925,56,13,69,1,7.51151966473207
38926,52,6,58,0,inf
38927,50,13,63,0,inf
38928,62,10,72,0,inf
38929,57,5,62,0,inf
38930,54,7,61,0,inf
38931,62,6,68,0,inf
38932,56,9,65,1,6.040513916195181
38933,55,9,64,0,inf
38934,65,5,70,0,inf
38935,61,9,70,0,inf
38936,63,5,68,0,inf
38937,54,8,62,0,inf
38938,64,6,70,0,inf
38939,57,5,62,0,inf
38940,62,12,74,0,inf
38941,51,9,60,0,inf
38942,58,11,69,0,inf
38943,51,9,60,0,inf
38944,53,10,63,0,inf
38945,60,8,68,0,inf
38946,59,9,68,0,inf
38947,63,9,72,0,inf
38948,53,5,58,0,inf
38949,58,5,63,0,inf
38950,50,12,62,0,inf
38951,65,10,75,0,inf
38952,51,13,64,0,inf
38953,66,6,72,0,inf
38954,63,13,76,0,inf
38955,54,8,62,0,inf
38956,58,10,68,0,inf
38957,56,11,67,1,9.939617982898795
38958,52,7,59,0,inf
38959,58,6,64,0,inf
38960,51,13,64,0,inf
38961,57,5,62,0,inf
38962,60,5,65,0,inf
38963,55,5,60,0,inf
38964,60,8,68,0,inf
38965,59,11,70,0,inf
38966,64,10,74,0,inf
38967,52,6,58,0,inf
38968,51,13,64,1,0.7665244445158663
38969,51,7,58,0,inf
38970,50,13,63,0,inf
38971,65,11,76,0,inf
38972,54,13,67,0,inf
38973,50,10,60,0,inf
38974,54,7,61,0,inf
38975,67,11,78,0,inf
38976,57,11,68,0,inf
38977,54,13,67,0,inf
38978,66,13,79,0,inf
38979,59,12,71,0,inf
38980,61,5,66,0,inf
38981,59,13,72,0,inf
38982,61,8,69,0,inf
38983,67,5,72,0,inf
38984,50,7,57,0,inf
38985,63,6,69,0,inf
38986,65,9,74,0,inf
38987,50,10,60,0,inf
38988,65,8,73,0,inf
38989,52,10,62,0,inf
38990,62,7,69,0,inf
38991,56,9,65,0,inf
38992,50,10,60,0,inf
38993,51,7,58,0,inf
38994,51,11,62,0,inf
38995,66,6,72,0,inf
38996,55,12,67,0,inf
38997,60,11,71,0,inf
38998,61,9,70,0,inf
38999,57,6,63,0,inf
39000,56,5,61,0,inf
39001,56,9,65,0,inf
39002,59,5,64,0,inf
39003,63,5,68,0,inf
39004,54,11,65,0,inf
39005,51,13,64,0,inf
39006,65,11,76,0,inf
39007,58,7,65,0,inf
39008,54,8,62,0,inf
39009,66,5,71,0,inf
39010,57,6,63,0,inf
39011,60,6,66,0,inf
39012,60,11,71,0,inf
39013,63,9,72,0,inf
39014,55,6,61,0,inf
39015,60,5,65,0,inf
39016,67,13,80,0,inf
39017,58,12,70,0,inf
39018,54,12,66,1,1.881038747403359
39019,64,5,69,0,inf
39020,67,6,73,0,inf
39021,60,12,72,0,inf
39022,50,8,58,0,inf
39023,56,10,66,0,inf
39024,59,10,69,0,inf
39025,52,8,60,0,inf
39026,65,8,73,0,inf
39027,56,9,65,0,inf
39028,61,7,68,0,inf
39029,50,9,59,0,inf
39030,63,9,72,0,inf
39031,62,5,67,0,inf
39032,62,6,68,0,inf
39033,56,7,63,0,inf
39034,52,8,60,0,inf
39035,54,11,65,0,inf
39036,52,11,63,0,inf
39037,55,5,60,1,4.488476761749325
39038,55,11,66,0,inf
39039,54,6,60,0,inf
39040,60,7,67,0,inf
39041,66,11,77,0,inf
39042,64,8,72,0,inf
39043,65,13,78,0,inf
39044,52,12,64,1,11.80199373367072
39045,67,8,75,0,inf
39046,61,9,70,0,inf
39047,53,5,58,0,inf
39048,52,8,60,0,inf
39049,56,13,69,0,inf
39050,55,12,67,0,inf
39051,63,5,68,0,inf
39052,61,7,68,0,inf
39053,50,7,57,0,inf
39054,67,7,74,0,inf
39055,64,5,69,0,inf
39056,54,9,63,0,inf
39057,50,11,61,0,inf
39058,58,13,71,1,9.87306954011288
39059,50,13,63,0,inf
39060,60,7,67,0,inf
39061,67,10,77,0,inf
39062,51,10,61,0,inf
39063,54,6,60,0,inf
39064,64,11,75,0,inf
39065,56,6,62,0,inf
39066,62,8,70,0,inf
39067,54,8,62,0,inf
39068,61,6,67,0,inf
39069,52,12,64,1,5.870168777864649
39070,57,10,67,0,inf
39071,53,8,61,0,inf
39072,57,6,63,0,inf
39073,51,6,57,0,inf
39074,60,10,70,0,inf
39075,62,11,73,0,inf
39076,57,10,67,0,inf
39077,67,8,75,0,inf
39078,66,13,79,0,inf
39079,63,6,69,0,inf
39080,58,8,66,0,inf
39081,59,8,67,0,inf
39082,61,5,66,0,inf
39083,54,7,61,0,inf
39084,59,6,65,0,inf
39085,50,13,63,0,inf
39086,65,12,77,0,inf
39087,67,10,77,0,inf
39088,67,13,80,0,inf
39089,63,9,72,0,inf
39090,54,12,66,0,inf
39091,64,12,76,0,inf
39092,65,6,71,0,inf
39093,52,12,64,1,2.414111832347814
39094,58,8,66,0,inf
39095,60,10,70,0,inf
39096,53,11,64,0,inf
39097,58,10,68,0,inf
39098,62,6,68,0,inf
39099,53,11,64,0,inf
39100,54,11,65,0,inf
39101,64,8,72,0,inf
39102,60,9,69,0,inf
39103,58,6,64,0,inf
39104,52,7,59,0,inf
39105,50,9,59,0,inf
39106,56,7,63,0,inf
39107,62,9,71,0,inf
39108,57,12,69,0,inf
39109,58,10,68,0,inf
39110,55,12,67,0,inf
39111,62,9,71,0,inf
39112,59,13,72,0,inf
39113,50,13,63,0,inf
39114,60,12,72,0,inf
39115,67,11,78,0,inf
39116,62,10,72,0,inf
39117,60,5,65,0,inf
39118,63,10,73,0,inf
39119,56,7,63,0,inf
39120,64,6,70,0,inf
39121,50,13,63,0,inf
39122,59,9,68,0,inf
39123,51,8,59,0,inf
39124,59,8,67,0,inf
39125,51,7,58,0,inf
39126,67,8,75,0,inf
39127,60,5,65,0,inf
39128,66,6,72,0,inf
39129,61,13,74,0,inf
39130,64,11,75,0,inf
39131,58,6,64,0,inf
39132,63,6,69,1,1.6617721701214805
39133,67,5,72,0,inf
39134,67,5,72,0,inf
39135,52,10,62,0,inf
39136,62,8,70,0,inf
39137,50,7,57,0,inf
39138,61,9,70,0,inf
39139,52,13,65,1,3.9456952068171205
39140,66,6,72,0,inf
39141,53,7,60,0,inf
39142,67,13,80,0,inf
39143,67,13,80,0,inf
39144,59,9,68,0,inf
39145,52,13,65,0,inf
39146,52,9,61,0,inf
39147,66,12,78,0,inf
39148,52,8,60,0,inf
39149,66,10,76,0,inf
39150,61,10,71,0,inf
39151,63,7,70,0,inf
39152,57,11,68,0,inf
39153,55,12,67,0,inf
39154,63,5,68,0,inf
39155,65,10,75,0,inf
39156,66,6,72,0,inf
39157,55,8,63,0,inf
39158,50,7,57,0,inf
39159,52,11,63,0,inf
39160,60,12,72,0,inf
39161,56,6,62,0,inf
39162,57,9,66,0,inf
39163,55,5,60,0,inf
39164,61,13,74,0,inf
39165,56,11,67,1,7.241318571961131
39166,63,13,76,0,inf
39167,62,8,70,0,inf
39168,52,9,61,0,inf
39169,57,5,62,0,inf
39170,64,12,76,0,inf
39171,64,9,73,0,inf
39172,53,7,60,0,inf
39173,65,13,78,0,inf
39174,61,12,73,0,inf
39175,54,10,64,0,inf
39176,53,13,66,0,inf
39177,64,11,75,0,inf
39178,64,11,75,0,inf
39179,54,8,62,0,inf
39180,65,11,76,0,inf
39181,60,5,65,0,inf
39182,57,7,64,0,inf
39183,55,9,64,0,inf
39184,57,5,62,0,inf
39185,50,12,62,0,inf
39186,52,12,64,0,inf
39187,64,13,77,0,inf
39188,57,7,64,0,inf
39189,58,5,63,0,inf
39190,53,9,62,0,inf
39191,51,10,61,0,inf
39192,56,6,62,0,inf
39193,59,13,72,0,inf
39194,53,11,64,0,inf
39195,51,10,61,0,inf
39196,59,10,69,0,inf
39197,55,13,68,0,inf
39198,64,7,71,0,inf
39199,65,6,71,0,inf
39200,59,5,64,0,inf
39201,61,8,69,0,inf
39202,51,8,59,0,inf
39203,50,8,58,0,inf
39204,62,12,74,0,inf
39205,57,6,63,0,inf
39206,50,13,63,0,inf
39207,56,9,65,0,inf
39208,57,11,68,0,inf
39209,64,5,69,0,inf
39210,50,13,63,0,inf
39211,50,12,62,0,inf
39212,57,8,65,0,inf
39213,53,5,58,0,inf
39214,56,12,68,0,inf
39215,63,9,72,0,inf
39216,66,10,76,0,inf
39217,65,9,74,0,inf
39218,54,8,62,0,inf
39219,62,7,69,0,inf
39220,53,5,58,0,inf
39221,64,7,71,0,inf
39222,66,10,76,0,inf
39223,50,6,56,0,inf
39224,62,7,69,0,inf
39225,50,8,58,0,inf
39226,50,6,56,0,inf
39227,56,5,61,0,inf
39228,51,11,62,0,inf
39229,66,9,75,0,inf
39230,56,6,62,0,inf
39231,55,11,66,0,inf
39232,59,5,64,0,inf
39233,56,10,66,0,inf
39234,67,9,76,0,inf
39235,51,13,64,0,inf
39236,61,8,69,0,inf
39237,57,11,68,0,inf
39238,56,8,64,0,inf
39239,52,9,61,0,inf
39240,57,7,64,0,inf
39241,53,5,58,0,inf
39242,51,10,61,0,inf
39243,65,10,75,0,inf
39244,60,8,68,0,inf
39245,52,10,62,0,inf
39246,64,9,73,0,inf
39247,63,5,68,0,inf
39248,65,7,72,0,inf
39249,66,13,79,0,inf
39250,54,11,65,0,inf
39251,61,10,71,0,inf
39252,58,10,68,0,inf
39253,61,12,73,0,inf
39254,59,8,67,1,3.6102511569200857
39255,54,13,67,0,inf
39256,52,13,65,0,inf
39257,54,13,67,0,inf
39258,62,11,73,0,inf
39259,51,6,57,0,inf
39260,55,7,62,0,inf
39261,67,6,73,0,inf
39262,67,9,76,0,inf
39263,64,5,69,0,inf
39264,66,9,75,0,inf
39265,66,12,78,0,inf
39266,57,6,63,0,inf
39267,64,6,70,0,inf
39268,62,6,68,0,inf
39269,63,11,74,0,inf
39270,67,8,75,0,inf
39271,56,13,69,0,inf
39272,58,13,71,0,inf
39273,55,7,62,0,inf
39274,56,5,61,0,inf
39275,54,11,65,0,inf
39276,63,10,73,0,inf
39277,63,6,69,0,inf
39278,54,12,66,0,inf
39279,65,11,76,0,inf
39280,50,6,56,0,inf
39281,67,5,72,0,inf
39282,64,6,70,0,inf
39283,58,10,68,0,inf
39284,67,10,77,0,inf
39285,59,7,66,0,inf
39286,62,11,73,0,inf
39287,52,6,58,0,inf
39288,50,6,56,0,inf
39289,57,12,69,0,inf
39290,60,5,65,0,inf
39291,52,9,61,0,inf
39292,60,8,68,0,inf
39293,66,11,77,0,inf
39294,55,11,66,0,inf
39295,60,13,73,0,inf
39296,51,12,63,0,inf
39297,54,7,61,0,inf
39298,58,6,64,0,inf
39299,58,7,65,0,inf
39300,60,13,73,0,inf
39301,58,12,70,0,inf
39302,55,5,60,0,inf
39303,57,9,66,0,inf
39304,62,9,71,0,inf
39305,59,7,66,0,inf
39306,59,8,67,0,inf
39307,64,12,76,0,inf
39308,52,8,60,0,inf
39309,57,6,63,0,inf
39310,54,6,60,0,inf
39311,62,12,74,0,inf
39312,55,9,64,0,inf
39313,65,6,71,0,inf
39314,59,9,68,0,inf
39315,66,6,72,0,inf
39316,51,8,59,0,inf
39317,60,7,67,0,inf
39318,50,13,63,0,inf
39319,57,8,65,0,inf
39320,54,13,67,0,inf
39321,67,9,76,0,inf
39322,61,8,69,0,inf
39323,55,10,65,0,inf
39324,65,6,71,0,inf
39325,65,10,75,0,inf
39326,50,9,59,0,inf
39327,51,12,63,0,inf
39328,54,6,60,0,inf
39329,55,6,61,0,inf
39330,54,10,64,0,inf
39331,60,13,73,0,inf
39332,54,10,64,0,inf
39333,55,9,64,0,inf
39334,61,5,66,0,inf
39335,62,5,67,0,inf
39336,61,13,74,0,inf
39337,52,8,60,0,inf
39338,67,7,74,0,inf
39339,61,8,69,0,inf
39340,61,7,68,0,inf
39341,56,9,65,0,inf
39342,54,8,62,0,inf
39343,63,9,72,0,inf
39344,64,9,73,0,inf
39345,52,13,65,0,inf
39346,59,6,65,0,inf
39347,51,12,63,1,9.582284154602512
39348,66,5,71,0,inf
39349,61,7,68,0,inf
39350,57,5,62,0,inf
39351,54,5,59,0,inf
39352,50,7,57,0,inf
39353,61,11,72,0,inf
39354,57,7,64,0,inf
39355,57,9,66,0,inf
39356,66,7,73,0,inf
39357,64,6,70,0,inf
39358,61,11,72,0,inf
39359,53,8,61,0,inf
39360,64,7,71,0,inf
39361,67,7,74,0,inf
39362,51,11,62,0,inf
39363,56,5,61,0,inf
39364,50,11,61,0,inf
39365,50,10,60,0,inf
39366,51,10,61,0,inf
39367,55,10,65,0,inf
39368,57,7,64,0,inf
39369,65,10,75,0,inf
39370,50,13,63,0,inf
39371,50,5,55,0,inf
39372,54,6,60,0,inf
39373,59,11,70,0,inf
39374,65,10,75,0,inf
39375,60,11,71,0,inf
39376,63,10,73,0,inf
39377,60,8,68,0,inf
39378,52,7,59,0,inf
39379,51,9,60,1,1.8127487382352854
39380,62,5,67,0,inf
39381,62,8,70,0,inf
39382,62,6,68,0,inf
39383,54,11,65,0,inf
39384,66,8,74,0,inf
39385,61,10,71,0,inf
39386,64,6,70,0,inf
39387,57,9,66,1,6.446726317462364
39388,58,13,71,0,inf
39389,67,5,72,0,inf
39390,61,9,70,0,inf
39391,58,13,71,0,inf
39392,56,9,65,0,inf
39393,59,6,65,0,inf
39394,59,8,67,0,inf
39395,63,10,73,0,inf
39396,59,13,72,0,inf
39397,50,11,61,0,inf
39398,58,8,66,0,inf
39399,67,13,80,0,inf
39400,67,9,76,0,inf
39401,51,6,57,0,inf
39402,63,8,71,0,inf
39403,62,12,74,0,inf
39404,64,5,69,0,inf
39405,57,12,69,0,inf
39406,66,12,78,0,inf
39407,64,10,74,0,inf
39408,65,12,77,0,inf
39409,66,6,72,0,inf
39410,67,11,78,0,inf
39411,57,9,66,0,inf
39412,63,13,76,0,inf
39413,58,6,64,0,inf
39414,62,13,75,0,inf
39415,64,9,73,0,inf
39416,59,9,68,0,inf
39417,61,9,70,0,inf
39418,58,9,67,0,inf
39419,55,11,66,0,inf
39420,67,9,76,0,inf
39421,62,9,71,0,inf
39422,53,10,63,0,inf
39423,56,7,63,0,inf
39424,59,12,71,0,inf
39425,52,8,60,0,inf
39426,64,9,73,0,inf
39427,66,12,78,0,inf
39428,58,6,64,0,inf
39429,51,13,64,0,inf
39430,60,12,72,0,inf
39431,54,11,65,0,inf
39432,51,13,64,0,inf
39433,61,13,74,0,inf
39434,52,8,60,0,inf
39435,63,8,71,0,inf
39436,66,11,77,0,inf
39437,62,9,71,0,inf
39438,65,11,76,0,inf
39439,65,11,76,0,inf
39440,63,8,71,0,inf
39441,65,11,76,0,inf
39442,55,8,63,0,inf
39443,63,9,72,0,inf
39444,51,6,57,0,inf
39445,64,9,73,0,inf
39446,54,9,63,0,inf
39447,51,5,56,0,inf
39448,52,12,64,0,inf
39449,61,6,67,0,inf
39450,64,11,75,0,inf
39451,58,13,71,0,inf
39452,62,13,75,0,inf
39453,51,9,60,0,inf
39454,51,11,62,0,inf
39455,51,7,58,0,inf
39456,50,7,57,0,inf
39457,56,12,68,0,inf
39458,56,7,63,0,inf
39459,50,11,61,0,inf
39460,58,6,64,0,inf
39461,54,6,60,0,inf
39462,66,10,76,0,inf
39463,63,5,68,0,inf
39464,62,11,73,0,inf
39465,65,9,74,0,inf
39466,51,8,59,0,inf
39467,63,10,73,0,inf
39468,64,11,75,0,inf
39469,62,13,75,0,inf
39470,51,10,61,0,inf
39471,50,12,62,0,inf
39472,61,8,69,0,inf
39473,50,8,58,0,inf
39474,62,5,67,0,inf
39475,64,11,75,0,inf
39476,53,13,66,0,inf
39477,62,9,71,0,inf
39478,55,12,67,0,inf
39479,55,8,63,0,inf
39480,62,10,72,0,inf
39481,62,10,72,0,inf
39482,58,6,64,0,inf
39483,65,12,77,0,inf
39484,56,11,67,0,inf
39485,59,8,67,0,inf
39486,58,5,63,0,inf
39487,66,6,72,0,inf
39488,67,8,75,0,inf
39489,65,6,71,0,inf
39490,50,7,57,0,inf
39491,56,7,63,0,inf
39492,61,9,70,0,inf
39493,52,8,60,0,inf
39494,62,5,67,0,inf
39495,67,8,75,0,inf
39496,66,8,74,0,inf
39497,65,11,76,0,inf
39498,64,11,75,0,inf
39499,63,5,68,0,inf
39500,52,12,64,0,inf
39501,65,12,77,0,inf
39502,65,12,77,0,inf
39503,58,13,71,0,inf
39504,55,13,68,0,inf
39505,56,13,69,1,3.7572206119699914
39506,50,10,60,0,inf
39507,57,13,70,0,inf
39508,62,8,70,0,inf
39509,61,5,66,0,inf
39510,56,9,65,0,inf
39511,57,13,70,0,inf
39512,63,7,70,0,inf
39513,54,12,66,0,inf
39514,53,5,58,0,inf
39515,52,13,65,0,inf
39516,62,11,73,0,inf
39517,50,8,58,0,inf
39518,57,13,70,0,inf
39519,56,12,68,0,inf
39520,50,6,56,0,inf
39521,55,6,61,0,inf
39522,50,13,63,0,inf
39523,54,9,63,0,inf
39524,59,5,64,0,inf
39525,60,10,70,0,inf
39526,51,12,63,0,inf
39527,58,11,69,0,inf
39528,66,8,74,0,inf
39529,60,10,70,0,inf
39530,60,10,70,0,inf
39531,55,6,61,0,inf
39532,62,5,67,0,inf
39533,61,5,66,0,inf
39534,64,9,73,0,inf
39535,57,8,65,0,inf
39536,61,11,72,0,inf
39537,53,12,65,0,inf
39538,50,7,57,0,inf
39539,62,13,75,0,inf
39540,58,12,70,0,inf
39541,63,9,72,0,inf
39542,63,8,71,0,inf
39543,67,7,74,0,inf
39544,56,5,61,0,inf
39545,65,10,75,0,inf
39546,61,7,68,0,inf
39547,64,7,71,0,inf
39548,51,7,58,0,inf
39549,64,12,76,0,inf
39550,65,6,71,0,inf
39551,67,8,75,0,inf
39552,56,8,64,0,inf
39553,55,7,62,0,inf
39554,66,6,72,0,inf
39555,50,10,60,0,inf
39556,66,12,78,0,inf
39557,53,8,61,0,inf
39558,55,11,66,0,inf
39559,51,7,58,0,inf
39560,52,8,60,0,inf
39561,57,11,68,0,inf
39562,55,5,60,0,inf
39563,63,7,70,0,inf
39564,63,12,75,0,inf
39565,52,12,64,0,inf
39566,53,8,61,0,inf
39567,55,11,66,0,inf
39568,65,13,78,0,inf
39569,51,6,57,1,2.8665095849894655
39570,56,12,68,0,inf
39571,63,9,72,0,inf
39572,53,5,58,0,inf
39573,67,13,80,0,inf
39574,57,13,70,0,inf
39575,61,11,72,0,inf
39576,59,11,70,1,7.517028746443799
39577,60,12,72,0,inf
39578,65,13,78,0,inf
39579,54,7,61,0,inf
39580,59,9,68,0,inf
39581,57,10,67,0,inf
39582,64,8,72,0,inf
39583,54,12,66,0,inf
39584,58,12,70,0,inf
39585,52,10,62,0,inf
39586,64,8,72,0,inf
39587,61,7,68,0,inf
39588,66,12,78,0,inf
39589,59,11,70,0,inf
39590,57,5,62,0,inf
39591,66,10,76,0,inf
39592,64,8,72,0,inf
39593,63,9,72,0,inf
39594,53,9,62,0,inf
39595,65,13,78,0,inf
39596,55,11,66,0,inf
39597,55,13,68,0,inf
39598,54,5,59,0,inf
39599,55,12,67,0,inf
39600,52,9,61,0,inf
39601,60,9,69,0,inf
39602,63,12,75,0,inf
39603,50,7,57,0,inf
39604,55,11,66,0,inf
39605,50,6,56,0,inf
39606,59,7,66,0,inf
39607,56,9,65,0,inf
39608,65,6,71,0,inf
39609,55,9,64,0,inf
39610,52,11,63,0,inf
39611,52,12,64,0,inf
39612,57,10,67,0,inf
39613,61,10,71,0,inf
39614,59,10,69,0,inf
39615,58,10,68,0,inf
39616,53,12,65,0,inf
39617,51,5,56,0,inf
39618,63,10,73,0,inf
39619,54,8,62,0,inf
39620,56,6,62,0,inf
39621,56,8,64,0,inf
39622,61,5,66,0,inf
39623,67,13,80,0,inf
39624,54,6,60,0,inf
39625,55,9,64,0,inf
39626,56,6,62,0,inf
39627,65,10,75,0,inf
39628,50,6,56,0,inf
39629,66,6,72,0,inf
39630,58,9,67,0,inf
39631,53,5,58,0,inf
39632,54,9,63,0,inf
39633,65,12,77,0,inf
39634,57,11,68,1,3.03308705854932
39635,51,7,58,0,inf
39636,67,7,74,0,inf
39637,55,6,61,0,inf
39638,66,11,77,0,inf
39639,67,10,77,0,inf
39640,51,11,62,0,inf
39641,52,9,61,0,inf
39642,52,8,60,0,inf
39643,64,6,70,0,inf
39644,57,6,63,0,inf
39645,62,9,71,0,inf
39646,58,12,70,0,inf
39647,62,7,69,0,inf
39648,61,11,72,0,inf
39649,67,12,79,0,inf
39650,56,10,66,0,inf
39651,59,11,70,0,inf
39652,61,5,66,0,inf
39653,51,10,61,0,inf
39654,53,10,63,0,inf
39655,52,8,60,0,inf
39656,51,6,57,0,inf
39657,58,13,71,0,inf
39658,58,8,66,0,inf
39659,64,9,73,0,inf
39660,58,10,68,0,inf
39661,60,5,65,0,inf
39662,54,12,66,0,inf
39663,64,6,70,0,inf
39664,50,9,59,0,inf
39665,62,12,74,0,inf
39666,63,11,74,0,inf
39667,59,6,65,0,inf
39668,63,7,70,0,inf
39669,57,9,66,0,inf
39670,50,8,58,0,inf
39671,66,9,75,1,6.897701775452063
39672,55,12,67,0,inf
39673,59,6,65,0,inf
39674,62,10,72,0,inf
39675,57,11,68,1,0.7067355395900137
39676,61,8,69,0,inf
39677,54,9,63,0,inf
39678,59,13,72,0,inf
39679,63,13,76,0,inf
39680,65,10,75,1,2.542740106319144
39681,60,11,71,0,inf
39682,55,8,63,0,inf
39683,55,8,63,0,inf
39684,57,10,67,0,inf
39685,62,10,72,0,inf
39686,66,12,78,0,inf
39687,67,9,76,0,inf
39688,60,7,67,0,inf
39689,58,7,65,0,inf
39690,58,11,69,0,inf
39691,53,13,66,0,inf
39692,66,9,75,0,inf
39693,66,12,78,0,inf
39694,51,8,59,0,inf
39695,54,10,64,0,inf
39696,50,5,55,0,inf
39697,55,9,64,0,inf
39698,56,10,66,0,inf
39699,61,12,73,0,inf
39700,67,10,77,0,inf
39701,67,13,80,0,inf
39702,50,10,60,0,inf
39703,64,10,74,0,inf
39704,60,10,70,0,inf
39705,54,5,59,0,inf
39706,55,10,65,1,3.002513316830992
39707,54,7,61,0,inf
39708,63,6,69,0,inf
39709,55,13,68,0,inf
39710,62,11,73,0,inf
39711,52,10,62,1,6.834268388903972
39712,56,6,62,0,inf
39713,65,13,78,0,inf
39714,54,13,67,0,inf
39715,67,7,74,0,inf
39716,55,9,64,0,inf
39717,62,7,69,0,inf
39718,62,11,73,0,inf
39719,58,6,64,0,inf
39720,64,7,71,0,inf
39721,54,12,66,0,inf
39722,57,9,66,0,inf
39723,66,13,79,0,inf
39724,50,5,55,0,inf
39725,62,7,69,0,inf
39726,66,7,73,0,inf
39727,59,12,71,0,inf
39728,67,13,80,0,inf
39729,51,13,64,0,inf
39730,51,11,62,0,inf
39731,67,5,72,0,inf
39732,57,13,70,0,inf
39733,62,5,67,0,inf
39734,51,7,58,0,inf
39735,59,7,66,0,inf
39736,66,8,74,0,inf
39737,67,7,74,0,inf
39738,52,12,64,0,inf
39739,54,12,66,0,inf
39740,61,8,69,0,inf
39741,61,11,72,0,inf
39742,65,13,78,0,inf
39743,58,6,64,0,inf
39744,67,13,80,0,inf
39745,52,5,57,0,inf
39746,66,6,72,0,inf
39747,65,13,78,0,inf
39748,51,5,56,0,inf
39749,51,5,56,0,inf
39750,53,6,59,0,inf
39751,67,11,78,0,inf
39752,61,12,73,0,inf
39753,57,11,68,0,inf
39754,61,10,71,0,inf
39755,64,8,72,0,inf
39756,59,12,71,0,inf
39757,55,13,68,0,inf
39758,51,13,64,0,inf
39759,53,12,65,0,inf
39760,50,13,63,0,inf
39761,55,9,64,0,inf
39762,67,5,72,0,inf
39763,61,7,68,0,inf
39764,54,6,60,0,inf
39765,62,7,69,0,inf
39766,57,10,67,0,inf
39767,50,8,58,0,inf
39768,61,8,69,0,inf
39769,63,7,70,0,inf
39770,53,11,64,0,inf
39771,63,11,74,0,inf
39772,50,12,62,0,inf
39773,58,5,63,0,inf
39774,56,8,64,0,inf
39775,64,11,75,1,0.9991159261862919
39776,59,7,66,0,inf
39777,54,13,67,0,inf
39778,60,11,71,0,inf
39779,52,5,57,0,inf
39780,50,8,58,0,inf
39781,65,12,77,0,inf
39782,65,10,75,0,inf
39783,66,7,73,0,inf
39784,60,8,68,0,inf
39785,53,6,59,0,inf
39786,61,5,66,0,inf
39787,63,8,71,0,inf
39788,54,12,66,0,inf
39789,53,13,66,0,inf
39790,60,8,68,0,inf
39791,57,9,66,0,inf
39792,61,10,71,1,8.927083443393315
39793,63,11,74,0,inf
39794,67,10,77,0,inf
39795,64,10,74,0,inf
39796,59,12,71,0,inf
39797,64,13,77,0,inf
39798,61,6,67,0,inf
39799,66,6,72,0,inf
39800,65,7,72,0,inf
39801,57,7,64,0,inf
39802,51,7,58,0,inf
39803,50,10,60,0,inf
39804,64,13,77,0,inf
39805,56,6,62,0,inf
39806,51,8,59,0,inf
39807,58,7,65,0,inf
39808,60,9,69,0,inf
39809,62,9,71,0,inf
39810,55,8,63,0,inf
39811,66,11,77,1,4.200610883181497
39812,62,12,74,0,inf
39813,52,5,57,0,inf
39814,55,13,68,0,inf
39815,65,8,73,0,inf
39816,58,5,63,0,inf
39817,60,12,72,0,inf
39818,53,11,64,0,inf
39819,54,12,66,0,inf
39820,50,10,60,1,5.225942135684242
39821,50,7,57,0,inf
39822,65,8,73,0,inf
39823,65,10,75,0,inf
39824,63,6,69,0,inf
39825,62,7,69,0,inf
39826,57,12,69,0,inf
39827,51,10,61,0,inf
39828,52,13,65,0,inf
39829,65,12,77,0,inf
39830,59,10,69,0,inf
39831,53,8,61,0,inf
39832,67,9,76,0,inf
39833,55,12,67,0,inf
39834,56,10,66,0,inf
39835,51,6,57,0,inf
39836,60,12,72,0,inf
39837,60,10,70,0,inf
39838,54,5,59,0,inf
39839,67,13,80,0,inf
39840,65,10,75,0,inf
39841,63,6,69,0,inf
39842,55,9,64,0,inf
39843,53,10,63,0,inf
39844,62,11,73,0,inf
39845,53,9,62,0,inf
39846,62,5,67,0,inf
39847,54,5,59,0,inf
39848,54,11,65,0,inf
39849,52,11,63,0,inf
39850,52,13,65,0,inf
39851,50,6,56,0,inf
39852,50,8,58,0,inf
39853,56,12,68,0,inf
39854,60,6,66,0,inf
39855,64,11,75,0,inf
39856,66,8,74,0,inf
39857,55,12,67,0,inf
39858,53,8,61,0,inf
39859,61,8,69,0,inf
39860,66,8,74,0,inf
39861,63,13,76,0,inf
39862,51,5,56,0,inf
39863,56,9,65,0,inf
39864,57,8,65,0,inf
39865,52,9,61,0,inf
39866,52,10,62,0,inf
39867,53,13,66,0,inf
39868,52,6,58,0,inf
39869,64,12,76,0,inf
39870,52,10,62,0,inf
39871,55,8,63,0,inf
39872,50,7,57,0,inf
39873,61,12,73,1,9.13853238939592
39874,63,12,75,0,inf
39875,56,5,61,0,inf
39876,58,13,71,0,inf
39877,65,10,75,0,inf
39878,51,6,57,0,inf
39879,56,13,69,0,inf
39880,50,10,60,0,inf
39881,60,5,65,0,inf
39882,65,11,76,0,inf
39883,57,9,66,0,inf
39884,57,13,70,0,inf
39885,53,9,62,0,inf
39886,61,12,73,0,inf
39887,64,12,76,0,inf
39888,55,6,61,0,inf
39889,67,8,75,0,inf
39890,65,6,71,0,inf
39891,52,12,64,0,inf
39892,63,8,71,0,inf
39893,65,7,72,0,inf
39894,54,13,67,0,inf
39895,58,12,70,1,11.646024466218122
39896,50,9,59,0,inf
39897,53,6,59,0,inf
39898,65,5,70,0,inf
39899,53,13,66,0,inf
39900,67,13,80,0,inf
39901,54,6,60,0,inf
39902,64,7,71,0,inf
39903,60,10,70,0,inf
39904,57,6,63,0,inf
39905,56,6,62,0,inf
39906,53,6,59,0,inf
39907,50,7,57,0,inf
39908,56,5,61,0,inf
39909,60,6,66,0,inf
39910,57,11,68,0,inf
39911,52,13,65,0,inf
39912,52,8,60,0,inf
39913,56,5,61,0,inf
39914,57,11,68,0,inf
39915,66,10,76,0,inf
39916,64,9,73,0,inf
39917,52,8,60,0,inf
39918,60,10,70,0,inf
39919,61,12,73,1,4.849085834763116
39920,61,9,70,0,inf
39921,66,5,71,0,inf
39922,57,10,67,0,inf
39923,66,12,78,0,inf
39924,64,10,74,0,inf
39925,63,11,74,0,inf
39926,52,7,59,0,inf
39927,56,6,62,0,inf
39928,57,7,64,0,inf
39929,55,10,65,0,inf
39930,60,9,69,0,inf
39931,52,13,65,0,inf
39932,52,12,64,0,inf
39933,57,11,68,0,inf
39934,67,9,76,1,3.4230899945103346
39935,65,7,72,0,inf
39936,58,8,66,1,0.21014055140679488
39937,52,12,64,0,inf
39938,52,5,57,0,inf
39939,62,6,68,0,inf
39940,51,10,61,0,inf
39941,62,11,73,0,inf
39942,53,12,65,0,inf
39943,61,5,66,0,inf
39944,63,10,73,0,inf
39945,51,11,62,0,inf
39946,57,6,63,0,inf
39947,58,8,66,0,inf
39948,64,5,69,0,inf
39949,57,7,64,0,inf
39950,60,7,67,0,inf
39951,54,5,59,0,inf
39952,67,6,73,0,inf
39953,63,11,74,0,inf
39954,67,6,73,0,inf
39955,54,12,66,0,inf
39956,59,5,64,1,1.0294124612858013
39957,56,11,67,0,inf
39958,56,12,68,0,inf
39959,65,9,74,0,inf
39960,58,12,70,0,inf
39961,55,12,67,0,inf
39962,52,13,65,0,inf
39963,61,13,74,0,inf
39964,55,7,62,0,inf
39965,58,12,70,0,inf
39966,53,7,60,0,inf
39967,65,5,70,0,inf
39968,55,6,61,0,inf
39969,58,6,64,0,inf
39970,64,7,71,0,inf
39971,56,13,69,0,inf
39972,56,13,69,0,inf
39973,66,11,77,0,inf
39974,61,12,73,0,inf
39975,60,7,67,0,inf
39976,66,7,73,1,0.4505800130596498
39977,61,11,72,0,inf
39978,58,12,70,0,inf
39979,62,7,69,0,inf
39980,56,8,64,0,inf
39981,50,5,55,0,inf
39982,51,11,62,0,inf
39983,50,6,56,0,inf
39984,59,5,64,0,inf
39985,56,6,62,0,inf
39986,54,8,62,0,inf
39987,52,11,63,0,inf
39988,65,7,72,0,inf
39989,62,10,72,0,inf
39990,62,9,71,0,inf
39991,52,7,59,0,inf
39992,63,6,69,0,inf
39993,56,6,62,0,inf
39994,67,9,76,0,inf
39995,65,11,76,0,inf
39996,66,7,73,0,inf
39997,62,11,73,0,inf
39998,64,9,73,0,inf
39999,55,5,60,0,inf
40000,62,7,69,0,inf
40001,67,12,79,0,inf
40002,52,5,57,0,inf
40003,54,10,64,0,inf
40004,67,13,80,0,inf
40005,52,11,63,0,inf
40006,58,6,64,0,inf
40007,57,13,70,0,inf
40008,59,7,66,0,inf
40009,53,11,64,0,inf
40010,55,7,62,0,inf
40011,67,9,76,0,inf
40012,67,11,78,0,inf
40013,57,11,68,0,inf
40014,51,8,59,0,inf
40015,60,9,69,0,inf
40016,52,13,65,0,inf
40017,65,8,73,0,inf
40018,65,8,73,0,inf
40019,53,5,58,0,inf
40020,57,11,68,0,inf
40021,61,8,69,0,inf
40022,54,7,61,0,inf
40023,58,9,67,0,inf
40024,60,5,65,0,inf
40025,52,5,57,0,inf
40026,64,8,72,0,inf
40027,58,7,65,0,inf
40028,64,13,77,0,inf
40029,51,5,56,0,inf
40030,61,5,66,0,inf
40031,52,6,58,0,inf
40032,65,13,78,0,inf
40033,63,11,74,0,inf
40034,61,13,74,0,inf
40035,65,11,76,0,inf
40036,62,8,70,0,inf
40037,64,11,75,0,inf
40038,54,13,67,1,1.7292993440733326
40039,53,10,63,0,inf
40040,67,5,72,0,inf
40041,61,5,66,0,inf
40042,60,5,65,0,inf
40043,66,11,77,0,inf
40044,58,10,68,0,inf
40045,58,10,68,0,inf
40046,66,7,73,0,inf
40047,62,12,74,0,inf
40048,66,13,79,1,3.319785731858886
40049,66,13,79,0,inf
40050,58,5,63,0,inf
40051,66,12,78,0,inf
40052,54,9,63,0,inf
40053,56,8,64,0,inf
40054,50,11,61,0,inf
40055,55,6,61,0,inf
40056,65,13,78,0,inf
40057,66,6,72,0,inf
40058,54,13,67,0,inf
40059,65,9,74,0,inf
40060,57,9,66,0,inf
40061,61,10,71,0,inf
40062,53,6,59,0,inf
40063,61,7,68,0,inf
40064,52,13,65,1,12.926338302703101
40065,56,6,62,0,inf
40066,58,7,65,0,inf
40067,56,8,64,0,inf
40068,50,12,62,0,inf
40069,63,9,72,0,inf
40070,56,9,65,0,inf
40071,56,5,61,0,inf
40072,55,6,61,0,inf
40073,53,10,63,0,inf
40074,54,8,62,0,inf
40075,52,12,64,0,inf
40076,52,10,62,0,inf
40077,59,7,66,1,4.446825331474706
40078,67,11,78,0,inf
40079,61,12,73,0,inf
40080,65,5,70,0,inf
40081,61,12,73,0,inf
40082,60,5,65,0,inf
40083,56,10,66,0,inf
40084,67,8,75,0,inf
40085,65,12,77,0,inf
40086,55,6,61,0,inf
40087,62,6,68,0,inf
40088,51,10,61,0,inf
40089,50,6,56,0,inf
40090,66,9,75,0,inf
40091,61,8,69,0,inf
40092,54,7,61,0,inf
40093,59,9,68,0,inf
40094,62,7,69,0,inf
40095,55,12,67,0,inf
40096,67,6,73,0,inf
40097,50,6,56,0,inf
40098,64,5,69,0,inf
40099,58,7,65,0,inf
40100,64,12,76,0,inf
40101,65,11,76,0,inf
40102,62,8,70,0,inf
40103,67,12,79,0,inf
40104,54,13,67,0,inf
40105,55,12,67,0,inf
40106,51,7,58,0,inf
40107,57,12,69,0,inf
40108,51,13,64,0,inf
40109,60,11,71,0,inf
40110,52,11,63,0,inf
40111,55,10,65,0,inf
40112,59,5,64,0,inf
40113,66,13,79,0,inf
40114,55,6,61,0,inf
40115,63,9,72,0,inf
40116,64,13,77,0,inf
40117,50,9,59,1,8.30950704816295
40118,55,13,68,0,inf
40119,65,12,77,0,inf
40120,55,12,67,0,inf
40121,58,11,69,0,inf
40122,63,6,69,0,inf
40123,60,9,69,0,inf
40124,65,10,75,0,inf
40125,55,13,68,0,inf
40126,59,9,68,0,inf
40127,52,11,63,0,inf
40128,65,11,76,0,inf
40129,50,12,62,0,inf
40130,53,6,59,0,inf
40131,52,6,58,0,inf
40132,55,5,60,0,inf
40133,67,7,74,0,inf
40134,55,10,65,0,inf
40135,61,11,72,0,inf
40136,58,10,68,0,inf
40137,67,8,75,0,inf
40138,52,13,65,1,2.5030472594934707
40139,58,10,68,0,inf
40140,65,5,70,0,inf
40141,66,8,74,0,inf
40142,57,13,70,0,inf
40143,57,8,65,0,inf
40144,51,7,58,1,3.203094648198956
40145,57,10,67,0,inf
40146,57,13,70,0,inf
40147,65,9,74,0,inf
40148,55,10,65,0,inf
40149,63,6,69,0,inf
40150,67,7,74,0,inf
40151,62,6,68,0,inf
40152,52,10,62,0,inf
40153,65,5,70,0,inf
40154,61,7,68,0,inf
40155,67,10,77,0,inf
40156,56,9,65,0,inf
40157,57,12,69,0,inf
40158,63,5,68,0,inf
40159,63,6,69,0,inf
40160,67,9,76,0,inf
40161,62,7,69,0,inf
40162,55,8,63,0,inf
40163,58,9,67,0,inf
40164,51,7,58,0,inf
40165,64,6,70,0,inf
40166,55,13,68,0,inf
40167,67,11,78,0,inf
40168,54,12,66,0,inf
40169,56,13,69,0,inf
40170,64,12,76,0,inf
40171,62,13,75,0,inf
40172,50,7,57,0,inf
40173,62,11,73,0,inf
40174,62,8,70,0,inf
40175,53,13,66,0,inf
40176,66,6,72,0,inf
40177,53,5,58,0,inf
40178,63,5,68,0,inf
40179,63,7,70,0,inf
40180,67,5,72,0,inf
40181,54,7,61,0,inf
40182,63,13,76,0,inf
40183,53,6,59,0,inf
40184,56,8,64,0,inf
40185,52,7,59,0,inf
40186,53,6,59,0,inf
40187,57,7,64,0,inf
40188,61,13,74,0,inf
40189,63,11,74,1,8.012260134485913
40190,50,5,55,0,inf
40191,65,10,75,0,inf
40192,55,10,65,0,inf
40193,53,6,59,0,inf
40194,55,5,60,0,inf
40195,61,9,70,0,inf
40196,54,5,59,0,inf
40197,62,7,69,0,inf
40198,67,11,78,0,inf
40199,61,10,71,0,inf
40200,61,12,73,0,inf
40201,65,11,76,0,inf
40202,62,6,68,0,inf
40203,52,10,62,0,inf
40204,67,11,78,0,inf
40205,67,12,79,0,inf
40206,53,11,64,0,inf
40207,63,5,68,0,inf
40208,59,6,65,0,inf
40209,61,12,73,0,inf
40210,54,13,67,0,inf
40211,51,6,57,0,inf
40212,63,6,69,0,inf
40213,56,12,68,0,inf
40214,52,5,57,0,inf
40215,56,5,61,0,inf
40216,50,9,59,0,inf
40217,54,9,63,0,inf
40218,52,13,65,0,inf
40219,59,8,67,1,7.695346259998274
40220,50,8,58,0,inf
40221,55,11,66,0,inf
40222,65,6,71,0,inf
40223,52,13,65,0,inf
40224,53,11,64,0,inf
40225,58,9,67,0,inf
40226,51,10,61,0,inf
40227,65,7,72,0,inf
40228,61,10,71,0,inf
40229,51,8,59,0,inf
40230,59,10,69,0,inf
40231,65,5,70,0,inf
40232,59,10,69,0,inf
40233,51,10,61,0,inf
40234,58,6,64,0,inf
40235,53,5,58,0,inf
40236,61,7,68,0,inf
40237,63,13,76,0,inf
40238,66,11,77,0,inf
40239,53,11,64,0,inf
40240,51,7,58,0,inf
40241,50,13,63,0,inf
40242,65,11,76,0,inf
40243,59,5,64,0,inf
40244,58,10,68,0,inf
40245,62,6,68,0,inf
40246,67,13,80,0,inf
40247,67,7,74,0,inf
40248,54,10,64,0,inf
40249,60,10,70,0,inf
40250,65,9,74,0,inf
40251,55,10,65,0,inf
40252,60,11,71,0,inf
40253,62,6,68,0,inf
40254,57,10,67,0,inf
40255,65,7,72,0,inf
40256,56,9,65,0,inf
40257,62,12,74,0,inf
40258,58,9,67,0,inf
40259,67,5,72,0,inf
40260,54,10,64,0,inf
40261,51,9,60,0,inf
40262,61,12,73,0,inf
40263,59,8,67,0,inf
40264,50,13,63,0,inf
40265,65,10,75,0,inf
40266,61,12,73,0,inf
40267,59,10,69,0,inf
40268,57,12,69,0,inf
40269,58,9,67,0,inf
40270,59,9,68,0,inf
40271,66,7,73,0,inf
40272,58,9,67,0,inf
40273,54,11,65,0,inf
40274,65,6,71,0,inf
40275,54,9,63,0,inf
40276,63,5,68,0,inf
40277,51,9,60,1,1.6619715592124962
40278,61,5,66,0,inf
40279,56,8,64,0,inf
40280,57,11,68,0,inf
40281,59,11,70,0,inf
40282,63,9,72,0,inf
40283,52,8,60,0,inf
40284,53,10,63,0,inf
40285,63,12,75,0,inf
40286,59,8,67,0,inf
40287,58,6,64,0,inf
40288,57,13,70,0,inf
40289,53,6,59,0,inf
40290,65,13,78,0,inf
40291,58,11,69,1,0.33557396954162044
40292,66,8,74,1,6.375713333295522
40293,58,11,69,0,inf
40294,61,9,70,0,inf
40295,51,7,58,0,inf
40296,60,9,69,0,inf
40297,51,10,61,0,inf
40298,61,12,73,0,inf
40299,64,6,70,0,inf
40300,56,6,62,0,inf
40301,54,5,59,0,inf
40302,55,9,64,0,inf
40303,62,5,67,0,inf
40304,54,10,64,0,inf
40305,50,8,58,0,inf
40306,65,10,75,0,inf
40307,65,11,76,0,inf
40308,59,13,72,0,inf
40309,67,11,78,0,inf
40310,58,11,69,0,inf
40311,59,9,68,0,inf
40312,66,12,78,0,inf
40313,65,9,74,0,inf
40314,60,11,71,1,8.142932771362169
40315,59,8,67,0,inf
40316,65,7,72,0,inf
40317,54,10,64,0,inf
40318,61,11,72,0,inf
40319,53,8,61,0,inf
40320,65,5,70,0,inf
40321,53,13,66,0,inf
40322,54,8,62,0,inf
40323,63,9,72,0,inf
40324,64,9,73,0,inf
40325,58,8,66,0,inf
40326,64,7,71,0,inf
40327,63,12,75,0,inf
40328,60,6,66,0,inf
40329,50,8,58,0,inf
40330,66,6,72,0,inf
40331,58,13,71,0,inf
40332,53,7,60,0,inf
40333,64,9,73,0,inf
40334,54,9,63,0,inf
40335,51,6,57,0,inf
40336,64,8,72,0,inf
40337,57,6,63,0,inf
40338,50,7,57,0,inf
40339,53,12,65,0,inf
40340,67,13,80,0,inf
40341,61,7,68,0,inf
40342,62,9,71,0,inf
40343,58,9,67,0,inf
40344,58,7,65,0,inf
40345,67,10,77,0,inf
40346,52,6,58,0,inf
40347,67,7,74,0,inf
40348,60,9,69,0,inf
40349,64,13,77,0,inf
40350,59,10,69,0,inf
40351,61,11,72,0,inf
40352,58,12,70,0,inf
40353,53,13,66,0,inf
40354,51,6,57,0,inf
40355,67,6,73,0,inf
40356,51,5,56,0,inf
40357,60,6,66,0,inf
40358,65,7,72,0,inf
40359,65,12,77,0,inf
40360,64,13,77,0,inf
40361,51,12,63,0,inf
40362,67,10,77,0,inf
40363,60,12,72,0,inf
40364,67,12,79,0,inf
40365,62,8,70,0,inf
40366,58,11,69,0,inf
40367,61,11,72,0,inf
40368,66,5,71,0,inf
40369,57,5,62,0,inf
40370,53,5,58,0,inf
40371,62,8,70,0,inf
40372,60,12,72,0,inf
40373,53,11,64,0,inf
40374,53,7,60,0,inf
40375,55,11,66,0,inf
40376,59,7,66,0,inf
40377,64,12,76,0,inf
40378,61,8,69,0,inf
40379,62,8,70,0,inf
40380,59,8,67,0,inf
40381,67,11,78,0,inf
40382,67,11,78,0,inf
40383,65,12,77,0,inf
40384,64,11,75,0,inf
40385,60,6,66,0,inf
40386,51,7,58,0,inf
40387,52,12,64,0,inf
40388,65,12,77,0,inf
40389,57,7,64,0,inf
40390,64,12,76,0,inf
40391,52,7,59,0,inf
40392,61,9,70,0,inf
40393,59,8,67,0,inf
40394,55,8,63,0,inf
40395,55,8,63,0,inf
40396,62,8,70,0,inf
40397,55,12,67,0,inf
40398,63,13,76,0,inf
40399,59,11,70,0,inf
40400,54,6,60,0,inf
40401,52,7,59,0,inf
40402,62,11,73,0,inf
40403,57,6,63,0,inf
40404,63,8,71,0,inf
40405,62,6,68,0,inf
40406,54,11,65,0,inf
40407,62,10,72,0,inf
40408,52,8,60,0,inf
40409,50,8,58,0,inf
40410,54,10,64,0,inf
40411,50,9,59,0,inf
40412,52,13,65,0,inf
40413,62,5,67,0,inf
40414,52,6,58,0,inf
40415,61,8,69,0,inf
40416,56,6,62,0,inf
40417,62,13,75,0,inf
40418,63,7,70,0,inf
40419,53,9,62,0,inf
40420,64,12,76,0,inf
40421,51,13,64,0,inf
40422,51,10,61,0,inf
40423,58,11,69,0,inf
40424,56,6,62,0,inf
40425,58,5,63,0,inf
40426,53,13,66,0,inf
40427,57,6,63,0,inf
40428,52,10,62,0,inf
40429,66,11,77,0,inf
40430,63,9,72,0,inf
40431,55,10,65,0,inf
40432,58,6,64,0,inf
40433,67,12,79,1,7.580604970655088
40434,58,5,63,0,inf
40435,66,6,72,0,inf
40436,64,9,73,0,inf
40437,66,9,75,0,inf
40438,59,11,70,0,inf
40439,54,6,60,1,4.710827104184183
40440,51,7,58,0,inf
40441,66,12,78,0,inf
40442,65,6,71,0,inf
40443,54,9,63,0,inf
40444,61,11,72,0,inf
40445,52,5,57,0,inf
40446,54,7,61,0,inf
40447,59,10,69,0,inf
40448,60,7,67,0,inf
40449,60,9,69,0,inf
40450,64,6,70,0,inf
40451,61,8,69,0,inf
40452,66,11,77,0,inf
40453,67,6,73,0,inf
40454,54,5,59,0,inf
40455,54,10,64,0,inf
40456,52,8,60,0,inf
40457,62,10,72,0,inf
40458,53,12,65,0,inf
40459,54,9,63,0,inf
40460,62,13,75,0,inf
40461,64,7,71,0,inf
40462,61,5,66,0,inf
40463,52,7,59,0,inf
40464,62,6,68,0,inf
40465,63,5,68,0,inf
40466,63,7,70,0,inf
40467,63,12,75,0,inf
40468,57,5,62,0,inf
40469,63,9,72,0,inf
40470,50,7,57,0,inf
40471,62,5,67,0,inf
40472,66,6,72,0,inf
40473,56,10,66,0,inf
40474,57,6,63,0,inf
40475,65,8,73,0,inf
40476,63,7,70,0,inf
40477,67,11,78,0,inf
40478,51,7,58,0,inf
40479,62,11,73,0,inf
40480,54,11,65,0,inf
40481,58,9,67,0,inf
40482,65,9,74,0,inf
40483,52,6,58,0,inf
40484,67,12,79,0,inf
40485,60,11,71,0,inf
40486,50,8,58,0,inf
40487,55,9,64,0,inf
40488,53,10,63,0,inf
40489,50,11,61,0,inf
40490,56,11,67,0,inf
40491,54,6,60,0,inf
40492,59,5,64,0,inf
40493,61,6,67,0,inf
40494,52,10,62,0,inf
40495,50,5,55,0,inf
40496,66,9,75,0,inf
40497,66,8,74,0,inf
40498,60,6,66,0,inf
40499,64,8,72,0,inf
40500,50,9,59,0,inf
40501,52,13,65,0,inf
40502,52,12,64,0,inf
40503,62,6,68,0,inf
40504,57,13,70,0,inf
40505,52,5,57,0,inf
40506,52,8,60,1,4.134089427060459
40507,52,6,58,0,inf
40508,61,5,66,0,inf
40509,56,6,62,0,inf
40510,50,8,58,0,inf
40511,55,10,65,0,inf
40512,50,12,62,0,inf
40513,56,13,69,0,inf
40514,58,11,69,0,inf
40515,52,11,63,0,inf
40516,54,10,64,0,inf
40517,54,5,59,0,inf
40518,62,11,73,0,inf
40519,56,10,66,0,inf
40520,64,8,72,0,inf
40521,61,11,72,0,inf
40522,65,11,76,0,inf
40523,64,5,69,0,inf
40524,57,6,63,0,inf
40525,57,13,70,0,inf
40526,56,6,62,0,inf
40527,56,9,65,0,inf
40528,63,9,72,0,inf
40529,52,9,61,1,6.458992466176326
40530,54,13,67,0,inf
40531,67,12,79,0,inf
40532,50,8,58,0,inf
40533,50,9,59,0,inf
40534,56,5,61,0,inf
40535,63,7,70,0,inf
40536,60,10,70,0,inf
40537,56,9,65,0,inf
40538,67,11,78,0,inf
40539,61,8,69,0,inf
40540,50,9,59,0,inf
40541,63,12,75,0,inf
40542,54,10,64,0,inf
40543,50,13,63,0,inf
40544,53,12,65,0,inf
40545,64,7,71,0,inf
40546,61,9,70,0,inf
40547,59,12,71,0,inf
40548,66,10,76,1,2.9360544614254422
40549,57,12,69,0,inf
40550,56,12,68,0,inf
40551,54,12,66,0,inf
40552,63,13,76,0,inf
40553,50,8,58,0,inf
40554,54,12,66,0,inf
40555,67,5,72,0,inf
40556,66,13,79,0,inf
40557,51,8,59,0,inf
40558,58,12,70,0,inf
40559,65,8,73,0,inf
40560,56,11,67,0,inf
40561,67,8,75,0,inf
40562,61,5,66,0,inf
40563,62,13,75,0,inf
40564,63,5,68,0,inf
40565,51,10,61,0,inf
40566,58,5,63,0,inf
40567,63,6,69,0,inf
40568,65,6,71,0,inf
40569,54,7,61,0,inf
40570,51,5,56,0,inf
40571,53,12,65,0,inf
40572,55,11,66,0,inf
40573,61,13,74,0,inf
40574,58,5,63,0,inf
40575,67,5,72,0,inf
40576,56,13,69,0,inf
40577,52,7,59,0,inf
40578,59,5,64,0,inf
40579,62,12,74,0,inf
40580,56,12,68,0,inf
40581,65,6,71,1,3.5174668396275592
40582,65,8,73,0,inf
40583,50,13,63,0,inf
40584,64,9,73,0,inf
40585,61,5,66,0,inf
40586,55,13,68,0,inf
40587,57,13,70,1,4.792232887261868
40588,60,7,67,0,inf
40589,63,8,71,0,inf
40590,59,6,65,0,inf
40591,65,13,78,0,inf
40592,50,13,63,0,inf
40593,63,7,70,0,inf
40594,62,13,75,1,2.658070456678672
40595,67,6,73,0,inf
40596,50,9,59,0,inf
40597,63,10,73,0,inf
40598,51,7,58,0,inf
40599,53,7,60,0,inf
40600,65,10,75,0,inf
40601,58,8,66,0,inf
40602,54,11,65,0,inf
40603,62,5,67,0,inf
40604,65,5,70,0,inf
40605,61,13,74,0,inf
40606,56,5,61,0,inf
40607,52,9,61,0,inf
40608,60,5,65,0,inf
40609,59,8,67,0,inf
40610,53,6,59,0,inf
40611,67,7,74,0,inf
40612,64,6,70,0,inf
40613,64,13,77,0,inf
40614,51,5,56,0,inf
40615,50,11,61,0,inf
40616,58,10,68,1,0.522294173010053
40617,64,6,70,0,inf
40618,51,5,56,0,inf
40619,65,5,70,0,inf
40620,60,10,70,0,inf
40621,55,6,61,0,inf
40622,55,11,66,0,inf
40623,60,12,72,0,inf
40624,55,11,66,0,inf
40625,54,12,66,0,inf
40626,52,5,57,0,inf
40627,52,11,63,0,inf
40628,65,6,71,0,inf
40629,53,9,62,0,inf
40630,57,7,64,0,inf
40631,67,5,72,0,inf
40632,59,13,72,0,inf
40633,58,11,69,0,inf
40634,53,11,64,1,0.14202574982939353
40635,67,9,76,0,inf
40636,53,5,58,0,inf
40637,65,9,74,0,inf
40638,59,6,65,0,inf
40639,54,8,62,0,inf
40640,56,6,62,0,inf
40641,60,6,66,0,inf
40642,65,5,70,0,inf
40643,63,9,72,0,inf
40644,57,6,63,0,inf
40645,51,10,61,0,inf
40646,59,11,70,0,inf
40647,65,7,72,0,inf
40648,51,10,61,0,inf
40649,53,13,66,0,inf
40650,59,7,66,0,inf
40651,65,9,74,0,inf
40652,56,6,62,0,inf
40653,52,7,59,0,inf
40654,60,10,70,0,inf
40655,57,9,66,0,inf
40656,66,5,71,0,inf
40657,55,6,61,0,inf
40658,59,7,66,0,inf
40659,51,13,64,0,inf
40660,61,11,72,0,inf
40661,56,7,63,0,inf
40662,55,7,62,0,inf
40663,60,11,71,1,8.045543613707594
40664,51,8,59,0,inf
40665,64,6,70,0,inf
40666,54,6,60,0,inf
40667,53,12,65,0,inf
40668,54,13,67,1,6.877033402067646
40669,53,9,62,1,6.1938973110367925
40670,60,6,66,0,inf
40671,67,13,80,0,inf
40672,54,7,61,0,inf
40673,61,10,71,0,inf
40674,65,7,72,0,inf
40675,61,5,66,0,inf
40676,51,12,63,0,inf
40677,50,13,63,0,inf
40678,52,11,63,0,inf
40679,57,7,64,0,inf
40680,64,6,70,0,inf
40681,52,10,62,0,inf
40682,51,12,63,0,inf
40683,60,13,73,0,inf
40684,51,5,56,0,inf
40685,60,6,66,0,inf
40686,66,10,76,0,inf
40687,52,6,58,0,inf
40688,52,12,64,0,inf
40689,54,13,67,0,inf
40690,53,8,61,0,inf
40691,66,12,78,0,inf
40692,63,5,68,0,inf
40693,58,11,69,0,inf
40694,53,11,64,0,inf
40695,50,6,56,0,inf
40696,67,13,80,0,inf
40697,64,11,75,0,inf
40698,52,11,63,0,inf
40699,62,5,67,0,inf
40700,66,11,77,0,inf
40701,63,6,69,0,inf
40702,65,8,73,0,inf
40703,54,12,66,0,inf
40704,67,12,79,0,inf
40705,64,5,69,0,inf
40706,67,13,80,0,inf
40707,56,9,65,0,inf
40708,51,7,58,0,inf
40709,66,10,76,0,inf
40710,66,6,72,0,inf
40711,59,5,64,0,inf
40712,50,7,57,0,inf
40713,67,10,77,1,6.124127110913406
40714,53,9,62,0,inf
40715,56,5,61,0,inf
40716,67,12,79,0,inf
40717,50,7,57,0,inf
40718,57,9,66,0,inf
40719,62,6,68,0,inf
40720,59,8,67,0,inf
40721,61,9,70,0,inf
40722,60,5,65,0,inf
40723,63,13,76,0,inf
40724,58,9,67,0,inf
40725,67,12,79,0,inf
40726,53,7,60,0,inf
40727,63,11,74,0,inf
40728,53,12,65,0,inf
40729,56,10,66,0,inf
40730,52,5,57,0,inf
40731,53,10,63,0,inf
40732,65,6,71,0,inf
40733,66,5,71,0,inf
40734,65,11,76,0,inf
40735,50,11,61,0,inf
40736,64,12,76,0,inf
40737,59,5,64,0,inf
40738,66,8,74,0,inf
40739,56,7,63,0,inf
40740,64,11,75,0,inf
40741,57,7,64,0,inf
40742,67,5,72,0,inf
40743,53,11,64,0,inf
40744,64,10,74,0,inf
40745,57,9,66,0,inf
40746,61,9,70,0,inf
40747,65,9,74,0,inf
40748,50,12,62,0,inf
40749,60,10,70,0,inf
40750,58,10,68,0,inf
40751,61,8,69,0,inf
40752,51,6,57,0,inf
40753,67,10,77,0,inf
40754,61,8,69,0,inf
40755,53,6,59,1,1.1359271918752896
40756,53,10,63,0,inf
40757,64,8,72,0,inf
40758,66,9,75,0,inf
40759,54,13,67,0,inf
40760,55,7,62,0,inf
40761,63,12,75,0,inf
40762,60,13,73,0,inf
40763,52,11,63,0,inf
40764,64,11,75,0,inf
40765,53,11,64,0,inf
40766,62,11,73,0,inf
40767,52,6,58,0,inf
40768,50,8,58,0,inf
40769,64,8,72,0,inf
40770,52,7,59,0,inf
40771,53,5,58,0,inf
40772,65,7,72,0,inf
40773,51,7,58,0,inf
40774,51,5,56,0,inf
40775,58,11,69,0,inf
40776,62,13,75,0,inf
40777,60,13,73,0,inf
40778,66,5,71,0,inf
40779,53,9,62,0,inf
40780,63,10,73,0,inf
40781,55,13,68,0,inf
40782,60,9,69,0,inf
40783,57,6,63,0,inf
40784,51,10,61,0,inf
40785,55,5,60,0,inf
40786,63,5,68,0,inf
40787,55,7,62,0,inf
40788,59,7,66,0,inf
40789,52,8,60,0,inf
40790,63,12,75,0,inf
40791,56,5,61,0,inf
40792,57,11,68,0,inf
40793,62,11,73,0,inf
40794,53,8,61,0,inf
40795,65,5,70,0,inf
40796,67,12,79,0,inf
40797,54,10,64,0,inf
40798,52,9,61,0,inf
40799,64,12,76,0,inf
40800,67,8,75,0,inf
40801,50,8,58,0,inf
40802,52,13,65,1,6.77863666797564
40803,50,10,60,0,inf
40804,59,11,70,0,inf
40805,56,7,63,0,inf
40806,66,5,71,0,inf
40807,55,6,61,0,inf
40808,59,13,72,0,inf
40809,63,11,74,0,inf
40810,63,8,71,0,inf
40811,55,5,60,0,inf
40812,56,11,67,0,inf
40813,66,12,78,0,inf
40814,53,10,63,0,inf
40815,54,10,64,0,inf
40816,62,11,73,0,inf
40817,55,5,60,0,inf
40818,58,13,71,0,inf
40819,54,11,65,0,inf
40820,51,7,58,0,inf
40821,62,10,72,0,inf
40822,60,13,73,0,inf
40823,60,13,73,0,inf
40824,60,9,69,0,inf
40825,53,12,65,0,inf
40826,62,7,69,0,inf
40827,61,13,74,0,inf
40828,62,10,72,0,inf
40829,64,5,69,0,inf
40830,58,6,64,0,inf
40831,63,11,74,0,inf
40832,51,7,58,0,inf
40833,67,10,77,0,inf
40834,53,6,59,0,inf
40835,56,11,67,0,inf
40836,66,10,76,0,inf
40837,67,10,77,0,inf
40838,62,12,74,0,inf
40839,63,13,76,0,inf
40840,61,8,69,0,inf
40841,67,12,79,0,inf
40842,52,6,58,0,inf
40843,54,6,60,0,inf
40844,61,9,70,0,inf
40845,50,8,58,0,inf
40846,61,10,71,0,inf
40847,55,11,66,0,inf
40848,61,7,68,0,inf
40849,65,10,75,0,inf
40850,51,9,60,0,inf
40851,56,9,65,0,inf
40852,67,9,76,0,inf
40853,50,13,63,0,inf
40854,54,13,67,0,inf
40855,63,12,75,0,inf
40856,62,13,75,0,inf
40857,52,7,59,0,inf
40858,58,13,71,0,inf
40859,63,9,72,0,inf
40860,56,6,62,0,inf
40861,52,7,59,0,inf
40862,61,6,67,0,inf
40863,64,9,73,0,inf
40864,66,11,77,0,inf
40865,61,8,69,0,inf
40866,62,6,68,0,inf
40867,53,7,60,0,inf
40868,62,10,72,0,inf
40869,64,10,74,0,inf
40870,63,13,76,0,inf
40871,62,6,68,0,inf
40872,65,7,72,0,inf
40873,55,7,62,0,inf
40874,65,13,78,0,inf
40875,66,12,78,0,inf
40876,60,13,73,0,inf
40877,59,10,69,0,inf
40878,58,12,70,0,inf
40879,57,6,63,0,inf
40880,62,6,68,0,inf
40881,63,13,76,0,inf
40882,50,7,57,0,inf
40883,57,11,68,1,10.975837725540472
40884,66,12,78,0,inf
40885,66,10,76,0,inf
40886,56,10,66,0,inf
40887,65,8,73,0,inf
40888,64,7,71,0,inf
40889,59,5,64,0,inf
40890,62,12,74,1,6.244125770095181
40891,50,9,59,0,inf
40892,58,12,70,0,inf
40893,63,8,71,0,inf
40894,57,11,68,0,inf
40895,64,6,70,0,inf
40896,61,11,72,0,inf
40897,52,6,58,0,inf
40898,67,10,77,0,inf
40899,62,6,68,0,inf
40900,62,6,68,0,inf
40901,59,6,65,0,inf
40902,53,10,63,0,inf
40903,50,10,60,1,4.4328235237014155
40904,55,9,64,0,inf
40905,65,10,75,0,inf
40906,66,11,77,0,inf
40907,66,9,75,0,inf
40908,65,11,76,0,inf
40909,55,10,65,0,inf
40910,61,13,74,0,inf
40911,55,13,68,0,inf
40912,61,8,69,0,inf
40913,56,12,68,0,inf
40914,60,5,65,0,inf
40915,66,8,74,0,inf
40916,58,8,66,0,inf
40917,53,9,62,0,inf
40918,67,8,75,0,inf
40919,55,11,66,0,inf
40920,57,10,67,0,inf
40921,59,8,67,0,inf
40922,56,12,68,0,inf
40923,62,12,74,0,inf
40924,64,9,73,0,inf
40925,64,5,69,0,inf
40926,52,10,62,0,inf
40927,64,10,74,0,inf
40928,62,8,70,0,inf
40929,55,13,68,0,inf
40930,67,11,78,0,inf
40931,56,8,64,0,inf
40932,60,5,65,0,inf
40933,55,12,67,1,9.596936280371523
40934,61,12,73,0,inf
40935,56,13,69,0,inf
40936,64,8,72,0,inf
40937,65,7,72,0,inf
40938,63,10,73,0,inf
40939,54,13,67,0,inf
40940,55,13,68,0,inf
40941,54,13,67,0,inf
40942,61,7,68,0,inf
40943,60,8,68,0,inf
40944,52,10,62,0,inf
40945,51,12,63,0,inf
40946,50,8,58,0,inf
40947,63,12,75,0,inf
40948,58,12,70,0,inf
40949,67,5,72,0,inf
40950,54,6,60,0,inf
40951,56,8,64,0,inf
40952,53,13,66,0,inf
40953,51,7,58,0,inf
40954,63,6,69,0,inf
40955,55,8,63,0,inf
40956,51,10,61,0,inf
40957,63,5,68,0,inf
40958,51,13,64,0,inf
40959,61,11,72,0,inf
40960,61,5,66,0,inf
40961,50,5,55,0,inf
40962,61,13,74,0,inf
40963,51,5,56,0,inf
40964,56,5,61,0,inf
40965,51,5,56,0,inf
40966,56,9,65,0,inf
40967,62,10,72,0,inf
40968,59,13,72,0,inf
40969,54,8,62,0,inf
40970,59,11,70,0,inf
40971,64,7,71,0,inf
40972,55,8,63,0,inf
40973,63,6,69,0,inf
40974,54,10,64,0,inf
40975,63,8,71,1,3.213624330081629
40976,55,9,64,0,inf
40977,63,11,74,0,inf
40978,55,6,61,0,inf
40979,65,7,72,0,inf
40980,61,9,70,0,inf
40981,56,7,63,0,inf
40982,64,5,69,0,inf
40983,66,8,74,0,inf
40984,57,11,68,0,inf
40985,54,6,60,0,inf
40986,51,7,58,0,inf
40987,59,8,67,0,inf
40988,59,12,71,0,inf
40989,54,11,65,0,inf
40990,55,5,60,0,inf
40991,60,6,66,0,inf
40992,51,9,60,0,inf
40993,57,7,64,0,inf
40994,60,13,73,0,inf
40995,51,7,58,0,inf
40996,62,6,68,0,inf
40997,64,5,69,0,inf
40998,63,9,72,0,inf
40999,59,12,71,0,inf
41000,66,10,76,0,inf
41001,52,8,60,0,inf
41002,67,7,74,0,inf
41003,51,12,63,0,inf
41004,62,13,75,0,inf
41005,58,5,63,0,inf
41006,50,7,57,0,inf
41007,67,10,77,0,inf
41008,51,12,63,0,inf
41009,61,6,67,0,inf
41010,67,10,77,0,inf
41011,60,9,69,0,inf
41012,66,7,73,0,inf
41013,59,8,67,0,inf
41014,53,7,60,0,inf
41015,67,5,72,0,inf
41016,59,10,69,0,inf
41017,58,13,71,0,inf
41018,60,9,69,0,inf
41019,53,6,59,0,inf
41020,51,10,61,0,inf
41021,62,8,70,0,inf
41022,55,7,62,0,inf
41023,50,9,59,0,inf
41024,56,10,66,0,inf
41025,65,7,72,0,inf
41026,50,10,60,0,inf
41027,53,10,63,0,inf
41028,64,5,69,0,inf
41029,52,9,61,0,inf
41030,62,5,67,0,inf
41031,57,7,64,0,inf
41032,54,5,59,0,inf
41033,66,10,76,0,inf
41034,51,13,64,0,inf
41035,65,13,78,0,inf
41036,63,13,76,0,inf
41037,64,6,70,0,inf
41038,53,10,63,0,inf
41039,61,12,73,0,inf
41040,53,8,61,0,inf
41041,50,6,56,0,inf
41042,52,7,59,0,inf
41043,52,5,57,0,inf
41044,65,5,70,0,inf
41045,65,11,76,0,inf
41046,59,13,72,0,inf
41047,62,11,73,0,inf
41048,56,12,68,0,inf
41049,59,10,69,0,inf
41050,65,7,72,0,inf
41051,67,13,80,0,inf
41052,50,13,63,1,12.741989249039065
41053,63,6,69,0,inf
41054,59,11,70,0,inf
41055,67,10,77,0,inf
41056,55,13,68,0,inf
41057,57,7,64,0,inf
41058,52,10,62,0,inf
41059,58,13,71,0,inf
41060,58,11,69,0,inf
41061,60,5,65,1,2.4064902849242245
41062,52,9,61,0,inf
41063,65,7,72,0,inf
41064,55,8,63,0,inf
41065,60,6,66,0,inf
41066,52,13,65,0,inf
41067,60,13,73,0,inf
41068,51,12,63,0,inf
41069,57,8,65,0,inf
41070,67,7,74,0,inf
41071,60,8,68,0,inf
41072,53,7,60,0,inf
41073,66,8,74,0,inf
41074,66,10,76,0,inf
41075,67,12,79,0,inf
41076,53,11,64,0,inf
41077,59,9,68,0,inf
41078,61,10,71,0,inf
41079,58,9,67,0,inf
41080,55,13,68,0,inf
41081,57,13,70,0,inf
41082,56,6,62,0,inf
41083,54,13,67,1,1.7927442229541555
41084,51,11,62,0,inf
41085,59,13,72,0,inf
41086,67,11,78,0,inf
41087,58,10,68,0,inf
41088,50,9,59,0,inf
41089,58,12,70,0,inf
41090,62,9,71,0,inf
41091,59,6,65,0,inf
41092,67,8,75,0,inf
41093,57,10,67,0,inf
41094,58,8,66,0,inf
41095,63,10,73,0,inf
41096,66,5,71,0,inf
41097,58,5,63,0,inf
41098,57,5,62,0,inf
41099,51,7,58,0,inf
41100,51,12,63,0,inf
41101,55,10,65,0,inf
41102,67,7,74,0,inf
41103,62,8,70,0,inf
41104,57,5,62,0,inf
41105,67,7,74,0,inf
41106,56,8,64,0,inf
41107,51,10,61,0,inf
41108,60,12,72,0,inf
41109,60,5,65,0,inf
41110,57,12,69,0,inf
41111,57,5,62,0,inf
41112,50,9,59,0,inf
41113,67,7,74,0,inf
41114,52,5,57,0,inf
41115,56,7,63,0,inf
41116,56,10,66,0,inf
41117,58,9,67,0,inf
41118,67,5,72,1,3.629773985697753
41119,57,12,69,0,inf
41120,51,5,56,0,inf
41121,66,11,77,0,inf
41122,60,6,66,0,inf
41123,60,7,67,0,inf
41124,51,12,63,0,inf
41125,59,10,69,0,inf
41126,59,6,65,0,inf
41127,56,8,64,0,inf
41128,56,8,64,0,inf
41129,63,11,74,0,inf
41130,56,6,62,0,inf
41131,65,6,71,0,inf
41132,59,11,70,0,inf
41133,63,5,68,0,inf
41134,65,7,72,0,inf
41135,51,11,62,0,inf
41136,59,7,66,0,inf
41137,57,12,69,0,inf
41138,53,6,59,0,inf
41139,63,13,76,0,inf
41140,62,10,72,0,inf
41141,62,7,69,0,inf
41142,57,9,66,0,inf
41143,54,11,65,0,inf
41144,58,9,67,0,inf
41145,54,8,62,0,inf
41146,53,7,60,0,inf
41147,63,8,71,0,inf
41148,59,13,72,0,inf
41149,63,7,70,0,inf
41150,53,10,63,0,inf
41151,58,6,64,0,inf
41152,51,7,58,0,inf
41153,57,8,65,0,inf
41154,64,11,75,0,inf
41155,52,7,59,0,inf
41156,67,7,74,0,inf
41157,65,10,75,0,inf
41158,56,6,62,0,inf
41159,57,8,65,0,inf
41160,61,5,66,0,inf
41161,53,11,64,0,inf
41162,65,8,73,0,inf
41163,62,10,72,0,inf
41164,57,5,62,0,inf
41165,56,5,61,0,inf
41166,62,6,68,0,inf
41167,61,9,70,0,inf
41168,54,11,65,0,inf
41169,55,6,61,0,inf
41170,58,11,69,0,inf
41171,60,6,66,0,inf
41172,67,5,72,0,inf
41173,65,8,73,1,4.500094914616895
41174,65,12,77,0,inf
41175,62,12,74,0,inf
41176,61,9,70,0,inf
41177,67,8,75,0,inf
41178,57,5,62,0,inf
41179,52,11,63,0,inf
41180,57,13,70,0,inf
41181,53,6,59,0,inf
41182,62,9,71,0,inf
41183,64,12,76,0,inf
41184,65,5,70,0,inf
41185,60,8,68,0,inf
41186,56,11,67,0,inf
41187,62,10,72,0,inf
41188,54,10,64,0,inf
41189,62,13,75,0,inf
41190,60,11,71,0,inf
41191,67,7,74,0,inf
41192,57,12,69,0,inf
41193,51,11,62,0,inf
41194,62,9,71,0,inf
41195,54,9,63,0,inf
41196,54,7,61,0,inf
41197,62,7,69,0,inf
41198,60,6,66,0,inf
41199,51,5,56,0,inf
41200,59,8,67,0,inf
41201,50,5,55,0,inf
41202,59,8,67,0,inf
41203,59,9,68,0,inf
41204,59,13,72,0,inf
41205,52,8,60,0,inf
41206,65,9,74,0,inf
41207,56,9,65,0,inf
41208,59,6,65,0,inf
41209,65,5,70,0,inf
41210,67,9,76,0,inf
41211,64,12,76,0,inf
41212,59,11,70,0,inf
41213,54,13,67,0,inf
41214,67,11,78,0,inf
41215,60,9,69,0,inf
41216,63,5,68,0,inf
41217,61,6,67,0,inf
41218,54,13,67,0,inf
41219,61,6,67,0,inf
41220,56,12,68,0,inf
41221,56,13,69,0,inf
41222,54,9,63,0,inf
41223,62,5,67,0,inf
41224,60,5,65,0,inf
41225,67,9,76,0,inf
41226,54,9,63,0,inf
41227,50,13,63,0,inf
41228,53,10,63,0,inf
41229,55,10,65,0,inf
41230,52,9,61,0,inf
41231,67,11,78,0,inf
41232,56,7,63,0,inf
41233,58,6,64,0,inf
41234,54,7,61,0,inf
41235,67,13,80,0,inf
41236,55,11,66,0,inf
41237,54,10,64,0,inf
41238,56,10,66,0,inf
41239,50,8,58,0,inf
41240,62,9,71,0,inf
41241,65,11,76,0,inf
41242,50,10,60,0,inf
41243,55,11,66,0,inf
41244,52,6,58,0,inf
41245,64,7,71,0,inf
41246,59,8,67,0,inf
41247,56,10,66,0,inf
41248,54,5,59,0,inf
41249,54,10,64,0,inf
41250,51,10,61,0,inf
41251,54,10,64,0,inf
41252,65,11,76,0,inf
41253,52,10,62,0,inf
41254,62,7,69,0,inf
41255,65,8,73,0,inf
41256,63,8,71,0,inf
41257,60,12,72,0,inf
41258,51,6,57,0,inf
41259,65,7,72,0,inf
41260,53,11,64,0,inf
41261,54,9,63,0,inf
41262,61,12,73,0,inf
41263,59,7,66,0,inf
41264,62,9,71,0,inf
41265,54,13,67,0,inf
41266,57,11,68,0,inf
41267,56,7,63,0,inf
41268,64,10,74,0,inf
41269,54,11,65,0,inf
41270,66,10,76,0,inf
41271,50,13,63,0,inf
41272,63,8,71,0,inf
41273,58,8,66,0,inf
41274,58,6,64,0,inf
41275,67,11,78,0,inf
41276,60,6,66,0,inf
41277,51,7,58,0,inf
41278,52,12,64,1,10.706886253316398
41279,59,13,72,0,inf
41280,50,11,61,0,inf
41281,58,8,66,0,inf
41282,65,12,77,0,inf
41283,64,5,69,0,inf
41284,60,7,67,0,inf
41285,59,12,71,0,inf
41286,64,13,77,1,2.347698936090083
41287,56,11,67,0,inf
41288,57,12,69,0,inf
41289,50,13,63,0,inf
41290,61,7,68,0,inf
41291,64,6,70,0,inf
41292,59,12,71,0,inf
41293,52,8,60,0,inf
41294,51,11,62,0,inf
41295,55,5,60,0,inf
41296,58,13,71,0,inf
41297,59,12,71,0,inf
41298,54,10,64,0,inf
41299,60,8,68,1,2.7662029608771093
41300,60,8,68,0,inf
41301,66,10,76,0,inf
41302,51,12,63,0,inf
41303,64,5,69,0,inf
41304,67,10,77,0,inf
41305,52,9,61,0,inf
41306,51,6,57,0,inf
41307,59,12,71,0,inf
41308,51,6,57,0,inf
41309,63,8,71,0,inf
41310,63,10,73,0,inf
41311,66,13,79,1,1.4453439368867436
41312,62,8,70,0,inf
41313,64,10,74,0,inf
41314,62,13,75,0,inf
41315,55,10,65,0,inf
41316,62,6,68,0,inf
41317,65,9,74,0,inf
41318,61,12,73,0,inf
41319,61,13,74,0,inf
41320,52,13,65,0,inf
41321,54,12,66,0,inf
41322,55,13,68,0,inf
41323,62,10,72,0,inf
41324,54,12,66,0,inf
41325,65,5,70,0,inf
41326,62,6,68,0,inf
41327,58,6,64,0,inf
41328,66,13,79,0,inf
41329,51,9,60,0,inf
41330,61,13,74,0,inf
41331,52,6,58,0,inf
41332,50,8,58,0,inf
41333,53,12,65,0,inf
41334,64,11,75,0,inf
41335,59,5,64,0,inf
41336,66,11,77,0,inf
41337,66,5,71,0,inf
41338,57,6,63,0,inf
41339,58,6,64,0,inf
41340,59,8,67,0,inf
41341,58,6,64,0,inf
41342,59,5,64,0,inf
41343,52,13,65,0,inf
41344,64,11,75,0,inf
41345,56,7,63,0,inf
41346,60,9,69,0,inf
41347,61,8,69,0,inf
41348,50,13,63,0,inf
41349,67,13,80,0,inf
41350,52,8,60,1,1.1884742222774278
41351,61,11,72,0,inf
41352,59,10,69,0,inf
41353,55,7,62,0,inf
41354,50,11,61,0,inf
41355,53,13,66,1,12.265172885193692
41356,58,9,67,0,inf
41357,57,10,67,0,inf
41358,62,9,71,0,inf
41359,61,12,73,0,inf
41360,52,13,65,0,inf
41361,63,5,68,0,inf
41362,58,8,66,0,inf
41363,58,10,68,0,inf
41364,66,10,76,0,inf
41365,58,13,71,0,inf
41366,62,13,75,0,inf
41367,58,10,68,0,inf
41368,57,11,68,0,inf
41369,52,11,63,0,inf
41370,59,11,70,0,inf
41371,67,6,73,0,inf
41372,57,5,62,0,inf
41373,64,12,76,0,inf
41374,59,10,69,0,inf
41375,61,9,70,0,inf
41376,62,13,75,0,inf
41377,51,12,63,0,inf
41378,50,8,58,0,inf
41379,59,10,69,0,inf
41380,67,13,80,0,inf
41381,65,5,70,0,inf
41382,66,12,78,0,inf
41383,65,10,75,0,inf
41384,60,8,68,0,inf
41385,51,13,64,0,inf
41386,65,8,73,1,1.752800973449979
41387,60,6,66,0,inf
41388,50,7,57,0,inf
41389,67,12,79,0,inf
41390,60,10,70,0,inf
41391,57,11,68,0,inf
41392,67,13,80,0,inf
41393,67,9,76,0,inf
41394,67,8,75,0,inf
41395,60,11,71,0,inf
41396,62,11,73,0,inf
41397,67,9,76,0,inf
41398,67,6,73,0,inf
41399,59,7,66,0,inf
41400,67,6,73,0,inf
41401,66,7,73,0,inf
41402,65,7,72,0,inf
41403,55,10,65,0,inf
41404,59,6,65,0,inf
41405,64,13,77,0,inf
41406,51,11,62,0,inf
41407,63,10,73,0,inf
41408,65,12,77,0,inf
41409,65,8,73,0,inf
41410,62,13,75,0,inf
41411,50,13,63,0,inf
41412,59,11,70,0,inf
41413,53,5,58,0,inf
41414,54,10,64,0,inf
41415,58,5,63,0,inf
41416,62,6,68,0,inf
41417,57,8,65,0,inf
41418,57,8,65,0,inf
41419,52,11,63,0,inf
41420,61,13,74,0,inf
41421,63,9,72,0,inf
41422,52,6,58,0,inf
41423,60,11,71,0,inf
41424,58,13,71,0,inf
41425,54,8,62,0,inf
41426,52,7,59,0,inf
41427,58,7,65,0,inf
41428,62,12,74,0,inf
41429,67,6,73,0,inf
41430,54,11,65,0,inf
41431,64,6,70,0,inf
41432,56,6,62,0,inf
41433,56,9,65,0,inf
41434,60,6,66,0,inf
41435,61,10,71,0,inf
41436,52,5,57,0,inf
41437,59,9,68,0,inf
41438,54,6,60,0,inf
41439,61,6,67,0,inf
41440,62,10,72,0,inf
41441,53,13,66,0,inf
41442,51,10,61,0,inf
41443,58,10,68,0,inf
41444,61,12,73,0,inf
41445,61,10,71,0,inf
41446,56,9,65,0,inf
41447,62,10,72,0,inf
41448,61,10,71,0,inf
41449,54,11,65,0,inf
41450,65,11,76,0,inf
41451,65,6,71,0,inf
41452,62,11,73,0,inf
41453,55,12,67,0,inf
41454,65,8,73,0,inf
41455,53,6,59,0,inf
41456,50,13,63,0,inf
41457,57,13,70,0,inf
41458,63,12,75,0,inf
41459,60,7,67,0,inf
41460,63,11,74,0,inf
41461,53,9,62,0,inf
41462,51,7,58,1,0.3870871691964126
41463,63,7,70,0,inf
41464,65,7,72,0,inf
41465,53,9,62,0,inf
41466,54,8,62,0,inf
41467,53,8,61,0,inf
41468,64,9,73,0,inf
41469,52,9,61,0,inf
41470,50,5,55,0,inf
41471,50,12,62,0,inf
41472,60,8,68,0,inf
41473,58,5,63,0,inf
41474,52,8,60,0,inf
41475,56,10,66,0,inf
41476,52,10,62,0,inf
41477,58,7,65,0,inf
41478,50,5,55,0,inf
41479,66,13,79,0,inf
41480,51,9,60,0,inf
41481,66,8,74,0,inf
41482,58,10,68,0,inf
41483,58,8,66,0,inf
41484,63,9,72,0,inf
41485,57,9,66,0,inf
41486,64,9,73,0,inf
41487,61,9,70,0,inf
41488,59,9,68,0,inf
41489,52,11,63,0,inf
41490,51,10,61,0,inf
41491,59,7,66,0,inf
41492,54,12,66,0,inf
41493,62,10,72,0,inf
41494,62,10,72,0,inf
41495,56,8,64,0,inf
41496,53,9,62,0,inf
41497,53,5,58,0,inf
41498,50,11,61,0,inf
41499,67,6,73,0,inf
41500,54,6,60,0,inf
41501,53,13,66,0,inf
41502,64,13,77,0,inf
41503,54,10,64,0,inf
41504,53,12,65,0,inf
41505,60,8,68,0,inf
41506,65,9,74,0,inf
41507,67,10,77,0,inf
41508,65,9,74,0,inf
41509,66,11,77,0,inf
41510,51,9,60,0,inf
41511,61,13,74,0,inf
41512,63,7,70,0,inf
41513,60,9,69,0,inf
41514,57,10,67,0,inf
41515,63,6,69,0,inf
41516,66,12,78,0,inf
41517,63,5,68,0,inf
41518,52,10,62,0,inf
41519,64,5,69,0,inf
41520,50,5,55,0,inf
41521,62,10,72,0,inf
41522,59,8,67,0,inf
41523,52,5,57,0,inf
41524,56,11,67,0,inf
41525,54,11,65,0,inf
41526,52,12,64,0,inf
41527,60,11,71,0,inf
41528,55,6,61,1,2.910319686936475
41529,53,7,60,0,inf
41530,65,13,78,0,inf
41531,63,7,70,0,inf
41532,59,5,64,0,inf
41533,52,5,57,0,inf
41534,54,13,67,0,inf
41535,50,12,62,0,inf
41536,65,8,73,0,inf
41537,50,8,58,0,inf
41538,65,9,74,0,inf
41539,55,5,60,0,inf
41540,63,6,69,0,inf
41541,63,10,73,0,inf
41542,54,11,65,0,inf
41543,64,5,69,0,inf
41544,50,12,62,0,inf
41545,57,10,67,0,inf
41546,64,6,70,0,inf
41547,58,7,65,0,inf
41548,53,6,59,0,inf
41549,67,7,74,0,inf
41550,59,10,69,0,inf
41551,65,10,75,0,inf
41552,53,13,66,0,inf
41553,57,8,65,0,inf
41554,62,7,69,0,inf
41555,59,7,66,0,inf
41556,61,11,72,0,inf
41557,66,7,73,0,inf
41558,58,13,71,0,inf
41559,56,9,65,0,inf
41560,50,12,62,0,inf
41561,51,9,60,0,inf
41562,59,5,64,0,inf
41563,54,12,66,0,inf
41564,52,11,63,0,inf
41565,53,7,60,0,inf
41566,53,7,60,0,inf
41567,54,12,66,0,inf
41568,59,9,68,0,inf
41569,52,6,58,0,inf
41570,59,12,71,0,inf
41571,54,10,64,0,inf
41572,58,9,67,0,inf
41573,54,7,61,0,inf
41574,52,9,61,0,inf
41575,66,5,71,0,inf
41576,66,10,76,0,inf
41577,57,8,65,0,inf
41578,59,13,72,0,inf
41579,66,9,75,0,inf
41580,54,13,67,0,inf
41581,58,8,66,0,inf
41582,60,8,68,0,inf
41583,55,8,63,0,inf
41584,64,9,73,0,inf
41585,57,12,69,0,inf
41586,65,11,76,0,inf
41587,65,12,77,0,inf
41588,52,10,62,0,inf
41589,64,8,72,0,inf
41590,50,12,62,0,inf
41591,67,6,73,0,inf
41592,50,13,63,0,inf
41593,53,11,64,0,inf
41594,55,6,61,0,inf
41595,54,10,64,0,inf
41596,67,12,79,0,inf
41597,57,8,65,0,inf
41598,58,12,70,0,inf
41599,61,8,69,0,inf
41600,56,9,65,0,inf
41601,66,13,79,0,inf
41602,65,13,78,0,inf
41603,67,6,73,0,inf
41604,54,5,59,0,inf
41605,55,7,62,0,inf
41606,57,6,63,0,inf
41607,66,11,77,0,inf
41608,62,13,75,0,inf
41609,64,7,71,0,inf
41610,61,12,73,0,inf
41611,52,12,64,0,inf
41612,56,5,61,0,inf
41613,53,13,66,0,inf
41614,58,7,65,0,inf
41615,60,12,72,0,inf
41616,63,10,73,0,inf
41617,57,12,69,0,inf
41618,64,11,75,0,inf
41619,56,12,68,0,inf
41620,66,11,77,0,inf
41621,51,11,62,0,inf
41622,61,12,73,0,inf
41623,52,7,59,0,inf
41624,51,7,58,0,inf
41625,65,11,76,0,inf
41626,61,8,69,0,inf
41627,50,10,60,0,inf
41628,52,8,60,0,inf
41629,56,5,61,0,inf
41630,60,12,72,1,9.980674759853073
41631,65,5,70,0,inf
41632,50,5,55,0,inf
41633,61,12,73,0,inf
41634,67,5,72,0,inf
41635,52,12,64,0,inf
41636,59,7,66,0,inf
41637,57,8,65,0,inf
41638,50,11,61,0,inf
41639,55,10,65,0,inf
41640,65,12,77,0,inf
41641,67,12,79,0,inf
41642,62,13,75,0,inf
41643,56,13,69,0,inf
41644,54,13,67,0,inf
41645,61,5,66,0,inf
41646,58,7,65,0,inf
41647,64,9,73,0,inf
41648,54,9,63,0,inf
41649,64,6,70,0,inf
41650,58,8,66,0,inf
41651,54,5,59,0,inf
41652,65,9,74,0,inf
41653,65,10,75,0,inf
41654,67,10,77,0,inf
41655,64,13,77,0,inf
41656,63,10,73,0,inf
41657,55,5,60,0,inf
41658,67,5,72,0,inf
41659,61,11,72,0,inf
41660,60,11,71,0,inf
41661,52,11,63,0,inf
41662,61,10,71,0,inf
41663,56,7,63,0,inf
41664,52,13,65,0,inf
41665,66,9,75,0,inf
41666,56,5,61,0,inf
41667,66,11,77,0,inf
41668,51,12,63,0,inf
41669,52,13,65,0,inf
41670,51,9,60,0,inf
41671,66,12,78,0,inf
41672,59,8,67,0,inf
41673,52,5,57,0,inf
41674,60,13,73,0,inf
41675,59,12,71,0,inf
41676,51,8,59,0,inf
41677,54,9,63,0,inf
41678,62,8,70,0,inf
41679,67,13,80,0,inf
41680,63,8,71,0,inf
41681,55,13,68,0,inf
41682,54,7,61,0,inf
41683,56,10,66,0,inf
41684,67,13,80,0,inf
41685,55,9,64,0,inf
41686,54,13,67,0,inf
41687,51,6,57,0,inf
41688,66,13,79,0,inf
41689,50,11,61,0,inf
41690,65,6,71,0,inf
41691,58,11,69,0,inf
41692,51,5,56,0,inf
41693,61,11,72,0,inf
41694,64,9,73,0,inf
41695,60,10,70,0,inf
41696,56,13,69,0,inf
41697,58,10,68,0,inf
41698,66,5,71,0,inf
41699,55,8,63,0,inf
41700,54,11,65,0,inf
41701,65,7,72,0,inf
41702,65,13,78,0,inf
41703,55,13,68,0,inf
41704,65,6,71,0,inf
41705,61,10,71,0,inf
41706,58,8,66,0,inf
41707,58,7,65,0,inf
41708,61,10,71,0,inf
41709,60,12,72,0,inf
41710,66,9,75,0,inf
41711,54,9,63,0,inf
41712,61,6,67,0,inf
41713,67,8,75,0,inf
41714,62,13,75,0,inf
41715,63,7,70,0,inf
41716,66,7,73,0,inf
41717,64,12,76,0,inf
41718,62,6,68,0,inf
41719,56,7,63,0,inf
41720,59,9,68,0,inf
41721,62,11,73,0,inf
41722,67,10,77,0,inf
41723,65,6,71,0,inf
41724,62,9,71,0,inf
41725,53,7,60,0,inf
41726,63,11,74,0,inf
41727,64,6,70,0,inf
41728,57,10,67,0,inf
41729,60,13,73,0,inf
41730,64,8,72,0,inf
41731,51,10,61,0,inf
41732,55,6,61,0,inf
41733,58,6,64,0,inf
41734,62,13,75,0,inf
41735,56,8,64,0,inf
41736,60,6,66,0,inf
41737,50,7,57,0,inf
41738,66,12,78,0,inf
41739,51,5,56,0,inf
41740,54,6,60,1,1.569721114731287
41741,58,5,63,0,inf
41742,53,9,62,0,inf
41743,50,13,63,0,inf
41744,67,11,78,0,inf
41745,65,6,71,0,inf
41746,59,13,72,0,inf
41747,67,11,78,0,inf
41748,64,10,74,0,inf
41749,55,12,67,0,inf
41750,56,9,65,0,inf
41751,55,6,61,0,inf
41752,61,11,72,0,inf
41753,64,7,71,0,inf
41754,64,11,75,0,inf
41755,59,5,64,0,inf
41756,51,5,56,0,inf
41757,63,13,76,0,inf
41758,59,13,72,0,inf
41759,50,10,60,0,inf
41760,59,6,65,0,inf
41761,57,12,69,1,0.6716307291280259
41762,58,9,67,0,inf
41763,61,10,71,0,inf
41764,63,13,76,0,inf
41765,66,8,74,0,inf
41766,66,10,76,0,inf
41767,59,6,65,0,inf
41768,52,8,60,1,5.294038954373853
41769,66,7,73,0,inf
41770,59,8,67,1,7.795713023787911
41771,60,8,68,0,inf
41772,63,7,70,0,inf
41773,67,11,78,0,inf
41774,67,5,72,0,inf
41775,50,6,56,0,inf
41776,61,13,74,0,inf
41777,61,12,73,0,inf
41778,50,5,55,0,inf
41779,50,9,59,0,inf
41780,66,11,77,0,inf
41781,52,11,63,0,inf
41782,67,5,72,0,inf
41783,64,10,74,0,inf
41784,54,10,64,0,inf
41785,55,9,64,0,inf
41786,60,8,68,0,inf
41787,53,6,59,0,inf
41788,63,5,68,0,inf
41789,61,6,67,0,inf
41790,57,7,64,0,inf
41791,55,6,61,0,inf
41792,61,13,74,0,inf
41793,54,13,67,0,inf
41794,65,11,76,0,inf
41795,65,5,70,0,inf
41796,63,7,70,0,inf
41797,57,11,68,0,inf
41798,57,11,68,0,inf
41799,55,9,64,0,inf
41800,53,11,64,0,inf
41801,57,13,70,0,inf
41802,50,7,57,0,inf
41803,56,12,68,0,inf
41804,65,9,74,0,inf
41805,52,10,62,0,inf
41806,65,11,76,0,inf
41807,67,13,80,0,inf
41808,63,9,72,0,inf
41809,63,8,71,0,inf
41810,59,12,71,0,inf
41811,53,5,58,0,inf
41812,62,5,67,0,inf
41813,64,11,75,0,inf
41814,54,10,64,0,inf
41815,54,12,66,0,inf
41816,54,9,63,0,inf
41817,56,11,67,1,10.349653243684855
41818,57,7,64,0,inf
41819,50,6,56,0,inf
41820,67,13,80,0,inf
41821,67,9,76,0,inf
41822,63,13,76,1,11.508459298299826
41823,62,5,67,0,inf
41824,61,9,70,0,inf
41825,60,11,71,0,inf
41826,54,10,64,0,inf
41827,60,12,72,0,inf
41828,55,12,67,0,inf
41829,58,8,66,0,inf
41830,56,10,66,0,inf
41831,61,6,67,0,inf
41832,60,7,67,0,inf
41833,65,10,75,0,inf
41834,51,6,57,0,inf
41835,55,8,63,0,inf
41836,63,12,75,0,inf
41837,58,9,67,0,inf
41838,50,5,55,0,inf
41839,61,5,66,0,inf
41840,63,9,72,0,inf
41841,57,5,62,0,inf
41842,55,11,66,0,inf
41843,53,6,59,0,inf
41844,54,6,60,0,inf
41845,62,7,69,1,5.523484402701129
41846,59,6,65,0,inf
41847,63,12,75,0,inf
41848,63,12,75,0,inf
41849,61,6,67,0,inf
41850,63,13,76,0,inf
41851,57,6,63,0,inf
41852,51,12,63,0,inf
41853,60,13,73,0,inf
41854,67,6,73,0,inf
41855,64,5,69,0,inf
41856,56,10,66,0,inf
41857,63,13,76,0,inf
41858,65,6,71,0,inf
41859,53,11,64,0,inf
41860,67,10,77,0,inf
41861,61,11,72,0,inf
41862,58,5,63,0,inf
41863,66,7,73,0,inf
41864,52,10,62,0,inf
41865,53,8,61,0,inf
41866,50,6,56,0,inf
41867,58,13,71,0,inf
41868,64,5,69,0,inf
41869,52,7,59,0,inf
41870,66,12,78,0,inf
41871,64,8,72,1,0.7127899203796773
41872,61,12,73,0,inf
41873,56,10,66,0,inf
41874,64,8,72,0,inf
41875,53,5,58,0,inf
41876,54,5,59,0,inf
41877,65,10,75,0,inf
41878,51,11,62,0,inf
41879,66,11,77,0,inf
41880,53,13,66,0,inf
41881,60,5,65,0,inf
41882,62,10,72,0,inf
41883,56,5,61,0,inf
41884,64,10,74,0,inf
41885,55,11,66,0,inf
41886,52,8,60,0,inf
41887,53,7,60,0,inf
41888,62,8,70,0,inf
41889,62,6,68,0,inf
41890,66,6,72,0,inf
41891,58,13,71,0,inf
41892,67,11,78,0,inf
41893,67,8,75,0,inf
41894,64,11,75,0,inf
41895,50,5,55,0,inf
41896,58,10,68,0,inf
41897,65,10,75,0,inf
41898,59,5,64,0,inf
41899,52,8,60,0,inf
41900,53,8,61,0,inf
41901,63,13,76,0,inf
41902,67,6,73,0,inf
41903,62,5,67,0,inf
41904,59,8,67,0,inf
41905,60,8,68,0,inf
41906,54,7,61,0,inf
41907,51,11,62,0,inf
41908,51,8,59,0,inf
41909,62,10,72,0,inf
41910,63,13,76,0,inf
41911,55,8,63,0,inf
41912,59,8,67,0,inf
41913,58,11,69,0,inf
41914,66,7,73,0,inf
41915,62,6,68,0,inf
41916,60,5,65,0,inf
41917,55,8,63,0,inf
41918,60,8,68,0,inf
41919,63,6,69,0,inf
41920,51,12,63,0,inf
41921,50,9,59,0,inf
41922,61,9,70,0,inf
41923,61,7,68,0,inf
41924,55,6,61,0,inf
41925,52,10,62,0,inf
41926,58,5,63,0,inf
41927,50,6,56,0,inf
41928,66,8,74,0,inf
41929,56,9,65,0,inf
41930,57,12,69,0,inf
41931,50,5,55,0,inf
41932,54,11,65,0,inf
41933,52,9,61,0,inf
41934,60,10,70,0,inf
41935,67,7,74,1,6.658961572273839
41936,52,12,64,0,inf
41937,62,8,70,0,inf
41938,64,5,69,0,inf
41939,55,9,64,0,inf
41940,59,6,65,0,inf
41941,67,5,72,0,inf
41942,65,12,77,0,inf
41943,60,5,65,1,4.290204614312984
41944,66,10,76,0,inf
41945,67,6,73,0,inf
41946,56,13,69,0,inf
41947,50,5,55,0,inf
41948,50,6,56,0,inf
41949,61,13,74,0,inf
41950,63,6,69,0,inf
41951,52,7,59,0,inf
41952,55,6,61,0,inf
41953,54,7,61,0,inf
41954,63,9,72,0,inf
41955,58,8,66,0,inf
41956,52,10,62,1,8.32492040630514
41957,58,10,68,0,inf
41958,62,5,67,0,inf
41959,50,7,57,0,inf
41960,51,7,58,0,inf
41961,57,7,64,0,inf
41962,58,7,65,0,inf
41963,57,5,62,0,inf
41964,59,5,64,0,inf
41965,66,6,72,0,inf
41966,51,9,60,0,inf
41967,64,11,75,0,inf
41968,50,13,63,0,inf
41969,59,13,72,0,inf
41970,65,11,76,0,inf
41971,61,11,72,0,inf
41972,54,8,62,0,inf
41973,52,7,59,0,inf
41974,63,10,73,0,inf
41975,50,7,57,0,inf
41976,59,12,71,0,inf
41977,58,12,70,0,inf
41978,62,10,72,0,inf
41979,61,13,74,1,12.925625291565254
41980,51,12,63,0,inf
41981,53,10,63,0,inf
41982,64,12,76,0,inf
41983,53,13,66,0,inf
41984,67,5,72,0,inf
41985,60,10,70,0,inf
41986,60,9,69,0,inf
41987,62,11,73,0,inf
41988,51,5,56,0,inf
41989,64,11,75,0,inf
41990,57,11,68,0,inf
41991,50,9,59,0,inf
41992,59,13,72,0,inf
41993,62,11,73,0,inf
41994,66,9,75,0,inf
41995,58,7,65,0,inf
41996,63,7,70,0,inf
41997,50,10,60,0,inf
41998,56,13,69,0,inf
41999,67,11,78,0,inf
42000,64,8,72,0,inf
42001,66,9,75,0,inf
42002,63,7,70,0,inf
42003,57,13,70,0,inf
42004,54,12,66,0,inf
42005,56,7,63,0,inf
42006,57,9,66,0,inf
42007,52,11,63,0,inf
42008,57,9,66,0,inf
42009,50,12,62,0,inf
42010,54,11,65,0,inf
42011,61,10,71,0,inf
42012,57,8,65,0,inf
42013,63,6,69,0,inf
42014,59,6,65,0,inf
42015,67,6,73,0,inf
42016,64,7,71,0,inf
42017,55,12,67,0,inf
42018,51,6,57,0,inf
42019,54,9,63,0,inf
42020,64,10,74,0,inf
42021,59,5,64,0,inf
42022,59,13,72,0,inf
42023,64,10,74,0,inf
42024,57,13,70,0,inf
42025,52,8,60,0,inf
42026,56,13,69,0,inf
42027,64,9,73,0,inf
42028,59,8,67,0,inf
42029,65,13,78,0,inf
42030,58,11,69,0,inf
42031,61,10,71,0,inf
42032,50,6,56,0,inf
42033,63,9,72,1,8.238261636331714
42034,54,12,66,0,inf
42035,50,8,58,0,inf
42036,58,6,64,0,inf
42037,61,8,69,0,inf
42038,56,7,63,0,inf
42039,59,9,68,0,inf
42040,58,8,66,0,inf
42041,50,6,56,0,inf
42042,54,7,61,0,inf
42043,57,8,65,0,inf
42044,53,10,63,0,inf
42045,63,8,71,0,inf
42046,61,9,70,0,inf
42047,51,12,63,0,inf
42048,63,13,76,0,inf
42049,56,5,61,0,inf
42050,59,5,64,0,inf
42051,54,7,61,0,inf
42052,60,9,69,0,inf
42053,66,13,79,0,inf
42054,52,11,63,0,inf
42055,54,5,59,0,inf
42056,59,6,65,0,inf
42057,51,9,60,0,inf
42058,53,6,59,0,inf
42059,61,9,70,0,inf
42060,58,12,70,0,inf
42061,57,10,67,0,inf
42062,51,13,64,0,inf
42063,60,13,73,0,inf
42064,52,9,61,0,inf
42065,50,5,55,0,inf
42066,52,12,64,0,inf
42067,60,8,68,0,inf
42068,61,11,72,0,inf
42069,55,7,62,0,inf
42070,59,8,67,0,inf
42071,52,13,65,0,inf
42072,55,8,63,0,inf
42073,60,13,73,0,inf
42074,60,5,65,0,inf
42075,66,12,78,0,inf
42076,51,13,64,0,inf
42077,63,13,76,0,inf
42078,56,6,62,0,inf
42079,63,11,74,0,inf
42080,55,6,61,0,inf
42081,56,8,64,0,inf
42082,66,6,72,0,inf
42083,52,10,62,0,inf
42084,67,6,73,0,inf
42085,67,9,76,0,inf
42086,52,12,64,0,inf
42087,55,9,64,0,inf
42088,60,12,72,0,inf
42089,62,5,67,0,inf
42090,60,10,70,0,inf
42091,55,10,65,0,inf
42092,54,13,67,0,inf
42093,50,5,55,0,inf
42094,66,13,79,0,inf
42095,64,7,71,0,inf
42096,63,12,75,0,inf
42097,51,6,57,1,1.3707210721438017
42098,51,11,62,0,inf
42099,56,5,61,0,inf
42100,52,11,63,0,inf
42101,55,13,68,0,inf
42102,62,11,73,0,inf
42103,57,8,65,0,inf
42104,54,5,59,0,inf
42105,64,8,72,0,inf
42106,59,13,72,0,inf
42107,52,5,57,0,inf
42108,61,10,71,0,inf
42109,63,7,70,0,inf
42110,64,10,74,0,inf
42111,54,8,62,0,inf
42112,56,6,62,0,inf
42113,54,9,63,0,inf
42114,60,11,71,0,inf
42115,56,8,64,0,inf
42116,53,10,63,0,inf
42117,65,9,74,0,inf
42118,65,5,70,0,inf
42119,52,9,61,0,inf
42120,64,11,75,0,inf
42121,58,8,66,0,inf
42122,57,5,62,0,inf
42123,66,11,77,0,inf
42124,55,9,64,0,inf
42125,56,12,68,0,inf
42126,62,9,71,0,inf
42127,56,9,65,0,inf
42128,59,10,69,0,inf
42129,50,11,61,0,inf
42130,65,11,76,1,5.691728190616999
42131,66,10,76,0,inf
42132,66,6,72,0,inf
42133,64,5,69,0,inf
42134,65,5,70,0,inf
42135,64,6,70,0,inf
42136,62,7,69,0,inf
42137,60,7,67,0,inf
42138,66,7,73,0,inf
42139,64,11,75,0,inf
42140,65,5,70,0,inf
42141,62,8,70,0,inf
42142,56,13,69,0,inf
42143,64,10,74,0,inf
42144,61,10,71,0,inf
42145,60,10,70,0,inf
42146,64,9,73,0,inf
42147,55,6,61,0,inf
42148,67,13,80,1,8.523435504817883
42149,67,7,74,0,inf
42150,55,8,63,0,inf
42151,54,12,66,0,inf
42152,50,10,60,0,inf
42153,65,9,74,0,inf
42154,56,8,64,0,inf
42155,66,8,74,0,inf
42156,60,10,70,0,inf
42157,62,6,68,0,inf
42158,63,11,74,0,inf
42159,60,7,67,0,inf
42160,65,12,77,0,inf
42161,54,7,61,0,inf
42162,52,9,61,0,inf
42163,54,11,65,0,inf
42164,67,10,77,0,inf
42165,62,7,69,0,inf
42166,55,10,65,0,inf
42167,60,7,67,0,inf
42168,54,10,64,0,inf
42169,57,5,62,0,inf
42170,55,8,63,0,inf
42171,57,5,62,0,inf
42172,65,10,75,0,inf
42173,59,7,66,0,inf
42174,65,13,78,0,inf
42175,53,13,66,0,inf
42176,55,5,60,0,inf
42177,51,6,57,0,inf
42178,57,7,64,0,inf
42179,55,11,66,0,inf
42180,64,11,75,0,inf
42181,59,5,64,0,inf
42182,61,8,69,0,inf
42183,50,10,60,0,inf
42184,62,10,72,0,inf
42185,53,13,66,0,inf
42186,62,13,75,0,inf
42187,51,11,62,0,inf
42188,67,9,76,0,inf
42189,60,7,67,0,inf
42190,56,7,63,0,inf
42191,64,8,72,0,inf
42192,60,12,72,0,inf
42193,54,12,66,0,inf
42194,54,13,67,0,inf
42195,65,9,74,1,4.214515246455548
42196,59,13,72,0,inf
42197,58,13,71,0,inf
42198,62,10,72,0,inf
42199,52,8,60,0,inf
42200,51,5,56,0,inf
42201,56,12,68,0,inf
42202,61,10,71,0,inf
42203,58,11,69,0,inf
42204,58,13,71,0,inf
42205,65,8,73,0,inf
42206,50,8,58,0,inf
42207,59,11,70,0,inf
42208,67,12,79,0,inf
42209,58,7,65,0,inf
42210,53,10,63,0,inf
42211,55,7,62,0,inf
42212,57,13,70,0,inf
42213,67,10,77,0,inf
42214,54,8,62,0,inf
42215,58,5,63,0,inf
42216,53,13,66,0,inf
42217,57,5,62,0,inf
42218,63,6,69,0,inf
42219,57,12,69,0,inf
42220,53,7,60,0,inf
42221,51,6,57,0,inf
42222,67,9,76,0,inf
42223,54,12,66,0,inf
42224,62,13,75,0,inf
42225,57,12,69,0,inf
42226,65,6,71,0,inf
42227,50,13,63,0,inf
42228,60,12,72,0,inf
42229,59,8,67,0,inf
42230,57,11,68,0,inf
42231,62,8,70,0,inf
42232,60,6,66,0,inf
42233,56,9,65,0,inf
42234,63,7,70,0,inf
42235,50,12,62,1,5.9802316867268885
42236,59,5,64,0,inf
42237,60,6,66,0,inf
42238,57,13,70,0,inf
42239,59,8,67,0,inf
42240,64,9,73,0,inf
42241,65,5,70,0,inf
42242,54,5,59,0,inf
42243,63,12,75,0,inf
42244,53,8,61,0,inf
42245,61,8,69,0,inf
42246,57,9,66,0,inf
42247,62,6,68,0,inf
42248,50,9,59,0,inf
42249,61,13,74,0,inf
42250,66,11,77,1,9.058093280772042
42251,59,5,64,0,inf
42252,51,13,64,0,inf
42253,56,12,68,0,inf
42254,54,10,64,0,inf
42255,59,9,68,0,inf
42256,65,11,76,0,inf
42257,64,10,74,0,inf
42258,57,8,65,0,inf
42259,55,11,66,0,inf
42260,57,7,64,0,inf
42261,50,13,63,0,inf
42262,53,5,58,0,inf
42263,52,7,59,0,inf
42264,64,9,73,0,inf
42265,54,8,62,0,inf
42266,64,13,77,0,inf
42267,67,9,76,0,inf
42268,50,7,57,0,inf
42269,65,5,70,0,inf
42270,51,8,59,0,inf
42271,56,5,61,0,inf
42272,65,8,73,0,inf
42273,65,5,70,0,inf
42274,50,9,59,0,inf
42275,58,6,64,0,inf
42276,55,13,68,0,inf
42277,52,5,57,0,inf
42278,66,9,75,0,inf
42279,56,6,62,0,inf
42280,51,7,58,0,inf
42281,63,6,69,0,inf
42282,65,11,76,0,inf
42283,53,6,59,0,inf
42284,59,5,64,0,inf
42285,58,13,71,0,inf
42286,57,9,66,0,inf
42287,62,11,73,0,inf
42288,61,9,70,0,inf
42289,56,12,68,0,inf
42290,65,13,78,0,inf
42291,54,6,60,0,inf
42292,65,5,70,0,inf
42293,52,9,61,0,inf
42294,65,5,70,0,inf
42295,63,13,76,0,inf
42296,50,9,59,0,inf
42297,53,7,60,0,inf
42298,59,5,64,0,inf
42299,59,5,64,0,inf
42300,67,11,78,0,inf
42301,54,8,62,0,inf
42302,55,9,64,0,inf
42303,56,6,62,0,inf
42304,54,5,59,0,inf
42305,52,12,64,0,inf
42306,60,5,65,0,inf
42307,65,10,75,0,inf
42308,53,9,62,0,inf
42309,66,7,73,0,inf
42310,59,6,65,0,inf
42311,51,9,60,1,3.4858449332769723
42312,55,10,65,0,inf
42313,65,9,74,0,inf
42314,50,10,60,0,inf
42315,63,6,69,0,inf
42316,61,11,72,0,inf
42317,63,11,74,0,inf
42318,50,6,56,0,inf
42319,58,13,71,0,inf
42320,60,6,66,0,inf
42321,64,7,71,0,inf
42322,60,5,65,0,inf
42323,51,10,61,0,inf
42324,62,5,67,0,inf
42325,59,12,71,0,inf
42326,63,7,70,0,inf
42327,50,9,59,0,inf
42328,63,9,72,0,inf
42329,61,9,70,0,inf
42330,56,13,69,0,inf
42331,67,6,73,0,inf
42332,59,8,67,0,inf
42333,65,12,77,0,inf
42334,61,13,74,0,inf
42335,53,6,59,0,inf
42336,67,6,73,0,inf
42337,61,9,70,0,inf
42338,51,9,60,0,inf
42339,62,10,72,0,inf
42340,51,12,63,0,inf
42341,64,11,75,0,inf
42342,54,5,59,0,inf
42343,60,9,69,0,inf
42344,50,7,57,0,inf
42345,50,5,55,0,inf
42346,59,8,67,0,inf
42347,59,10,69,0,inf
42348,54,7,61,0,inf
42349,53,5,58,0,inf
42350,54,9,63,0,inf
42351,67,9,76,0,inf
42352,51,10,61,0,inf
42353,54,6,60,0,inf
42354,51,12,63,0,inf
42355,62,10,72,1,2.165497569560628
42356,64,12,76,0,inf
42357,59,5,64,0,inf
42358,51,5,56,0,inf
42359,58,12,70,1,11.799954218922366
42360,55,10,65,0,inf
42361,64,11,75,0,inf
42362,58,12,70,0,inf
42363,57,11,68,0,inf
42364,66,12,78,0,inf
42365,60,9,69,0,inf
42366,55,11,66,0,inf
42367,51,6,57,0,inf
42368,62,10,72,0,inf
42369,62,12,74,0,inf
42370,52,9,61,0,inf
42371,67,13,80,0,inf
42372,50,5,55,0,inf
42373,50,9,59,0,inf
42374,67,6,73,0,inf
42375,58,5,63,0,inf
42376,58,7,65,0,inf
42377,60,6,66,0,inf
42378,56,13,69,0,inf
42379,57,6,63,0,inf
42380,64,12,76,0,inf
42381,50,10,60,0,inf
42382,65,6,71,0,inf
42383,55,13,68,0,inf
42384,64,13,77,0,inf
42385,53,7,60,0,inf
42386,54,12,66,0,inf
42387,58,7,65,0,inf
42388,51,10,61,0,inf
42389,67,12,79,0,inf
42390,51,8,59,0,inf
42391,62,12,74,0,inf
42392,61,6,67,0,inf
42393,64,12,76,0,inf
42394,63,9,72,0,inf
42395,61,8,69,0,inf
42396,52,12,64,0,inf
42397,51,13,64,0,inf
42398,61,5,66,0,inf
42399,65,13,78,0,inf
42400,66,6,72,0,inf
42401,59,13,72,0,inf
42402,50,10,60,0,inf
42403,63,7,70,0,inf
42404,59,11,70,0,inf
42405,59,11,70,0,inf
42406,59,8,67,0,inf
42407,66,6,72,0,inf
42408,60,12,72,0,inf
42409,63,7,70,0,inf
42410,54,8,62,0,inf
42411,56,5,61,0,inf
42412,52,9,61,1,4.366591816164217
42413,54,13,67,0,inf
42414,63,9,72,0,inf
42415,54,11,65,0,inf
42416,63,8,71,0,inf
42417,60,9,69,0,inf
42418,63,10,73,1,1.3618100929371337
42419,67,9,76,0,inf
42420,52,13,65,0,inf
42421,67,6,73,0,inf
42422,64,5,69,0,inf
42423,61,6,67,0,inf
42424,58,10,68,0,inf
42425,59,9,68,0,inf
42426,62,11,73,0,inf
42427,53,7,60,0,inf
42428,67,5,72,0,inf
42429,60,9,69,0,inf
42430,53,9,62,0,inf
42431,55,8,63,0,inf
42432,55,5,60,0,inf
42433,60,8,68,0,inf
42434,51,9,60,0,inf
42435,64,11,75,0,inf
42436,51,8,59,0,inf
42437,65,6,71,0,inf
42438,55,10,65,0,inf
42439,52,13,65,0,inf
42440,67,7,74,0,inf
42441,62,6,68,0,inf
42442,53,13,66,0,inf
42443,60,6,66,0,inf
42444,57,6,63,0,inf
42445,61,9,70,0,inf
42446,57,12,69,0,inf
42447,53,10,63,0,inf
42448,57,13,70,0,inf
42449,56,13,69,0,inf
42450,54,7,61,0,inf
42451,66,11,77,0,inf
42452,56,11,67,0,inf
42453,55,11,66,0,inf
42454,66,7,73,0,inf
42455,58,13,71,0,inf
42456,56,11,67,0,inf
42457,59,9,68,0,inf
42458,56,11,67,0,inf
42459,67,11,78,0,inf
42460,53,7,60,0,inf
42461,57,10,67,0,inf
42462,54,11,65,0,inf
42463,51,11,62,0,inf
42464,65,13,78,0,inf
42465,51,5,56,0,inf
42466,54,8,62,0,inf
42467,57,6,63,0,inf
42468,62,12,74,0,inf
42469,65,12,77,0,inf
42470,61,10,71,0,inf
42471,52,12,64,0,inf
42472,64,5,69,0,inf
42473,52,13,65,0,inf
42474,63,6,69,0,inf
42475,67,7,74,0,inf
42476,53,11,64,0,inf
42477,58,8,66,0,inf
42478,61,11,72,0,inf
42479,61,8,69,0,inf
42480,51,6,57,0,inf
42481,67,5,72,0,inf
42482,55,13,68,0,inf
42483,63,12,75,0,inf
42484,63,8,71,0,inf
42485,60,7,67,0,inf
42486,55,8,63,0,inf
42487,53,10,63,0,inf
42488,65,9,74,0,inf
42489,59,12,71,0,inf
42490,50,12,62,0,inf
42491,56,6,62,0,inf
42492,57,13,70,0,inf
42493,59,9,68,0,inf
42494,56,6,62,0,inf
42495,65,5,70,0,inf
42496,51,5,56,0,inf
42497,55,12,67,0,inf
42498,62,9,71,0,inf
42499,55,10,65,0,inf
42500,56,6,62,0,inf
42501,61,5,66,0,inf
42502,59,11,70,0,inf
42503,67,6,73,0,inf
42504,64,5,69,0,inf
42505,50,12,62,0,inf
42506,50,12,62,0,inf
42507,67,6,73,0,inf
42508,50,6,56,0,inf
42509,62,9,71,0,inf
42510,52,8,60,0,inf
42511,57,8,65,0,inf
42512,61,13,74,0,inf
42513,61,11,72,0,inf
42514,52,12,64,0,inf
42515,62,7,69,0,inf
42516,51,6,57,0,inf
42517,60,11,71,0,inf
42518,50,6,56,0,inf
42519,60,10,70,0,inf
42520,62,5,67,0,inf
42521,62,7,69,0,inf
42522,60,8,68,0,inf
42523,66,10,76,0,inf
42524,50,5,55,0,inf
42525,54,8,62,0,inf
42526,65,7,72,0,inf
42527,54,13,67,0,inf
42528,60,9,69,0,inf
42529,58,10,68,0,inf
42530,66,9,75,0,inf
42531,56,13,69,0,inf
42532,60,5,65,0,inf
42533,66,5,71,0,inf
42534,50,13,63,0,inf
42535,58,5,63,0,inf
42536,59,5,64,0,inf
42537,52,13,65,0,inf
42538,54,11,65,0,inf
42539,50,12,62,0,inf
42540,62,7,69,0,inf
42541,54,13,67,0,inf
42542,61,13,74,0,inf
42543,54,11,65,0,inf
42544,64,7,71,0,inf
42545,55,12,67,0,inf
42546,58,12,70,0,inf
42547,52,10,62,0,inf
42548,66,7,73,0,inf
42549,58,8,66,1,5.12129254692983
42550,54,5,59,0,inf
42551,65,9,74,0,inf
42552,64,8,72,0,inf
42553,54,5,59,0,inf
42554,61,7,68,0,inf
42555,53,8,61,0,inf
42556,59,9,68,0,inf
42557,64,7,71,0,inf
42558,55,9,64,0,inf
42559,53,13,66,0,inf
42560,54,10,64,0,inf
42561,56,10,66,0,inf
42562,53,5,58,0,inf
42563,64,13,77,0,inf
42564,60,12,72,0,inf
42565,60,7,67,0,inf
42566,52,6,58,0,inf
42567,62,8,70,0,inf
42568,65,7,72,0,inf
42569,58,5,63,0,inf
42570,61,10,71,0,inf
42571,66,10,76,0,inf
42572,64,7,71,0,inf
42573,64,12,76,0,inf
42574,53,8,61,0,inf
42575,56,10,66,0,inf
42576,65,10,75,0,inf
42577,50,8,58,0,inf
42578,61,12,73,0,inf
42579,58,12,70,0,inf
42580,57,8,65,1,3.3140611472834394
42581,54,7,61,0,inf
42582,51,6,57,0,inf
42583,63,6,69,0,inf
42584,53,9,62,0,inf
42585,58,11,69,0,inf
42586,59,13,72,0,inf
42587,60,7,67,1,6.30079267715405
42588,52,13,65,0,inf
42589,67,11,78,0,inf
42590,60,8,68,0,inf
42591,67,10,77,0,inf
42592,60,5,65,0,inf
42593,60,6,66,0,inf
42594,59,8,67,0,inf
42595,54,9,63,0,inf
42596,57,7,64,0,inf
42597,51,5,56,0,inf
42598,60,5,65,0,inf
42599,67,5,72,0,inf
42600,53,8,61,0,inf
42601,63,11,74,0,inf
42602,50,13,63,0,inf
42603,56,11,67,0,inf
42604,50,11,61,0,inf
42605,64,11,75,0,inf
42606,59,10,69,0,inf
42607,52,12,64,0,inf
42608,62,9,71,0,inf
42609,50,12,62,0,inf
42610,51,11,62,0,inf
42611,55,8,63,0,inf
42612,67,10,77,0,inf
42613,60,5,65,0,inf
42614,55,7,62,0,inf
42615,59,13,72,0,inf
42616,54,9,63,0,inf
42617,61,7,68,0,inf
42618,67,11,78,0,inf
42619,60,9,69,0,inf
42620,65,6,71,0,inf
42621,63,8,71,0,inf
42622,65,6,71,0,inf
42623,62,5,67,0,inf
42624,51,12,63,0,inf
42625,60,11,71,0,inf
42626,55,10,65,0,inf
42627,50,11,61,0,inf
42628,57,9,66,0,inf
42629,51,7,58,0,inf
42630,52,12,64,0,inf
42631,53,7,60,0,inf
42632,64,10,74,1,2.387474711325268
42633,52,6,58,0,inf
42634,57,12,69,0,inf
42635,61,11,72,0,inf
42636,59,11,70,0,inf
42637,66,13,79,0,inf
42638,52,11,63,0,inf
42639,51,8,59,0,inf
42640,63,7,70,0,inf
42641,64,8,72,0,inf
42642,60,10,70,0,inf
42643,67,5,72,0,inf
42644,58,8,66,0,inf
42645,52,11,63,0,inf
42646,50,12,62,0,inf
42647,61,5,66,0,inf
42648,51,6,57,0,inf
42649,54,13,67,0,inf
42650,51,12,63,0,inf
42651,54,7,61,0,inf
42652,67,12,79,0,inf
42653,56,7,63,0,inf
42654,60,12,72,0,inf
42655,50,6,56,0,inf
42656,65,7,72,1,5.569273594868804
42657,51,5,56,0,inf
42658,57,7,64,0,inf
42659,61,9,70,0,inf
42660,52,12,64,0,inf
42661,53,10,63,0,inf
42662,67,12,79,0,inf
42663,61,6,67,0,inf
42664,57,7,64,0,inf
42665,63,9,72,0,inf
42666,59,6,65,0,inf
42667,59,10,69,0,inf
42668,59,5,64,0,inf
42669,50,10,60,1,1.656061883798131
42670,62,6,68,0,inf
42671,55,12,67,0,inf
42672,66,7,73,0,inf
42673,60,12,72,0,inf
42674,55,6,61,0,inf
42675,50,8,58,0,inf
42676,63,13,76,0,inf
42677,65,5,70,0,inf
42678,62,5,67,0,inf
42679,50,5,55,0,inf
42680,55,6,61,0,inf
42681,67,13,80,0,inf
42682,59,12,71,0,inf
42683,59,5,64,0,inf
42684,63,13,76,0,inf
42685,57,5,62,0,inf
42686,64,13,77,0,inf
42687,52,5,57,0,inf
42688,62,12,74,0,inf
42689,52,10,62,0,inf
42690,57,11,68,0,inf
42691,50,12,62,0,inf
42692,67,10,77,0,inf
42693,57,10,67,0,inf
42694,58,10,68,0,inf
42695,59,10,69,0,inf
42696,60,11,71,0,inf
42697,59,9,68,0,inf
42698,61,12,73,1,4.805419746615698
42699,57,6,63,0,inf
42700,50,13,63,0,inf
42701,64,10,74,0,inf
42702,62,6,68,0,inf
42703,63,7,70,0,inf
42704,66,12,78,0,inf
42705,65,8,73,0,inf
42706,60,13,73,0,inf
42707,62,9,71,0,inf
42708,54,6,60,0,inf
42709,63,10,73,0,inf
42710,57,6,63,0,inf
42711,56,11,67,0,inf
42712,67,9,76,0,inf
42713,66,9,75,0,inf
42714,56,6,62,0,inf
42715,60,9,69,0,inf
42716,51,8,59,0,inf
42717,53,11,64,0,inf
42718,65,13,78,0,inf
42719,51,6,57,0,inf
42720,62,10,72,0,inf
42721,62,5,67,0,inf
42722,61,5,66,0,inf
42723,59,13,72,0,inf
42724,50,6,56,0,inf
42725,53,5,58,0,inf
42726,63,13,76,1,2.7550195658388787
42727,64,7,71,0,inf
42728,59,6,65,0,inf
42729,67,13,80,0,inf
42730,54,6,60,0,inf
42731,50,12,62,0,inf
42732,61,13,74,0,inf
42733,59,9,68,0,inf
42734,52,13,65,0,inf
42735,62,7,69,0,inf
42736,53,8,61,0,inf
42737,54,9,63,0,inf
42738,64,10,74,0,inf
42739,56,5,61,0,inf
42740,64,5,69,1,1.0817141135582489
42741,57,11,68,0,inf
42742,56,5,61,0,inf
42743,53,8,61,0,inf
42744,52,10,62,0,inf
42745,57,7,64,0,inf
42746,55,7,62,0,inf
42747,55,13,68,0,inf
42748,54,13,67,0,inf
42749,59,10,69,0,inf
42750,56,13,69,0,inf
42751,56,9,65,0,inf
42752,60,7,67,0,inf
42753,61,13,74,0,inf
42754,66,8,74,0,inf
42755,61,13,74,0,inf
42756,64,6,70,0,inf
42757,56,7,63,0,inf
42758,55,8,63,0,inf
42759,55,5,60,0,inf
42760,55,7,62,0,inf
42761,62,9,71,0,inf
42762,62,9,71,0,inf
42763,50,7,57,0,inf
42764,51,11,62,0,inf
42765,56,5,61,0,inf
42766,52,12,64,0,inf
42767,66,11,77,0,inf
42768,60,13,73,0,inf
42769,55,12,67,0,inf
42770,50,6,56,0,inf
42771,62,10,72,0,inf
42772,58,7,65,0,inf
42773,61,8,69,0,inf
42774,63,10,73,0,inf
42775,59,12,71,0,inf
42776,67,9,76,0,inf
42777,57,5,62,0,inf
42778,60,7,67,0,inf
42779,67,12,79,0,inf
42780,64,10,74,0,inf
42781,50,10,60,0,inf
42782,54,7,61,0,inf
42783,59,5,64,0,inf
42784,51,8,59,0,inf
42785,61,5,66,0,inf
42786,65,13,78,0,inf
42787,61,6,67,0,inf
42788,63,6,69,0,inf
42789,56,13,69,0,inf
42790,60,6,66,0,inf
42791,66,5,71,0,inf
42792,62,12,74,0,inf
42793,62,10,72,0,inf
42794,54,10,64,0,inf
42795,59,10,69,0,inf
42796,54,8,62,0,inf
42797,54,6,60,0,inf
42798,53,9,62,0,inf
42799,63,13,76,0,inf
42800,61,8,69,0,inf
42801,51,10,61,1,1.0170358282323875
42802,52,13,65,0,inf
42803,51,11,62,0,inf
42804,55,6,61,0,inf
42805,59,11,70,0,inf
42806,63,13,76,0,inf
42807,65,6,71,0,inf
42808,60,12,72,0,inf
42809,60,5,65,0,inf
42810,61,8,69,0,inf
42811,63,12,75,0,inf
42812,52,11,63,0,inf
42813,57,6,63,0,inf
42814,61,11,72,0,inf
42815,67,8,75,0,inf
42816,64,13,77,0,inf
42817,64,11,75,0,inf
42818,65,9,74,0,inf
42819,53,5,58,0,inf
42820,55,6,61,0,inf
42821,50,7,57,0,inf
42822,63,13,76,0,inf
42823,59,9,68,0,inf
42824,62,6,68,0,inf
42825,54,8,62,0,inf
42826,60,12,72,0,inf
42827,66,5,71,0,inf
42828,59,6,65,0,inf
42829,56,12,68,0,inf
42830,59,6,65,0,inf
42831,54,9,63,0,inf
42832,65,9,74,0,inf
42833,56,10,66,0,inf
42834,65,13,78,0,inf
42835,56,9,65,0,inf
42836,60,5,65,0,inf
42837,51,5,56,0,inf
42838,67,13,80,0,inf
42839,62,11,73,0,inf
42840,66,7,73,0,inf
42841,62,10,72,0,inf
42842,55,6,61,0,inf
42843,62,9,71,0,inf
42844,59,13,72,0,inf
42845,64,7,71,0,inf
42846,58,10,68,0,inf
42847,65,6,71,0,inf
42848,67,5,72,0,inf
42849,63,10,73,0,inf
42850,67,9,76,0,inf
42851,65,11,76,0,inf
42852,52,5,57,0,inf
42853,52,8,60,0,inf
42854,67,9,76,0,inf
42855,54,5,59,0,inf
42856,59,10,69,0,inf
42857,66,12,78,0,inf
42858,65,11,76,0,inf
42859,61,11,72,0,inf
42860,55,10,65,0,inf
42861,55,6,61,0,inf
42862,53,11,64,0,inf
42863,65,12,77,1,2.254255928459145
42864,55,9,64,1,6.152634760927533
42865,62,8,70,0,inf
42866,55,12,67,0,inf
42867,62,10,72,0,inf
42868,64,6,70,0,inf
42869,62,8,70,0,inf
42870,66,13,79,0,inf
42871,57,5,62,0,inf
42872,53,7,60,0,inf
42873,57,12,69,0,inf
42874,56,8,64,0,inf
42875,66,9,75,0,inf
42876,65,13,78,0,inf
42877,65,13,78,0,inf
42878,55,13,68,0,inf
42879,52,11,63,0,inf
42880,55,12,67,0,inf
42881,52,6,58,0,inf
42882,55,5,60,0,inf
42883,67,13,80,0,inf
42884,56,5,61,0,inf
42885,55,12,67,0,inf
42886,60,11,71,0,inf
42887,51,6,57,0,inf
42888,58,7,65,0,inf
42889,50,8,58,0,inf
42890,56,7,63,0,inf
42891,57,11,68,0,inf
42892,63,10,73,0,inf
42893,51,10,61,0,inf
42894,51,11,62,0,inf
42895,65,8,73,0,inf
42896,61,6,67,0,inf
42897,53,8,61,0,inf
42898,55,6,61,0,inf
42899,51,13,64,0,inf
42900,64,8,72,0,inf
42901,52,8,60,0,inf
42902,58,5,63,0,inf
42903,61,13,74,0,inf
42904,62,10,72,0,inf
42905,57,12,69,0,inf
42906,50,13,63,0,inf
42907,52,12,64,0,inf
42908,65,5,70,0,inf
42909,61,12,73,0,inf
42910,51,9,60,0,inf
42911,67,7,74,0,inf
42912,64,12,76,0,inf
42913,61,10,71,0,inf
42914,64,6,70,0,inf
42915,57,8,65,0,inf
42916,57,11,68,0,inf
42917,61,10,71,0,inf
42918,53,10,63,1,6.721989894243556
42919,55,8,63,0,inf
42920,57,6,63,0,inf
42921,53,5,58,0,inf
42922,60,12,72,0,inf
42923,57,7,64,0,inf
42924,59,6,65,0,inf
42925,64,10,74,0,inf
42926,63,5,68,0,inf
42927,58,11,69,0,inf
42928,55,7,62,0,inf
42929,52,9,61,0,inf
42930,65,6,71,0,inf
42931,65,12,77,0,inf
42932,50,6,56,0,inf
42933,54,5,59,0,inf
42934,65,7,72,0,inf
42935,57,8,65,0,inf
42936,58,5,63,0,inf
42937,66,11,77,0,inf
42938,50,10,60,0,inf
42939,64,5,69,0,inf
42940,61,8,69,0,inf
42941,64,12,76,0,inf
42942,57,8,65,0,inf
42943,58,13,71,0,inf
42944,62,13,75,0,inf
42945,63,9,72,0,inf
42946,54,10,64,0,inf
42947,55,9,64,0,inf
42948,62,9,71,0,inf
42949,62,10,72,1,5.340314682445737
42950,61,5,66,0,inf
42951,59,9,68,0,inf
42952,66,12,78,0,inf
42953,65,8,73,0,inf
42954,51,11,62,0,inf
42955,50,8,58,0,inf
42956,60,5,65,0,inf
42957,64,12,76,0,inf
42958,65,11,76,0,inf
42959,66,7,73,0,inf
42960,53,11,64,0,inf
42961,58,5,63,0,inf
42962,62,12,74,0,inf
42963,50,6,56,0,inf
42964,65,11,76,0,inf
42965,57,5,62,0,inf
42966,66,5,71,0,inf
42967,61,9,70,0,inf
42968,56,7,63,0,inf
42969,53,10,63,0,inf
42970,63,10,73,0,inf
42971,67,10,77,0,inf
42972,66,8,74,0,inf
42973,66,13,79,0,inf
42974,58,13,71,0,inf
42975,58,12,70,0,inf
42976,55,5,60,0,inf
42977,63,12,75,0,inf
42978,62,8,70,0,inf
42979,53,8,61,0,inf
42980,62,6,68,0,inf
42981,60,5,65,0,inf
42982,57,8,65,0,inf
42983,64,13,77,0,inf
42984,61,11,72,0,inf
42985,53,5,58,0,inf
42986,61,13,74,0,inf
42987,59,9,68,0,inf
42988,63,8,71,0,inf
42989,64,12,76,0,inf
42990,61,13,74,0,inf
42991,65,9,74,0,inf
42992,58,12,70,1,9.787139319948196
42993,61,8,69,0,inf
42994,57,11,68,0,inf
42995,62,10,72,0,inf
42996,55,13,68,0,inf
42997,55,13,68,0,inf
42998,60,13,73,0,inf
42999,57,11,68,0,inf
43000,52,5,57,0,inf
43001,50,12,62,0,inf
43002,50,11,61,0,inf
43003,60,6,66,0,inf
43004,58,8,66,0,inf
43005,65,12,77,0,inf
43006,63,7,70,0,inf
43007,67,8,75,0,inf
43008,59,10,69,0,inf
43009,59,13,72,0,inf
43010,60,13,73,0,inf
43011,62,13,75,0,inf
43012,58,12,70,0,inf
43013,59,13,72,0,inf
43014,52,12,64,0,inf
43015,65,7,72,0,inf
43016,64,9,73,0,inf
43017,51,7,58,0,inf
43018,61,7,68,0,inf
43019,64,12,76,0,inf
43020,57,10,67,0,inf
43021,54,10,64,0,inf
43022,63,11,74,0,inf
43023,61,10,71,0,inf
43024,61,8,69,0,inf
43025,60,11,71,0,inf
43026,56,7,63,0,inf
43027,63,6,69,0,inf
43028,62,13,75,0,inf
43029,52,12,64,0,inf
43030,50,13,63,0,inf
43031,52,12,64,0,inf
43032,61,5,66,0,inf
43033,53,9,62,0,inf
43034,55,13,68,0,inf
43035,58,11,69,0,inf
43036,60,10,70,1,4.436049690891423
43037,62,11,73,0,inf
43038,64,13,77,0,inf
43039,62,6,68,0,inf
43040,50,10,60,0,inf
43041,52,5,57,0,inf
43042,57,8,65,0,inf
43043,53,9,62,0,inf
43044,50,6,56,0,inf
43045,62,12,74,0,inf
43046,50,9,59,0,inf
43047,51,7,58,0,inf
43048,66,7,73,0,inf
43049,51,10,61,0,inf
43050,52,7,59,0,inf
43051,63,11,74,0,inf
43052,64,6,70,0,inf
43053,60,7,67,0,inf
43054,67,13,80,0,inf
43055,59,12,71,0,inf
43056,65,8,73,0,inf
43057,66,12,78,0,inf
43058,52,12,64,0,inf
43059,56,13,69,0,inf
43060,52,11,63,1,4.607454525920559
43061,58,11,69,0,inf
43062,57,6,63,1,1.8670124550668348
43063,59,13,72,0,inf
43064,51,8,59,0,inf
43065,66,6,72,0,inf
43066,56,5,61,0,inf
43067,60,6,66,0,inf
43068,60,10,70,0,inf
43069,62,13,75,0,inf
43070,57,5,62,0,inf
43071,63,12,75,0,inf
43072,61,6,67,0,inf
43073,67,12,79,0,inf
43074,57,11,68,0,inf
43075,67,13,80,0,inf
43076,61,13,74,0,inf
43077,65,7,72,0,inf
43078,58,12,70,0,inf
43079,59,10,69,0,inf
43080,50,11,61,0,inf
43081,56,12,68,0,inf
43082,55,7,62,0,inf
43083,67,13,80,1,12.62097504814514
43084,53,12,65,0,inf
43085,56,9,65,0,inf
43086,66,10,76,0,inf
43087,54,9,63,0,inf
43088,53,6,59,0,inf
43089,62,8,70,0,inf
43090,64,13,77,0,inf
43091,51,8,59,0,inf
43092,51,6,57,0,inf
43093,51,10,61,1,6.50376911301295
43094,50,7,57,0,inf
43095,58,7,65,0,inf
43096,54,10,64,0,inf
43097,56,12,68,0,inf
43098,66,10,76,0,inf
43099,64,7,71,0,inf
43100,54,5,59,0,inf
43101,63,6,69,0,inf
43102,58,6,64,0,inf
43103,54,10,64,0,inf
43104,52,6,58,0,inf
43105,53,8,61,0,inf
43106,55,13,68,0,inf
43107,54,7,61,0,inf
43108,63,7,70,0,inf
43109,53,11,64,0,inf
43110,67,13,80,0,inf
43111,55,7,62,0,inf
43112,60,5,65,0,inf
43113,58,9,67,0,inf
43114,61,6,67,0,inf
43115,53,12,65,1,2.5877602607359833
43116,55,12,67,0,inf
43117,50,7,57,0,inf
43118,51,8,59,0,inf
43119,58,7,65,0,inf
43120,57,7,64,0,inf
43121,50,13,63,0,inf
43122,67,5,72,0,inf
43123,61,13,74,0,inf
43124,54,5,59,0,inf
43125,62,8,70,0,inf
43126,65,9,74,0,inf
43127,67,7,74,0,inf
43128,55,11,66,0,inf
43129,65,9,74,0,inf
43130,57,12,69,0,inf
43131,61,10,71,0,inf
43132,62,11,73,0,inf
43133,62,10,72,0,inf
43134,55,10,65,0,inf
43135,61,9,70,0,inf
43136,61,5,66,0,inf
43137,50,5,55,0,inf
43138,51,13,64,0,inf
43139,51,6,57,0,inf
43140,61,11,72,0,inf
43141,60,6,66,0,inf
43142,59,10,69,0,inf
43143,53,13,66,0,inf
43144,51,13,64,0,inf
43145,63,5,68,0,inf
43146,53,13,66,0,inf
43147,58,12,70,0,inf
43148,57,9,66,0,inf
43149,63,10,73,0,inf
43150,58,10,68,0,inf
43151,64,9,73,0,inf
43152,62,11,73,0,inf
43153,52,7,59,0,inf
43154,55,10,65,0,inf
43155,66,5,71,0,inf
43156,52,13,65,0,inf
43157,51,13,64,0,inf
43158,64,13,77,0,inf
43159,54,7,61,0,inf
43160,52,10,62,0,inf
43161,59,5,64,0,inf
43162,66,13,79,0,inf
43163,54,11,65,0,inf
43164,60,5,65,0,inf
43165,66,8,74,0,inf
43166,55,11,66,0,inf
43167,63,11,74,0,inf
43168,62,13,75,0,inf
43169,50,13,63,0,inf
43170,67,5,72,0,inf
43171,51,9,60,0,inf
43172,61,8,69,0,inf
43173,65,12,77,0,inf
43174,55,5,60,0,inf
43175,51,12,63,0,inf
43176,56,8,64,0,inf
43177,64,9,73,0,inf
43178,53,11,64,0,inf
43179,66,6,72,1,4.009359479013199
43180,66,10,76,0,inf
43181,56,10,66,1,6.838996217814156
43182,57,6,63,0,inf
43183,60,13,73,0,inf
43184,65,5,70,0,inf
43185,59,5,64,0,inf
43186,55,5,60,0,inf
43187,61,10,71,0,inf
43188,66,13,79,0,inf
43189,56,7,63,0,inf
43190,66,12,78,0,inf
43191,64,8,72,0,inf
43192,61,13,74,0,inf
43193,60,9,69,0,inf
43194,52,6,58,0,inf
43195,56,5,61,0,inf
43196,57,5,62,0,inf
43197,52,8,60,0,inf
43198,60,11,71,0,inf
43199,66,6,72,0,inf
43200,53,10,63,0,inf
43201,61,10,71,0,inf
43202,67,5,72,0,inf
43203,65,7,72,0,inf
43204,58,11,69,0,inf
43205,67,13,80,0,inf
43206,57,10,67,0,inf
43207,57,12,69,0,inf
43208,65,12,77,0,inf
43209,64,9,73,0,inf
43210,64,12,76,0,inf
43211,54,10,64,0,inf
43212,65,10,75,0,inf
43213,60,8,68,0,inf
43214,54,8,62,0,inf
43215,54,9,63,0,inf
43216,54,11,65,0,inf
43217,60,9,69,1,1.6089470795136265
43218,56,7,63,0,inf
43219,57,8,65,0,inf
43220,60,6,66,1,0.917043622218614
43221,52,7,59,0,inf
43222,52,13,65,0,inf
43223,67,11,78,0,inf
43224,55,8,63,0,inf
43225,66,8,74,0,inf
43226,66,6,72,0,inf
43227,67,13,80,0,inf
43228,62,9,71,0,inf
43229,54,5,59,0,inf
43230,55,11,66,0,inf
43231,57,11,68,0,inf
43232,56,6,62,0,inf
43233,52,5,57,0,inf
43234,63,11,74,0,inf
43235,51,7,58,0,inf
43236,66,5,71,0,inf
43237,59,12,71,0,inf
43238,54,12,66,0,inf
43239,58,10,68,0,inf
43240,53,11,64,1,10.063538057314119
43241,50,13,63,0,inf
43242,52,12,64,0,inf
43243,65,8,73,0,inf
43244,61,12,73,0,inf
43245,58,6,64,0,inf
43246,50,10,60,0,inf
43247,58,10,68,0,inf
43248,61,12,73,0,inf
43249,50,6,56,0,inf
43250,66,7,73,0,inf
43251,65,13,78,0,inf
43252,59,10,69,0,inf
43253,67,12,79,0,inf
43254,60,6,66,0,inf
43255,58,6,64,0,inf
43256,54,5,59,0,inf
43257,58,11,69,0,inf
43258,63,10,73,0,inf
43259,50,13,63,0,inf
43260,66,10,76,0,inf
43261,56,5,61,0,inf
43262,60,7,67,0,inf
43263,56,13,69,0,inf
43264,51,9,60,0,inf
43265,64,11,75,0,inf
43266,60,11,71,0,inf
43267,52,13,65,0,inf
43268,56,10,66,0,inf
43269,57,11,68,0,inf
43270,63,12,75,1,1.7497777262774292
43271,61,13,74,0,inf
43272,65,8,73,0,inf
43273,57,13,70,0,inf
43274,57,10,67,0,inf
43275,62,5,67,0,inf
43276,50,5,55,0,inf
43277,55,9,64,0,inf
43278,61,10,71,0,inf
43279,61,10,71,0,inf
43280,61,8,69,0,inf
43281,58,8,66,0,inf
43282,65,13,78,1,9.324764504849895
43283,60,5,65,0,inf
43284,67,6,73,0,inf
43285,54,7,61,0,inf
43286,60,11,71,0,inf
43287,62,12,74,0,inf
43288,65,8,73,0,inf
43289,52,6,58,0,inf
43290,60,5,65,0,inf
43291,63,9,72,0,inf
43292,59,10,69,0,inf
43293,57,12,69,0,inf
43294,57,10,67,0,inf
43295,58,10,68,0,inf
43296,53,6,59,0,inf
43297,57,5,62,0,inf
43298,64,7,71,1,3.3390988669436155
43299,60,5,65,0,inf
43300,55,12,67,0,inf
43301,53,13,66,0,inf
43302,67,6,73,0,inf
43303,52,5,57,0,inf
43304,54,7,61,0,inf
43305,55,5,60,0,inf
43306,63,6,69,0,inf
43307,65,11,76,0,inf
43308,51,13,64,0,inf
43309,62,6,68,1,4.558185729920524
43310,55,5,60,0,inf
43311,67,10,77,0,inf
43312,59,5,64,0,inf
43313,67,6,73,0,inf
43314,55,9,64,0,inf
43315,56,5,61,0,inf
43316,56,11,67,0,inf
43317,53,11,64,0,inf
43318,61,6,67,0,inf
43319,62,8,70,0,inf
43320,50,5,55,0,inf
43321,59,6,65,0,inf
43322,65,8,73,0,inf
43323,64,11,75,0,inf
43324,61,8,69,0,inf
43325,55,8,63,0,inf
43326,53,8,61,0,inf
43327,61,13,74,0,inf
43328,59,9,68,0,inf
43329,67,12,79,0,inf
43330,52,11,63,0,inf
43331,53,11,64,0,inf
43332,62,5,67,0,inf
43333,59,11,70,0,inf
43334,66,13,79,0,inf
43335,62,12,74,0,inf
43336,65,12,77,0,inf
43337,66,6,72,0,inf
43338,55,11,66,0,inf
43339,59,13,72,0,inf
43340,66,6,72,0,inf
43341,58,9,67,0,inf
43342,54,6,60,0,inf
43343,58,8,66,0,inf
43344,51,9,60,0,inf
43345,50,9,59,0,inf
43346,51,8,59,0,inf
43347,57,11,68,0,inf
43348,66,7,73,0,inf
43349,58,7,65,0,inf
43350,51,5,56,0,inf
43351,55,10,65,0,inf
43352,58,13,71,0,inf
43353,50,6,56,0,inf
43354,53,5,58,0,inf
43355,56,12,68,0,inf
43356,60,11,71,0,inf
43357,56,6,62,0,inf
43358,62,12,74,0,inf
43359,55,5,60,0,inf
43360,50,10,60,0,inf
43361,54,6,60,0,inf
43362,67,8,75,0,inf
43363,52,10,62,0,inf
43364,54,10,64,1,4.9484209544560755
43365,54,8,62,0,inf
43366,52,9,61,0,inf
43367,54,5,59,0,inf
43368,61,11,72,0,inf
43369,53,13,66,0,inf
43370,51,5,56,0,inf
43371,56,10,66,0,inf
43372,56,8,64,0,inf
43373,57,12,69,0,inf
43374,53,5,58,0,inf
43375,58,13,71,0,inf
43376,57,13,70,0,inf
43377,64,11,75,0,inf
43378,50,8,58,0,inf
43379,63,7,70,0,inf
43380,54,13,67,0,inf
43381,62,13,75,0,inf
43382,54,13,67,0,inf
43383,59,6,65,0,inf
43384,60,6,66,0,inf
43385,62,10,72,1,6.538096326631333
43386,50,6,56,0,inf
43387,53,10,63,0,inf
43388,67,10,77,0,inf
43389,66,5,71,0,inf
43390,56,5,61,0,inf
43391,61,9,70,0,inf
43392,64,10,74,0,inf
43393,57,11,68,0,inf
43394,64,11,75,0,inf
43395,50,8,58,0,inf
43396,55,12,67,0,inf
43397,60,7,67,0,inf
43398,62,9,71,0,inf
43399,66,13,79,0,inf
43400,67,10,77,0,inf
43401,66,10,76,0,inf
43402,62,9,71,0,inf
43403,54,7,61,0,inf
43404,61,7,68,0,inf
43405,66,13,79,0,inf
43406,62,7,69,0,inf
43407,52,7,59,0,inf
43408,56,12,68,0,inf
43409,62,9,71,0,inf
43410,59,8,67,0,inf
43411,64,10,74,0,inf
43412,53,12,65,0,inf
43413,51,5,56,0,inf
43414,54,6,60,0,inf
43415,66,10,76,0,inf
43416,51,12,63,0,inf
43417,55,7,62,0,inf
43418,59,9,68,0,inf
43419,58,13,71,0,inf
43420,63,9,72,0,inf
43421,50,11,61,0,inf
43422,51,13,64,0,inf
43423,60,9,69,0,inf
43424,53,10,63,0,inf
43425,51,6,57,0,inf
43426,55,10,65,0,inf
43427,65,10,75,0,inf
43428,53,9,62,0,inf
43429,52,12,64,0,inf
43430,57,11,68,0,inf
43431,66,7,73,0,inf
43432,64,6,70,0,inf
43433,67,5,72,0,inf
43434,62,6,68,0,inf
43435,51,12,63,0,inf
43436,58,12,70,0,inf
43437,62,13,75,0,inf
43438,66,10,76,0,inf
43439,63,11,74,0,inf
43440,54,6,60,0,inf
43441,63,7,70,0,inf
43442,57,8,65,0,inf
43443,52,9,61,0,inf
43444,64,13,77,0,inf
43445,60,5,65,0,inf
43446,50,8,58,0,inf
43447,56,6,62,0,inf
43448,64,13,77,0,inf
43449,63,7,70,0,inf
43450,56,8,64,0,inf
43451,67,7,74,0,inf
43452,64,11,75,0,inf
43453,60,13,73,0,inf
43454,50,11,61,0,inf
43455,54,9,63,0,inf
43456,52,10,62,0,inf
43457,55,12,67,0,inf
43458,52,5,57,0,inf
43459,64,13,77,0,inf
43460,50,6,56,0,inf
43461,66,11,77,0,inf
43462,62,13,75,0,inf
43463,66,6,72,0,inf
43464,56,6,62,0,inf
43465,53,5,58,0,inf
43466,50,9,59,0,inf
43467,66,12,78,0,inf
43468,52,10,62,0,inf
43469,64,9,73,0,inf
43470,59,12,71,0,inf
43471,56,11,67,0,inf
43472,50,7,57,0,inf
43473,59,8,67,0,inf
43474,63,7,70,0,inf
43475,61,12,73,0,inf
43476,62,11,73,0,inf
43477,51,10,61,0,inf
43478,64,5,69,0,inf
43479,51,5,56,0,inf
43480,57,11,68,0,inf
43481,64,7,71,0,inf
43482,61,7,68,0,inf
43483,55,8,63,0,inf
43484,52,10,62,0,inf
43485,54,13,67,0,inf
43486,60,10,70,0,inf
43487,53,11,64,0,inf
43488,54,10,64,0,inf
43489,54,5,59,0,inf
43490,56,6,62,0,inf
43491,67,9,76,0,inf
43492,66,5,71,0,inf
43493,57,9,66,0,inf
43494,64,11,75,0,inf
43495,64,8,72,0,inf
43496,64,8,72,0,inf
43497,59,6,65,0,inf
43498,65,12,77,0,inf
43499,50,10,60,1,0.11406383283669896
43500,66,5,71,0,inf
43501,64,6,70,0,inf
43502,55,7,62,0,inf
43503,53,12,65,1,0.550242241472489
43504,59,7,66,1,1.375753903268837
43505,65,12,77,0,inf
43506,62,10,72,0,inf
43507,52,8,60,0,inf
43508,52,10,62,0,inf
43509,61,7,68,0,inf
43510,64,7,71,0,inf
43511,58,7,65,0,inf
43512,50,9,59,0,inf
43513,53,9,62,0,inf
43514,56,9,65,0,inf
43515,64,13,77,0,inf
43516,55,7,62,0,inf
43517,65,10,75,0,inf
43518,54,9,63,0,inf
43519,61,6,67,0,inf
43520,53,12,65,0,inf
43521,56,9,65,0,inf
43522,54,8,62,0,inf
43523,52,13,65,0,inf
43524,66,10,76,0,inf
43525,52,11,63,0,inf
43526,57,11,68,1,5.033463829967857
43527,60,13,73,0,inf
43528,52,8,60,0,inf
43529,56,11,67,0,inf
43530,54,12,66,0,inf
43531,50,6,56,0,inf
43532,64,12,76,0,inf
43533,56,7,63,0,inf
43534,57,9,66,0,inf
43535,59,6,65,0,inf
43536,51,6,57,0,inf
43537,65,5,70,0,inf
43538,50,6,56,0,inf
43539,66,5,71,0,inf
43540,60,7,67,0,inf
43541,56,13,69,0,inf
43542,60,7,67,0,inf
43543,65,13,78,0,inf
43544,58,9,67,0,inf
43545,56,5,61,0,inf
43546,66,9,75,0,inf
43547,57,10,67,1,8.477154285433798
43548,64,13,77,0,inf
43549,56,9,65,0,inf
43550,51,8,59,0,inf
43551,56,8,64,0,inf
43552,52,11,63,0,inf
43553,58,5,63,0,inf
43554,51,13,64,0,inf
43555,53,13,66,1,0.8024493633550946
43556,67,11,78,0,inf
43557,57,6,63,0,inf
43558,67,7,74,0,inf
43559,61,7,68,0,inf
43560,55,13,68,1,11.083042736882291
43561,57,13,70,0,inf
43562,62,6,68,0,inf
43563,61,13,74,0,inf
43564,60,9,69,0,inf
43565,61,5,66,0,inf
43566,62,12,74,0,inf
43567,64,10,74,0,inf
43568,67,6,73,0,inf
43569,55,13,68,0,inf
43570,63,9,72,0,inf
43571,67,5,72,0,inf
43572,61,5,66,0,inf
43573,54,9,63,0,inf
43574,64,12,76,0,inf
43575,59,7,66,0,inf
43576,51,5,56,0,inf
43577,64,5,69,0,inf
43578,52,8,60,0,inf
43579,56,11,67,0,inf
43580,53,8,61,0,inf
43581,62,13,75,0,inf
43582,59,8,67,0,inf
43583,56,5,61,0,inf
43584,62,5,67,0,inf
43585,65,9,74,0,inf
43586,60,6,66,0,inf
43587,63,9,72,0,inf
43588,59,7,66,0,inf
43589,53,10,63,0,inf
43590,62,11,73,1,2.832239856222145
43591,51,10,61,0,inf
43592,51,13,64,0,inf
43593,55,8,63,0,inf
43594,67,7,74,0,inf
43595,61,6,67,0,inf
43596,53,13,66,0,inf
43597,60,13,73,0,inf
43598,53,11,64,0,inf
43599,63,6,69,0,inf
43600,50,12,62,0,inf
43601,51,7,58,0,inf
43602,58,6,64,0,inf
43603,60,10,70,0,inf
43604,52,13,65,0,inf
43605,55,5,60,0,inf
43606,55,5,60,0,inf
43607,60,11,71,0,inf
43608,52,13,65,0,inf
43609,61,12,73,0,inf
43610,54,5,59,0,inf
43611,55,13,68,0,inf
43612,66,9,75,0,inf
43613,56,12,68,0,inf
43614,63,13,76,0,inf
43615,55,5,60,0,inf
43616,63,11,74,0,inf
43617,64,7,71,0,inf
43618,58,6,64,0,inf
43619,53,13,66,0,inf
43620,51,6,57,0,inf
43621,57,12,69,0,inf
43622,57,9,66,0,inf
43623,66,5,71,0,inf
43624,59,9,68,0,inf
43625,55,5,60,0,inf
43626,51,6,57,0,inf
43627,59,10,69,0,inf
43628,67,5,72,0,inf
43629,53,7,60,0,inf
43630,54,11,65,0,inf
43631,62,9,71,0,inf
43632,62,5,67,0,inf
43633,52,12,64,0,inf
43634,51,11,62,0,inf
43635,61,12,73,0,inf
43636,66,11,77,0,inf
43637,56,9,65,0,inf
43638,59,9,68,0,inf
43639,63,5,68,0,inf
43640,58,12,70,1,4.84765144004642
43641,60,8,68,0,inf
43642,66,6,72,0,inf
43643,59,8,67,0,inf
43644,50,13,63,0,inf
43645,62,6,68,0,inf
43646,54,9,63,0,inf
43647,64,12,76,0,inf
43648,64,9,73,0,inf
43649,52,6,58,0,inf
43650,65,6,71,0,inf
43651,64,11,75,0,inf
43652,58,7,65,0,inf
43653,57,8,65,0,inf
43654,56,10,66,0,inf
43655,61,8,69,0,inf
43656,64,8,72,0,inf
43657,61,11,72,0,inf
43658,65,8,73,0,inf
43659,52,12,64,0,inf
43660,56,6,62,0,inf
43661,64,10,74,0,inf
43662,58,11,69,0,inf
43663,67,7,74,1,5.947025501707415
43664,61,7,68,0,inf
43665,65,6,71,0,inf
43666,52,8,60,0,inf
43667,51,7,58,1,1.953733321247121
43668,57,10,67,0,inf
43669,65,12,77,0,inf
43670,60,5,65,0,inf
43671,51,10,61,0,inf
43672,66,11,77,0,inf
43673,63,13,76,0,inf
43674,58,5,63,0,inf
43675,63,8,71,0,inf
43676,52,11,63,0,inf
43677,63,8,71,0,inf
43678,54,7,61,0,inf
43679,53,5,58,0,inf
43680,58,5,63,0,inf
43681,53,7,60,0,inf
43682,56,7,63,0,inf
43683,55,9,64,0,inf
43684,65,7,72,0,inf
43685,50,13,63,0,inf
43686,62,10,72,0,inf
43687,55,10,65,0,inf
43688,52,12,64,0,inf
43689,54,5,59,0,inf
43690,53,10,63,0,inf
43691,64,12,76,0,inf
43692,51,5,56,1,3.913782233500257
43693,56,12,68,0,inf
43694,67,8,75,0,inf
43695,66,9,75,0,inf
43696,50,8,58,0,inf
43697,51,6,57,0,inf
43698,67,13,80,0,inf
43699,50,9,59,0,inf
43700,51,13,64,0,inf
43701,59,11,70,0,inf
43702,64,12,76,0,inf
43703,65,9,74,0,inf
43704,62,9,71,0,inf
43705,55,5,60,0,inf
43706,50,10,60,0,inf
43707,52,7,59,0,inf
43708,51,8,59,0,inf
43709,50,10,60,0,inf
43710,55,9,64,0,inf
43711,53,8,61,0,inf
43712,60,10,70,0,inf
43713,59,11,70,0,inf
43714,59,5,64,0,inf
43715,61,7,68,0,inf
43716,60,13,73,0,inf
43717,51,6,57,0,inf
43718,58,5,63,0,inf
43719,58,8,66,0,inf
43720,63,5,68,0,inf
43721,50,7,57,0,inf
43722,55,11,66,0,inf
43723,66,11,77,0,inf
43724,55,10,65,0,inf
43725,65,5,70,0,inf
43726,65,8,73,0,inf
43727,58,11,69,0,inf
43728,62,9,71,0,inf
43729,56,8,64,0,inf
43730,58,5,63,0,inf
43731,52,9,61,0,inf
43732,53,7,60,0,inf
43733,65,7,72,0,inf
43734,62,9,71,0,inf
43735,64,5,69,0,inf
43736,51,10,61,0,inf
43737,62,13,75,0,inf
43738,54,13,67,0,inf
43739,60,5,65,0,inf
43740,56,12,68,0,inf
43741,52,12,64,0,inf
43742,62,8,70,1,0.8979855721464318
43743,58,7,65,0,inf
43744,51,13,64,0,inf
43745,65,9,74,0,inf
43746,55,7,62,0,inf
43747,66,8,74,0,inf
43748,51,13,64,0,inf
43749,57,11,68,1,10.142894691154979
43750,54,13,67,0,inf
43751,58,12,70,1,11.310723706014159
43752,50,11,61,0,inf
43753,54,5,59,0,inf
43754,50,10,60,0,inf
43755,56,5,61,0,inf
43756,51,6,57,0,inf
43757,59,9,68,0,inf
43758,65,9,74,0,inf
43759,57,12,69,0,inf
43760,67,5,72,0,inf
43761,67,10,77,0,inf
43762,56,7,63,0,inf
43763,63,12,75,0,inf
43764,55,8,63,1,0.8187965443110414
43765,67,11,78,0,inf
43766,67,5,72,0,inf
43767,55,7,62,0,inf
43768,58,9,67,1,7.651034762761682
43769,53,8,61,0,inf
43770,54,11,65,0,inf
43771,64,8,72,0,inf
43772,60,13,73,0,inf
43773,52,5,57,0,inf
43774,67,11,78,0,inf
43775,63,7,70,0,inf
43776,58,9,67,0,inf
43777,58,6,64,0,inf
43778,63,11,74,0,inf
43779,66,13,79,0,inf
43780,60,8,68,0,inf
43781,51,5,56,0,inf
43782,66,8,74,0,inf
43783,62,9,71,0,inf
43784,54,12,66,1,9.779972810366786
43785,67,7,74,0,inf
43786,62,5,67,0,inf
43787,59,6,65,0,inf
43788,53,10,63,0,inf
43789,55,12,67,0,inf
43790,58,10,68,0,inf
43791,57,11,68,0,inf
43792,55,5,60,0,inf
43793,60,9,69,0,inf
43794,50,12,62,0,inf
43795,60,10,70,0,inf
43796,65,13,78,0,inf
43797,53,12,65,0,inf
43798,57,10,67,0,inf
43799,62,11,73,0,inf
43800,65,8,73,0,inf
43801,51,13,64,0,inf
43802,61,6,67,0,inf
43803,65,11,76,0,inf
43804,51,12,63,0,inf
43805,63,10,73,0,inf
43806,50,11,61,0,inf
43807,64,6,70,0,inf
43808,54,5,59,0,inf
43809,64,7,71,0,inf
43810,54,11,65,0,inf
43811,60,13,73,0,inf
43812,50,13,63,0,inf
43813,58,11,69,0,inf
43814,67,8,75,0,inf
43815,54,6,60,0,inf
43816,63,10,73,1,7.762676952183838
43817,60,5,65,0,inf
43818,54,13,67,0,inf
43819,67,8,75,0,inf
43820,64,10,74,0,inf
43821,59,7,66,0,inf
43822,53,10,63,0,inf
43823,62,9,71,0,inf
43824,57,5,62,0,inf
43825,65,13,78,0,inf
43826,55,10,65,0,inf
43827,64,13,77,0,inf
43828,67,11,78,0,inf
43829,61,8,69,0,inf
43830,56,13,69,0,inf
43831,54,13,67,0,inf
43832,60,13,73,0,inf
43833,56,10,66,0,inf
43834,50,13,63,0,inf
43835,67,10,77,0,inf
43836,53,9,62,0,inf
43837,54,8,62,0,inf
43838,66,6,72,0,inf
43839,61,13,74,0,inf
43840,55,10,65,0,inf
43841,60,12,72,0,inf
43842,50,11,61,0,inf
43843,59,8,67,0,inf
43844,50,9,59,0,inf
43845,61,5,66,0,inf
43846,63,7,70,0,inf
43847,52,12,64,0,inf
43848,63,6,69,0,inf
43849,58,10,68,0,inf
43850,62,9,71,0,inf
43851,58,13,71,0,inf
43852,57,6,63,0,inf
43853,50,6,56,0,inf
43854,56,9,65,1,6.311133076213451
43855,60,12,72,0,inf
43856,62,8,70,0,inf
43857,62,5,67,0,inf
43858,64,12,76,0,inf
43859,59,9,68,0,inf
43860,66,5,71,0,inf
43861,64,13,77,0,inf
43862,53,6,59,0,inf
43863,59,9,68,0,inf
43864,59,9,68,0,inf
43865,65,9,74,0,inf
43866,56,10,66,0,inf
43867,54,10,64,0,inf
43868,51,8,59,1,0.09975328384257409
43869,55,10,65,0,inf
43870,60,5,65,0,inf
43871,54,13,67,0,inf
43872,59,5,64,0,inf
43873,63,13,76,0,inf
43874,63,10,73,0,inf
43875,65,13,78,0,inf
43876,61,10,71,0,inf
43877,51,7,58,0,inf
43878,51,12,63,0,inf
43879,64,12,76,0,inf
43880,67,6,73,0,inf
43881,64,11,75,0,inf
43882,52,8,60,0,inf
43883,53,11,64,0,inf
43884,65,12,77,0,inf
43885,58,12,70,0,inf
43886,63,10,73,0,inf
43887,58,11,69,0,inf
43888,51,9,60,0,inf
43889,65,11,76,0,inf
43890,67,10,77,0,inf
43891,55,12,67,1,11.146925318949556
43892,63,12,75,0,inf
43893,53,5,58,0,inf
43894,62,5,67,0,inf
43895,62,13,75,0,inf
43896,60,9,69,0,inf
43897,53,13,66,0,inf
43898,54,7,61,0,inf
43899,66,11,77,0,inf
43900,51,12,63,0,inf
43901,57,7,64,0,inf
43902,62,13,75,0,inf
43903,62,10,72,0,inf
43904,57,5,62,0,inf
43905,59,7,66,0,inf
43906,52,12,64,0,inf
43907,57,8,65,0,inf
43908,56,7,63,0,inf
43909,51,10,61,0,inf
43910,63,9,72,0,inf
43911,55,12,67,0,inf
43912,67,9,76,0,inf
43913,65,8,73,0,inf
43914,67,5,72,1,0.4928806883524999
43915,51,11,62,0,inf
43916,53,10,63,0,inf
43917,60,10,70,0,inf
43918,59,9,68,0,inf
43919,63,8,71,0,inf
43920,52,12,64,0,inf
43921,51,7,58,0,inf
43922,61,12,73,0,inf
43923,66,12,78,0,inf
43924,52,9,61,0,inf
43925,65,5,70,0,inf
43926,62,13,75,0,inf
43927,54,9,63,0,inf
43928,51,6,57,0,inf
43929,60,7,67,0,inf
43930,56,13,69,0,inf
43931,63,5,68,0,inf
43932,50,7,57,0,inf
43933,65,7,72,0,inf
43934,64,8,72,0,inf
43935,52,10,62,0,inf
43936,57,9,66,0,inf
43937,53,13,66,0,inf
43938,56,12,68,0,inf
43939,65,9,74,0,inf
43940,58,5,63,0,inf
43941,58,5,63,0,inf
43942,59,11,70,0,inf
43943,51,8,59,0,inf
43944,59,9,68,0,inf
43945,50,9,59,0,inf
43946,66,9,75,0,inf
43947,52,6,58,0,inf
43948,54,11,65,0,inf
43949,54,12,66,0,inf
43950,58,12,70,0,inf
43951,59,11,70,0,inf
43952,66,10,76,0,inf
43953,61,12,73,0,inf
43954,63,5,68,0,inf
43955,56,5,61,0,inf
43956,60,9,69,0,inf
43957,64,6,70,0,inf
43958,61,12,73,0,inf
43959,55,8,63,0,inf
43960,63,8,71,0,inf
43961,52,11,63,0,inf
43962,61,11,72,0,inf
43963,65,9,74,0,inf
43964,55,10,65,0,inf
43965,53,9,62,1,6.514871126367673
43966,56,10,66,0,inf
43967,60,12,72,0,inf
43968,58,6,64,0,inf
43969,62,11,73,0,inf
43970,56,11,67,0,inf
43971,65,9,74,0,inf
43972,59,8,67,0,inf
43973,62,13,75,1,9.895892542724894
43974,54,11,65,0,inf
43975,61,6,67,0,inf
43976,63,10,73,0,inf
43977,52,9,61,0,inf
43978,67,5,72,0,inf
43979,67,12,79,0,inf
43980,52,5,57,0,inf
43981,64,10,74,0,inf
43982,65,12,77,0,inf
43983,62,11,73,1,10.870237622290176
43984,57,10,67,0,inf
43985,58,12,70,0,inf
43986,51,11,62,0,inf
43987,53,12,65,0,inf
43988,50,11,61,0,inf
43989,60,11,71,0,inf
43990,62,10,72,0,inf
43991,56,7,63,0,inf
43992,64,10,74,0,inf
43993,54,6,60,0,inf
43994,51,6,57,0,inf
43995,61,8,69,0,inf
43996,59,13,72,0,inf
43997,54,5,59,0,inf
43998,52,6,58,0,inf
43999,65,13,78,0,inf
44000,65,10,75,0,inf
44001,64,5,69,0,inf
44002,61,7,68,0,inf
44003,50,13,63,0,inf
44004,67,7,74,0,inf
44005,55,10,65,0,inf
44006,54,9,63,0,inf
44007,61,7,68,0,inf
44008,64,12,76,0,inf
44009,51,9,60,0,inf
44010,61,9,70,0,inf
44011,55,12,67,0,inf
44012,66,11,77,0,inf
44013,62,7,69,0,inf
44014,58,13,71,0,inf
44015,57,5,62,0,inf
44016,52,12,64,0,inf
44017,61,10,71,0,inf
44018,58,12,70,0,inf
44019,59,5,64,0,inf
44020,63,6,69,0,inf
44021,62,12,74,0,inf
44022,66,13,79,0,inf
44023,57,11,68,0,inf
44024,61,5,66,0,inf
44025,57,13,70,0,inf
44026,50,10,60,0,inf
44027,66,7,73,0,inf
44028,67,10,77,0,inf
44029,58,11,69,0,inf
44030,61,8,69,0,inf
44031,50,11,61,0,inf
44032,52,5,57,0,inf
44033,54,11,65,0,inf
44034,55,12,67,0,inf
44035,65,6,71,0,inf
44036,55,5,60,0,inf
44037,59,10,69,0,inf
44038,64,9,73,0,inf
44039,58,10,68,0,inf
44040,60,13,73,0,inf
44041,64,10,74,0,inf
44042,63,7,70,0,inf
44043,59,10,69,0,inf
44044,51,12,63,0,inf
44045,55,8,63,0,inf
44046,55,6,61,0,inf
44047,62,11,73,0,inf
44048,56,9,65,0,inf
44049,67,11,78,0,inf
44050,65,5,70,0,inf
44051,64,8,72,0,inf
44052,62,13,75,0,inf
44053,52,5,57,0,inf
44054,53,7,60,0,inf
44055,67,10,77,0,inf
44056,65,9,74,0,inf
44057,61,13,74,0,inf
44058,66,9,75,0,inf
44059,54,6,60,0,inf
44060,56,5,61,0,inf
44061,61,7,68,0,inf
44062,57,6,63,0,inf
44063,54,6,60,0,inf
44064,61,6,67,0,inf
44065,59,12,71,0,inf
44066,53,11,64,0,inf
44067,62,12,74,0,inf
44068,60,6,66,0,inf
44069,67,7,74,0,inf
44070,57,7,64,0,inf
44071,66,9,75,0,inf
44072,54,5,59,0,inf
44073,64,8,72,0,inf
44074,52,9,61,0,inf
44075,57,8,65,0,inf
44076,65,13,78,0,inf
44077,57,12,69,0,inf
44078,53,12,65,0,inf
44079,65,13,78,0,inf
44080,60,6,66,0,inf
44081,57,13,70,0,inf
44082,60,11,71,0,inf
44083,55,12,67,0,inf
44084,58,7,65,0,inf
44085,51,9,60,0,inf
44086,50,13,63,0,inf
44087,59,13,72,0,inf
44088,59,12,71,0,inf
44089,58,6,64,0,inf
44090,55,10,65,0,inf
44091,54,10,64,0,inf
44092,65,13,78,0,inf
44093,51,12,63,0,inf
44094,52,12,64,0,inf
44095,67,9,76,0,inf
44096,61,12,73,0,inf
44097,50,7,57,0,inf
44098,55,7,62,0,inf
44099,55,10,65,0,inf
44100,60,5,65,0,inf
44101,53,11,64,0,inf
44102,59,7,66,0,inf
44103,53,8,61,0,inf
44104,64,6,70,0,inf
44105,67,9,76,0,inf
44106,67,13,80,0,inf
44107,58,13,71,0,inf
44108,64,7,71,0,inf
44109,59,13,72,0,inf
44110,56,7,63,0,inf
44111,52,8,60,0,inf
44112,66,9,75,0,inf
44113,61,5,66,0,inf
44114,63,6,69,0,inf
44115,66,13,79,0,inf
44116,62,12,74,0,inf
44117,56,5,61,0,inf
44118,63,9,72,0,inf
44119,59,7,66,0,inf
44120,61,8,69,0,inf
44121,63,6,69,0,inf
44122,53,6,59,0,inf
44123,52,12,64,0,inf
44124,67,10,77,0,inf
44125,63,7,70,0,inf
44126,65,12,77,0,inf
44127,50,10,60,0,inf
44128,67,12,79,0,inf
44129,60,7,67,0,inf
44130,60,10,70,0,inf
44131,57,12,69,0,inf
44132,64,6,70,0,inf
44133,64,12,76,0,inf
44134,55,10,65,0,inf
44135,59,12,71,0,inf
44136,61,13,74,0,inf
44137,61,13,74,0,inf
44138,56,10,66,0,inf
44139,59,9,68,0,inf
44140,64,10,74,0,inf
44141,58,11,69,0,inf
44142,54,9,63,0,inf
44143,52,10,62,0,inf
44144,61,11,72,0,inf
44145,57,6,63,1,0.7371346982827234
44146,63,8,71,0,inf
44147,56,11,67,0,inf
44148,62,10,72,0,inf
44149,52,6,58,0,inf
44150,60,5,65,0,inf
44151,57,8,65,0,inf
44152,55,7,62,0,inf
44153,65,11,76,0,inf
44154,52,6,58,0,inf
44155,52,13,65,0,inf
44156,56,10,66,0,inf
44157,58,11,69,0,inf
44158,57,13,70,0,inf
44159,63,5,68,0,inf
44160,53,6,59,0,inf
44161,64,12,76,0,inf
44162,62,7,69,0,inf
44163,63,13,76,0,inf
44164,50,11,61,0,inf
44165,52,12,64,0,inf
44166,51,6,57,0,inf
44167,61,12,73,0,inf
44168,63,7,70,0,inf
44169,66,6,72,0,inf
44170,64,12,76,0,inf
44171,63,8,71,0,inf
44172,65,13,78,0,inf
44173,53,12,65,0,inf
44174,65,10,75,0,inf
44175,51,10,61,0,inf
44176,59,5,64,0,inf
44177,59,12,71,0,inf
44178,50,7,57,0,inf
44179,55,13,68,0,inf
44180,54,7,61,0,inf
44181,67,7,74,0,inf
44182,61,13,74,0,inf
44183,58,10,68,0,inf
44184,51,6,57,0,inf
44185,51,6,57,0,inf
44186,67,9,76,0,inf
44187,60,9,69,0,inf
44188,60,5,65,0,inf
44189,59,10,69,0,inf
44190,66,9,75,0,inf
44191,52,13,65,0,inf
44192,62,10,72,0,inf
44193,65,6,71,0,inf
44194,50,9,59,0,inf
44195,58,12,70,0,inf
44196,56,9,65,1,2.465992072910133
44197,56,5,61,0,inf
44198,54,5,59,0,inf
44199,63,11,74,0,inf
44200,67,10,77,0,inf
44201,58,13,71,1,9.706717348193479
44202,60,8,68,0,inf
44203,62,12,74,0,inf
44204,51,9,60,0,inf
44205,54,11,65,0,inf
44206,52,9,61,0,inf
44207,52,6,58,0,inf
44208,67,7,74,0,inf
44209,51,13,64,0,inf
44210,57,5,62,0,inf
44211,67,5,72,0,inf
44212,63,6,69,0,inf
44213,52,7,59,0,inf
44214,55,7,62,0,inf
44215,55,12,67,0,inf
44216,58,13,71,0,inf
44217,52,13,65,0,inf
44218,62,6,68,0,inf
44219,67,12,79,0,inf
44220,55,7,62,0,inf
44221,65,11,76,0,inf
44222,59,13,72,0,inf
44223,59,6,65,0,inf
44224,61,12,73,0,inf
44225,59,9,68,0,inf
44226,64,11,75,0,inf
44227,53,7,60,0,inf
44228,65,10,75,0,inf
44229,62,5,67,0,inf
44230,51,12,63,0,inf
44231,62,9,71,0,inf
44232,67,13,80,0,inf
44233,58,11,69,0,inf
44234,63,8,71,0,inf
44235,57,9,66,0,inf
44236,55,13,68,0,inf
44237,53,6,59,0,inf
44238,54,6,60,0,inf
44239,52,13,65,0,inf
44240,66,10,76,0,inf
44241,55,6,61,0,inf
44242,53,13,66,0,inf
44243,58,7,65,0,inf
44244,61,10,71,0,inf
44245,56,9,65,0,inf
44246,51,7,58,0,inf
44247,60,8,68,0,inf
44248,53,6,59,0,inf
44249,57,12,69,0,inf
44250,51,10,61,0,inf
44251,58,6,64,0,inf
44252,52,8,60,0,inf
44253,55,5,60,0,inf
44254,56,12,68,0,inf
44255,63,7,70,0,inf
44256,59,5,64,0,inf
44257,51,8,59,0,inf
44258,62,11,73,0,inf
44259,65,9,74,0,inf
44260,53,7,60,0,inf
44261,57,13,70,0,inf
44262,55,13,68,0,inf
44263,54,7,61,0,inf
44264,59,11,70,0,inf
44265,57,11,68,0,inf
44266,51,6,57,0,inf
44267,62,12,74,0,inf
44268,67,7,74,0,inf
44269,64,12,76,0,inf
44270,57,9,66,0,inf
44271,66,8,74,0,inf
44272,56,12,68,0,inf
44273,66,7,73,0,inf
44274,51,9,60,0,inf
44275,66,9,75,0,inf
44276,60,10,70,0,inf
44277,65,5,70,0,inf
44278,59,13,72,0,inf
44279,64,12,76,0,inf
44280,61,7,68,0,inf
44281,62,13,75,0,inf
44282,56,12,68,0,inf
44283,58,10,68,0,inf
44284,52,13,65,0,inf
44285,57,6,63,0,inf
44286,56,9,65,0,inf
44287,52,5,57,0,inf
44288,58,13,71,0,inf
44289,52,8,60,0,inf
44290,51,11,62,0,inf
44291,67,12,79,0,inf
44292,59,5,64,0,inf
44293,55,12,67,0,inf
44294,65,6,71,0,inf
44295,65,10,75,0,inf
44296,53,7,60,0,inf
44297,65,10,75,0,inf
44298,65,8,73,0,inf
44299,55,8,63,0,inf
44300,63,12,75,0,inf
44301,60,9,69,0,inf
44302,56,7,63,0,inf
44303,61,9,70,0,inf
44304,66,11,77,0,inf
44305,65,10,75,0,inf
44306,66,10,76,0,inf
44307,51,11,62,0,inf
44308,59,6,65,0,inf
44309,56,7,63,0,inf
44310,50,8,58,0,inf
44311,66,8,74,0,inf
44312,57,7,64,0,inf
44313,61,6,67,0,inf
44314,66,10,76,0,inf
44315,54,8,62,0,inf
44316,51,11,62,0,inf
44317,65,11,76,0,inf
44318,53,5,58,0,inf
44319,54,11,65,0,inf
44320,59,13,72,1,8.157236562040822
44321,67,8,75,0,inf
44322,65,7,72,0,inf
44323,54,11,65,0,inf
44324,62,6,68,0,inf
44325,67,13,80,0,inf
44326,67,13,80,0,inf
44327,51,5,56,0,inf
44328,67,11,78,0,inf
44329,62,5,67,0,inf
44330,58,6,64,0,inf
44331,59,5,64,0,inf
44332,62,5,67,0,inf
44333,60,6,66,0,inf
44334,62,7,69,0,inf
44335,59,9,68,0,inf
44336,60,6,66,0,inf
44337,51,7,58,0,inf
44338,59,12,71,0,inf
44339,60,12,72,0,inf
44340,54,12,66,0,inf
44341,55,8,63,0,inf
44342,53,8,61,0,inf
44343,54,10,64,0,inf
44344,52,9,61,0,inf
44345,58,13,71,0,inf
44346,64,7,71,0,inf
44347,58,6,64,0,inf
44348,60,13,73,1,10.922062792551287
44349,66,9,75,0,inf
44350,60,9,69,0,inf
44351,63,7,70,0,inf
44352,51,7,58,0,inf
44353,50,5,55,0,inf
44354,60,10,70,0,inf
44355,51,5,56,0,inf
44356,53,5,58,0,inf
44357,64,13,77,0,inf
44358,53,7,60,0,inf
44359,57,9,66,0,inf
44360,51,13,64,0,inf
44361,66,11,77,0,inf
44362,53,9,62,0,inf
44363,62,13,75,0,inf
44364,50,5,55,0,inf
44365,50,9,59,0,inf
44366,58,7,65,0,inf
44367,57,11,68,0,inf
44368,53,9,62,0,inf
44369,63,9,72,0,inf
44370,64,5,69,0,inf
44371,50,10,60,0,inf
44372,64,5,69,0,inf
44373,57,11,68,0,inf
44374,61,13,74,0,inf
44375,64,5,69,1,2.0556298380763423
44376,52,9,61,0,inf
44377,57,10,67,0,inf
44378,65,12,77,0,inf
44379,64,11,75,0,inf
44380,59,8,67,0,inf
44381,58,13,71,0,inf
44382,55,11,66,0,inf
44383,66,11,77,0,inf
44384,56,7,63,0,inf
44385,58,7,65,0,inf
44386,55,10,65,0,inf
44387,67,5,72,0,inf
44388,55,8,63,0,inf
44389,56,10,66,0,inf
44390,66,13,79,0,inf
44391,51,9,60,0,inf
44392,65,6,71,0,inf
44393,50,12,62,0,inf
44394,53,5,58,0,inf
44395,63,5,68,1,4.276171228547412
44396,58,11,69,0,inf
44397,65,9,74,0,inf
44398,56,7,63,0,inf
44399,60,11,71,0,inf
44400,63,9,72,0,inf
44401,52,8,60,0,inf
44402,60,11,71,0,inf
44403,61,7,68,0,inf
44404,60,7,67,0,inf
44405,51,8,59,0,inf
44406,54,7,61,0,inf
44407,50,10,60,0,inf
44408,67,6,73,0,inf
44409,65,8,73,0,inf
44410,55,9,64,0,inf
44411,66,6,72,0,inf
44412,57,8,65,0,inf
44413,52,8,60,0,inf
44414,51,8,59,0,inf
44415,51,5,56,0,inf
44416,62,10,72,0,inf
44417,58,10,68,0,inf
44418,57,6,63,0,inf
44419,57,6,63,0,inf
44420,63,5,68,0,inf
44421,58,12,70,0,inf
44422,62,5,67,0,inf
44423,66,7,73,0,inf
44424,63,12,75,0,inf
44425,58,5,63,0,inf
44426,54,13,67,0,inf
44427,65,10,75,0,inf
44428,61,12,73,0,inf
44429,55,7,62,0,inf
44430,65,12,77,1,8.783008730612707
44431,63,13,76,0,inf
44432,50,8,58,0,inf
44433,54,7,61,0,inf
44434,54,10,64,0,inf
44435,52,8,60,0,inf
44436,67,5,72,0,inf
44437,67,7,74,0,inf
44438,57,8,65,0,inf
44439,66,6,72,0,inf
44440,54,10,64,0,inf
44441,64,8,72,0,inf
44442,61,6,67,0,inf
44443,63,11,74,0,inf
44444,64,9,73,0,inf
44445,60,13,73,0,inf
44446,59,6,65,0,inf
44447,59,12,71,0,inf
44448,53,12,65,0,inf
44449,66,10,76,0,inf
44450,53,11,64,0,inf
44451,62,13,75,0,inf
44452,63,8,71,0,inf
44453,53,12,65,0,inf
44454,51,5,56,0,inf
44455,54,6,60,0,inf
44456,51,12,63,0,inf
44457,57,12,69,0,inf
44458,51,12,63,0,inf
44459,62,12,74,0,inf
44460,67,7,74,0,inf
44461,66,6,72,0,inf
44462,57,8,65,0,inf
44463,59,7,66,0,inf
44464,54,13,67,0,inf
44465,59,9,68,0,inf
44466,53,10,63,0,inf
44467,50,8,58,0,inf
44468,57,13,70,0,inf
44469,53,8,61,0,inf
44470,66,12,78,0,inf
44471,53,13,66,0,inf
44472,56,10,66,0,inf
44473,52,7,59,0,inf
44474,65,11,76,1,0.9550826566081554
44475,58,7,65,0,inf
44476,52,6,58,0,inf
44477,53,5,58,0,inf
44478,59,11,70,0,inf
44479,65,13,78,0,inf
44480,56,11,67,0,inf
44481,52,8,60,0,inf
44482,60,8,68,0,inf
44483,61,12,73,0,inf
44484,61,5,66,0,inf
44485,57,9,66,0,inf
44486,50,6,56,0,inf
44487,64,8,72,0,inf
44488,57,13,70,0,inf
44489,60,7,67,0,inf
44490,61,13,74,0,inf
44491,62,7,69,0,inf
44492,62,12,74,0,inf
44493,50,7,57,0,inf
44494,56,12,68,0,inf
44495,54,5,59,0,inf
44496,60,6,66,0,inf
44497,64,7,71,0,inf
44498,50,13,63,0,inf
44499,51,9,60,0,inf
44500,55,9,64,0,inf
44501,55,5,60,0,inf
44502,61,13,74,0,inf
44503,55,7,62,0,inf
44504,57,13,70,0,inf
44505,59,10,69,0,inf
44506,50,6,56,0,inf
44507,59,9,68,0,inf
44508,65,6,71,0,inf
44509,60,13,73,0,inf
44510,65,8,73,0,inf
44511,66,8,74,0,inf
44512,64,12,76,0,inf
44513,50,9,59,0,inf
44514,54,7,61,0,inf
44515,63,7,70,0,inf
44516,67,13,80,0,inf
44517,51,11,62,0,inf
44518,58,10,68,0,inf
44519,59,8,67,0,inf
44520,66,12,78,0,inf
44521,52,13,65,0,inf
44522,62,7,69,0,inf
44523,57,11,68,0,inf
44524,50,6,56,0,inf
44525,65,8,73,0,inf
44526,51,7,58,0,inf
44527,52,7,59,0,inf
44528,61,11,72,0,inf
44529,58,6,64,0,inf
44530,59,13,72,0,inf
44531,52,11,63,1,2.3786353403835037
44532,53,6,59,0,inf
44533,62,12,74,0,inf
44534,52,10,62,0,inf
44535,53,5,58,0,inf
44536,57,5,62,0,inf
44537,62,9,71,0,inf
44538,64,11,75,0,inf
44539,58,12,70,0,inf
44540,52,10,62,0,inf
44541,62,10,72,0,inf
44542,59,12,71,0,inf
44543,57,13,70,0,inf
44544,53,12,65,0,inf
44545,63,6,69,0,inf
44546,65,11,76,0,inf
44547,65,13,78,0,inf
44548,55,6,61,0,inf
44549,55,9,64,0,inf
44550,66,11,77,0,inf
44551,52,13,65,0,inf
44552,64,13,77,0,inf
44553,61,5,66,0,inf
44554,64,5,69,0,inf
44555,60,12,72,1,3.7630051378385403
44556,55,10,65,0,inf
44557,55,7,62,0,inf
44558,55,6,61,0,inf
44559,53,10,63,0,inf
44560,59,9,68,0,inf
44561,65,9,74,0,inf
44562,58,7,65,0,inf
44563,56,11,67,0,inf
44564,56,5,61,0,inf
44565,52,12,64,0,inf
44566,57,5,62,0,inf
44567,65,9,74,0,inf
44568,56,12,68,0,inf
44569,64,11,75,0,inf
44570,60,11,71,0,inf
44571,62,11,73,0,inf
44572,57,5,62,0,inf
44573,61,7,68,0,inf
44574,52,12,64,0,inf
44575,56,8,64,0,inf
44576,58,5,63,0,inf
44577,50,9,59,0,inf
44578,56,12,68,0,inf
44579,51,5,56,0,inf
44580,66,6,72,0,inf
44581,52,13,65,0,inf
44582,64,10,74,0,inf
44583,63,9,72,0,inf
44584,63,9,72,0,inf
44585,53,8,61,0,inf
44586,60,7,67,0,inf
44587,64,7,71,0,inf
44588,58,8,66,0,inf
44589,59,11,70,0,inf
44590,56,13,69,0,inf
44591,65,10,75,0,inf
44592,52,10,62,0,inf
44593,63,6,69,0,inf
44594,60,11,71,0,inf
44595,65,8,73,0,inf
44596,51,12,63,0,inf
44597,55,10,65,0,inf
44598,59,13,72,0,inf
44599,59,7,66,0,inf
44600,66,8,74,0,inf
44601,56,6,62,0,inf
44602,56,12,68,0,inf
44603,57,9,66,0,inf
44604,51,5,56,0,inf
44605,56,9,65,0,inf
44606,61,10,71,0,inf
44607,61,10,71,0,inf
44608,53,13,66,1,2.9634175051910603
44609,61,6,67,0,inf
44610,55,5,60,0,inf
44611,64,7,71,0,inf
44612,56,12,68,0,inf
44613,50,11,61,0,inf
44614,55,7,62,0,inf
44615,53,5,58,0,inf
44616,65,11,76,0,inf
44617,65,5,70,0,inf
44618,59,5,64,0,inf
44619,54,9,63,0,inf
44620,65,6,71,0,inf
44621,66,6,72,0,inf
44622,65,8,73,0,inf
44623,63,9,72,0,inf
44624,51,9,60,0,inf
44625,64,8,72,0,inf
44626,50,9,59,0,inf
44627,50,5,55,0,inf
44628,58,7,65,0,inf
44629,50,11,61,0,inf
44630,52,10,62,0,inf
44631,58,13,71,0,inf
44632,63,12,75,1,1.2498695078525657
44633,51,9,60,0,inf
44634,52,9,61,0,inf
44635,62,13,75,0,inf
44636,58,6,64,0,inf
44637,65,5,70,0,inf
44638,57,12,69,1,8.76147029034179
44639,66,13,79,0,inf
44640,54,9,63,0,inf
44641,59,5,64,0,inf
44642,65,10,75,0,inf
44643,59,5,64,0,inf
44644,66,7,73,0,inf
44645,55,9,64,0,inf
44646,63,10,73,0,inf
44647,50,7,57,0,inf
44648,60,7,67,0,inf
44649,53,12,65,0,inf
44650,54,11,65,0,inf
44651,57,8,65,0,inf
44652,54,11,65,0,inf
44653,54,9,63,0,inf
44654,54,9,63,0,inf
44655,63,11,74,0,inf
44656,63,8,71,0,inf
44657,54,11,65,0,inf
44658,61,9,70,1,6.528536898053773
44659,59,5,64,0,inf
44660,54,6,60,0,inf
44661,56,9,65,0,inf
44662,58,12,70,0,inf
44663,61,11,72,0,inf
44664,59,6,65,0,inf
44665,61,11,72,0,inf
44666,62,13,75,0,inf
44667,50,10,60,0,inf
44668,62,13,75,0,inf
44669,59,9,68,0,inf
44670,62,13,75,0,inf
44671,58,13,71,0,inf
44672,64,13,77,1,7.541647834103003
44673,66,13,79,0,inf
44674,62,8,70,0,inf
44675,52,9,61,0,inf
44676,63,8,71,0,inf
44677,67,6,73,0,inf
44678,57,9,66,0,inf
44679,52,6,58,0,inf
44680,63,6,69,0,inf
44681,54,6,60,0,inf
44682,50,7,57,0,inf
44683,57,10,67,0,inf
44684,60,8,68,0,inf
44685,55,13,68,0,inf
44686,59,10,69,0,inf
44687,60,5,65,0,inf
44688,55,7,62,0,inf
44689,61,13,74,0,inf
44690,64,13,77,0,inf
44691,51,9,60,0,inf
44692,64,11,75,0,inf
44693,52,11,63,0,inf
44694,50,9,59,0,inf
44695,50,5,55,0,inf
44696,61,8,69,0,inf
44697,65,9,74,0,inf
44698,61,6,67,0,inf
44699,58,5,63,0,inf
44700,59,12,71,0,inf
44701,66,10,76,0,inf
44702,62,6,68,0,inf
44703,66,7,73,0,inf
44704,67,10,77,0,inf
44705,52,7,59,0,inf
44706,56,6,62,0,inf
44707,62,13,75,0,inf
44708,64,11,75,0,inf
44709,57,10,67,0,inf
44710,51,6,57,0,inf
44711,55,9,64,0,inf
44712,62,12,74,0,inf
44713,55,11,66,0,inf
44714,59,11,70,0,inf
44715,66,5,71,0,inf
44716,52,5,57,0,inf
44717,57,12,69,0,inf
44718,62,11,73,0,inf
44719,63,11,74,0,inf
44720,67,7,74,0,inf
44721,67,10,77,0,inf
44722,55,9,64,0,inf
44723,50,5,55,0,inf
44724,50,5,55,0,inf
44725,67,9,76,0,inf
44726,61,8,69,0,inf
44727,54,7,61,0,inf
44728,52,9,61,0,inf
44729,56,10,66,0,inf
44730,63,10,73,0,inf
44731,65,7,72,0,inf
44732,52,12,64,0,inf
44733,65,11,76,0,inf
44734,59,12,71,0,inf
44735,51,5,56,0,inf
44736,66,12,78,0,inf
44737,64,9,73,0,inf
44738,51,6,57,0,inf
44739,67,13,80,0,inf
44740,54,10,64,0,inf
44741,64,5,69,0,inf
44742,52,13,65,0,inf
44743,65,11,76,0,inf
44744,62,5,67,0,inf
44745,58,11,69,0,inf
44746,55,6,61,0,inf
44747,65,13,78,0,inf
44748,58,13,71,1,9.567521129425117
44749,66,11,77,0,inf
44750,65,12,77,0,inf
44751,66,6,72,0,inf
44752,57,10,67,0,inf
44753,53,13,66,0,inf
44754,63,10,73,0,inf
44755,57,13,70,0,inf
44756,60,11,71,0,inf
44757,56,8,64,0,inf
44758,65,13,78,0,inf
44759,62,5,67,0,inf
44760,63,5,68,0,inf
44761,60,13,73,0,inf
44762,59,7,66,0,inf
44763,66,5,71,0,inf
44764,61,5,66,0,inf
44765,65,7,72,0,inf
44766,53,9,62,0,inf
44767,54,12,66,0,inf
44768,65,7,72,0,inf
44769,57,9,66,0,inf
44770,53,11,64,0,inf
44771,56,11,67,0,inf
44772,56,10,66,0,inf
44773,59,10,69,0,inf
44774,62,12,74,0,inf
44775,53,5,58,0,inf
44776,55,6,61,0,inf
44777,58,7,65,0,inf
44778,50,13,63,0,inf
44779,51,8,59,0,inf
44780,60,5,65,0,inf
44781,52,11,63,0,inf
44782,57,10,67,0,inf
44783,50,8,58,0,inf
44784,67,11,78,0,inf
44785,67,7,74,0,inf
44786,54,8,62,0,inf
44787,62,12,74,0,inf
44788,65,9,74,0,inf
44789,56,7,63,0,inf
44790,53,9,62,0,inf
44791,55,10,65,0,inf
44792,65,13,78,0,inf
44793,65,11,76,0,inf
44794,67,11,78,0,inf
44795,54,5,59,0,inf
44796,65,13,78,0,inf
44797,62,7,69,0,inf
44798,65,11,76,0,inf
44799,53,11,64,0,inf
44800,50,7,57,0,inf
44801,62,10,72,0,inf
44802,63,9,72,0,inf
44803,51,12,63,0,inf
44804,52,8,60,0,inf
44805,62,11,73,0,inf
44806,55,13,68,0,inf
44807,65,11,76,0,inf
44808,58,13,71,0,inf
44809,67,12,79,0,inf
44810,61,9,70,0,inf
44811,61,10,71,1,0.49732236100982163
44812,65,13,78,0,inf
44813,65,5,70,0,inf
44814,51,7,58,0,inf
44815,61,8,69,0,inf
44816,52,12,64,1,8.124212793319685
44817,66,6,72,0,inf
44818,66,12,78,0,inf
44819,53,5,58,1,2.2278805408401254
44820,66,12,78,0,inf
44821,66,10,76,1,4.412076346587213
44822,58,10,68,0,inf
44823,66,7,73,0,inf
44824,53,8,61,0,inf
44825,57,12,69,0,inf
44826,53,12,65,0,inf
44827,61,11,72,0,inf
44828,67,10,77,0,inf
44829,67,7,74,0,inf
44830,54,9,63,0,inf
44831,57,12,69,0,inf
44832,62,5,67,0,inf
44833,60,7,67,0,inf
44834,62,5,67,0,inf
44835,60,7,67,0,inf
44836,67,10,77,0,inf
44837,57,13,70,0,inf
44838,62,10,72,0,inf
44839,53,6,59,0,inf
44840,55,8,63,0,inf
44841,56,5,61,0,inf
44842,55,6,61,0,inf
44843,57,13,70,0,inf
44844,65,10,75,0,inf
44845,60,5,65,0,inf
44846,65,7,72,0,inf
44847,59,5,64,0,inf
44848,50,11,61,1,10.865347676783593
44849,62,7,69,0,inf
44850,60,7,67,0,inf
44851,61,11,72,0,inf
44852,53,5,58,0,inf
44853,62,12,74,0,inf
44854,62,8,70,0,inf
44855,56,10,66,0,inf
44856,61,9,70,0,inf
44857,50,9,59,0,inf
44858,55,9,64,0,inf
44859,63,5,68,0,inf
44860,57,9,66,0,inf
44861,67,11,78,0,inf
44862,50,12,62,0,inf
44863,56,9,65,0,inf
44864,63,10,73,0,inf
44865,54,8,62,0,inf
44866,57,6,63,0,inf
44867,65,9,74,0,inf
44868,65,6,71,0,inf
44869,62,5,67,0,inf
44870,52,11,63,0,inf
44871,62,12,74,0,inf
44872,52,10,62,0,inf
44873,57,9,66,0,inf
44874,50,12,62,0,inf
44875,67,12,79,0,inf
44876,61,7,68,0,inf
44877,63,9,72,0,inf
44878,58,5,63,0,inf
44879,51,5,56,0,inf
44880,64,10,74,0,inf
44881,62,12,74,0,inf
44882,63,6,69,0,inf
44883,65,13,78,0,inf
44884,55,6,61,0,inf
44885,57,5,62,0,inf
44886,56,8,64,0,inf
44887,64,9,73,0,inf
44888,60,5,65,0,inf
44889,67,12,79,0,inf
44890,60,10,70,0,inf
44891,50,12,62,0,inf
44892,62,10,72,0,inf
44893,62,6,68,0,inf
44894,58,9,67,0,inf
44895,51,13,64,0,inf
44896,56,11,67,0,inf
44897,63,11,74,0,inf
44898,57,6,63,0,inf
44899,64,7,71,1,5.0503328547823685
44900,51,9,60,0,inf
44901,67,11,78,0,inf
44902,59,6,65,0,inf
44903,65,12,77,0,inf
44904,55,13,68,1,3.0302305366985465
44905,67,6,73,0,inf
44906,54,12,66,0,inf
44907,60,6,66,0,inf
44908,50,6,56,0,inf
44909,54,7,61,0,inf
44910,64,12,76,0,inf
44911,54,5,59,0,inf
44912,56,13,69,0,inf
44913,55,12,67,0,inf
44914,58,7,65,0,inf
44915,64,8,72,0,inf
44916,62,5,67,0,inf
44917,66,12,78,0,inf
44918,51,12,63,0,inf
44919,63,13,76,0,inf
44920,57,12,69,0,inf
44921,52,9,61,0,inf
44922,55,9,64,0,inf
44923,57,12,69,0,inf
44924,60,9,69,0,inf
44925,67,11,78,0,inf
44926,67,6,73,0,inf
44927,64,8,72,0,inf
44928,67,7,74,0,inf
44929,58,13,71,0,inf
44930,61,12,73,0,inf
44931,57,5,62,0,inf
44932,57,12,69,0,inf
44933,56,9,65,0,inf
44934,60,6,66,0,inf
44935,52,5,57,0,inf
44936,55,5,60,0,inf
44937,66,6,72,0,inf
44938,63,7,70,0,inf
44939,64,12,76,0,inf
44940,54,10,64,0,inf
44941,55,12,67,0,inf
44942,57,5,62,0,inf
44943,61,12,73,0,inf
44944,55,13,68,0,inf
44945,58,13,71,0,inf
44946,65,11,76,0,inf
44947,63,10,73,0,inf
44948,62,9,71,0,inf
44949,59,11,70,0,inf
44950,64,5,69,0,inf
44951,51,11,62,0,inf
44952,57,11,68,0,inf
44953,61,7,68,0,inf
44954,50,12,62,0,inf
44955,64,9,73,0,inf
44956,67,10,77,0,inf
44957,63,7,70,0,inf
44958,53,5,58,0,inf
44959,59,8,67,0,inf
44960,59,5,64,0,inf
44961,54,7,61,0,inf
44962,66,13,79,0,inf
44963,60,13,73,0,inf
44964,57,6,63,0,inf
44965,53,9,62,0,inf
44966,58,6,64,0,inf
44967,51,5,56,0,inf
44968,51,12,63,0,inf
44969,60,9,69,0,inf
44970,66,11,77,0,inf
44971,64,9,73,1,2.807360219464556
44972,58,8,66,0,inf
44973,67,11,78,0,inf
44974,63,8,71,0,inf
44975,57,5,62,0,inf
44976,66,8,74,0,inf
44977,65,11,76,0,inf
44978,53,10,63,0,inf
44979,56,13,69,0,inf
44980,52,11,63,0,inf
44981,55,8,63,0,inf
44982,62,8,70,0,inf
44983,62,8,70,0,inf
44984,60,11,71,0,inf
44985,61,10,71,0,inf
44986,58,11,69,0,inf
44987,64,13,77,0,inf
44988,63,8,71,0,inf
44989,63,6,69,0,inf
44990,66,6,72,0,inf
44991,57,8,65,0,inf
44992,54,5,59,0,inf
44993,56,12,68,0,inf
44994,50,6,56,0,inf
44995,55,9,64,0,inf
44996,61,10,71,0,inf
44997,65,9,74,0,inf
44998,54,11,65,0,inf
44999,56,13,69,0,inf
45000,60,10,70,0,inf
45001,65,8,73,0,inf
45002,55,7,62,0,inf
45003,63,10,73,0,inf
45004,59,5,64,0,inf
45005,59,13,72,0,inf
45006,66,13,79,0,inf
45007,63,11,74,0,inf
45008,55,5,60,0,inf
45009,57,7,64,0,inf
45010,63,6,69,0,inf
45011,50,5,55,0,inf
45012,60,11,71,0,inf
45013,65,8,73,0,inf
45014,64,6,70,0,inf
45015,67,5,72,0,inf
45016,55,13,68,0,inf
45017,65,7,72,0,inf
45018,51,7,58,0,inf
45019,52,10,62,0,inf
45020,62,13,75,0,inf
45021,50,9,59,0,inf
45022,53,13,66,0,inf
45023,57,12,69,0,inf
45024,59,5,64,0,inf
45025,61,11,72,0,inf
45026,67,11,78,0,inf
45027,58,11,69,0,inf
45028,56,11,67,0,inf
45029,64,9,73,0,inf
45030,50,12,62,0,inf
45031,58,8,66,0,inf
45032,56,10,66,0,inf
45033,59,9,68,0,inf
45034,58,8,66,0,inf
45035,56,13,69,0,inf
45036,58,13,71,0,inf
45037,51,10,61,0,inf
45038,62,13,75,0,inf
45039,55,7,62,0,inf
45040,51,10,61,0,inf
45041,56,11,67,0,inf
45042,54,7,61,0,inf
45043,55,6,61,0,inf
45044,65,12,77,0,inf
45045,50,6,56,0,inf
45046,63,12,75,0,inf
45047,65,8,73,0,inf
45048,57,6,63,0,inf
45049,65,12,77,0,inf
45050,50,6,56,0,inf
45051,55,10,65,0,inf
45052,57,7,64,0,inf
45053,65,10,75,0,inf
45054,55,12,67,0,inf
45055,66,11,77,0,inf
45056,63,12,75,0,inf
45057,54,13,67,0,inf
45058,59,11,70,0,inf
45059,66,5,71,0,inf
45060,55,8,63,0,inf
45061,50,9,59,0,inf
45062,58,9,67,0,inf
45063,64,13,77,0,inf
45064,57,13,70,0,inf
45065,62,6,68,0,inf
45066,59,11,70,0,inf
45067,66,7,73,0,inf
45068,60,9,69,0,inf
45069,58,5,63,0,inf
45070,64,7,71,0,inf
45071,52,8,60,0,inf
45072,57,5,62,0,inf
45073,58,6,64,0,inf
45074,52,10,62,0,inf
45075,54,8,62,0,inf
45076,65,11,76,0,inf
45077,63,11,74,1,6.533507640591395
45078,62,6,68,0,inf
45079,54,5,59,0,inf
45080,57,6,63,0,inf
45081,56,13,69,0,inf
45082,60,13,73,0,inf
45083,61,8,69,0,inf
45084,52,7,59,0,inf
45085,63,5,68,0,inf
45086,51,11,62,0,inf
45087,57,9,66,0,inf
45088,66,5,71,0,inf
45089,55,6,61,0,inf
45090,53,10,63,0,inf
45091,59,5,64,0,inf
45092,63,6,69,0,inf
45093,52,13,65,0,inf
45094,56,13,69,0,inf
45095,54,6,60,0,inf
45096,51,5,56,0,inf
45097,53,6,59,0,inf
45098,66,5,71,0,inf
45099,51,7,58,0,inf
45100,63,7,70,0,inf
45101,65,9,74,0,inf
45102,66,9,75,0,inf
45103,53,6,59,0,inf
45104,57,6,63,0,inf
45105,52,8,60,0,inf
45106,56,5,61,0,inf
45107,51,5,56,0,inf
45108,50,8,58,1,2.6240422561796564
45109,58,12,70,0,inf
45110,53,12,65,0,inf
45111,66,8,74,0,inf
45112,50,5,55,0,inf
45113,63,13,76,0,inf
45114,58,10,68,0,inf
45115,60,12,72,0,inf
45116,57,12,69,0,inf
45117,65,7,72,0,inf
45118,59,13,72,0,inf
45119,63,5,68,0,inf
45120,60,10,70,1,4.822526346392806
45121,53,10,63,0,inf
45122,67,5,72,0,inf
45123,64,5,69,0,inf
45124,55,9,64,0,inf
45125,54,5,59,0,inf
45126,60,12,72,0,inf
45127,64,12,76,0,inf
45128,57,5,62,0,inf
45129,65,6,71,0,inf
45130,61,11,72,0,inf
45131,55,13,68,0,inf
45132,56,6,62,0,inf
45133,55,7,62,0,inf
45134,51,13,64,0,inf
45135,58,11,69,0,inf
45136,62,10,72,0,inf
45137,59,13,72,0,inf
45138,60,9,69,0,inf
45139,51,7,58,0,inf
45140,63,9,72,0,inf
45141,55,5,60,0,inf
45142,64,13,77,0,inf
45143,63,13,76,0,inf
45144,55,11,66,0,inf
45145,59,11,70,0,inf
45146,62,12,74,0,inf
45147,62,12,74,0,inf
45148,56,8,64,0,inf
45149,61,5,66,0,inf
45150,61,13,74,0,inf
45151,67,10,77,0,inf
45152,55,10,65,0,inf
45153,50,6,56,0,inf
45154,58,12,70,0,inf
45155,55,5,60,0,inf
45156,61,12,73,0,inf
45157,67,7,74,0,inf
45158,60,11,71,0,inf
45159,66,10,76,0,inf
45160,53,6,59,0,inf
45161,50,7,57,0,inf
45162,51,11,62,0,inf
45163,63,5,68,0,inf
45164,57,9,66,0,inf
45165,65,6,71,0,inf
45166,56,12,68,0,inf
45167,61,13,74,0,inf
45168,65,11,76,0,inf
45169,51,5,56,0,inf
45170,66,13,79,0,inf
45171,64,8,72,0,inf
45172,56,12,68,0,inf
45173,57,12,69,0,inf
45174,56,8,64,0,inf
45175,67,11,78,0,inf
45176,66,12,78,0,inf
45177,50,6,56,0,inf
45178,59,9,68,0,inf
45179,64,11,75,0,inf
45180,51,8,59,0,inf
45181,57,10,67,0,inf
45182,60,7,67,0,inf
45183,50,10,60,0,inf
45184,57,12,69,0,inf
45185,51,12,63,0,inf
45186,56,13,69,0,inf
45187,63,9,72,0,inf
45188,66,13,79,0,inf
45189,50,10,60,0,inf
45190,55,10,65,0,inf
45191,61,9,70,0,inf
45192,58,5,63,0,inf
45193,53,9,62,0,inf
45194,55,9,64,0,inf
45195,52,6,58,0,inf
45196,55,6,61,0,inf
45197,51,12,63,0,inf
45198,58,8,66,0,inf
45199,56,12,68,0,inf
45200,52,6,58,0,inf
45201,59,8,67,0,inf
45202,64,13,77,0,inf
45203,57,13,70,0,inf
45204,64,12,76,0,inf
45205,62,7,69,0,inf
45206,55,9,64,0,inf
45207,64,12,76,0,inf
45208,50,7,57,0,inf
45209,60,8,68,0,inf
45210,66,8,74,0,inf
45211,51,9,60,0,inf
45212,54,7,61,0,inf
45213,55,6,61,0,inf
45214,61,6,67,0,inf
45215,61,6,67,0,inf
45216,66,13,79,0,inf
45217,51,6,57,0,inf
45218,61,10,71,0,inf
45219,60,8,68,0,inf
45220,50,13,63,0,inf
45221,56,7,63,1,6.71206455993925
45222,64,9,73,0,inf
45223,64,9,73,0,inf
45224,63,11,74,0,inf
45225,63,10,73,0,inf
45226,52,13,65,0,inf
45227,58,12,70,0,inf
45228,65,9,74,0,inf
45229,61,5,66,0,inf
45230,63,10,73,1,3.008792091843361
45231,59,12,71,0,inf
45232,65,9,74,0,inf
45233,57,6,63,0,inf
45234,54,13,67,0,inf
45235,58,10,68,0,inf
45236,64,8,72,0,inf
45237,57,13,70,0,inf
45238,59,5,64,0,inf
45239,53,10,63,0,inf
45240,61,12,73,0,inf
45241,50,12,62,0,inf
45242,66,10,76,0,inf
45243,52,8,60,0,inf
45244,51,13,64,0,inf
45245,60,10,70,0,inf
45246,62,6,68,0,inf
45247,51,11,62,0,inf
45248,64,5,69,0,inf
45249,59,10,69,0,inf
45250,61,13,74,0,inf
45251,61,5,66,0,inf
45252,64,11,75,0,inf
45253,67,11,78,0,inf
45254,65,7,72,0,inf
45255,57,7,64,0,inf
45256,56,11,67,0,inf
45257,60,11,71,0,inf
45258,58,7,65,0,inf
45259,67,7,74,0,inf
45260,55,6,61,0,inf
45261,57,12,69,0,inf
45262,61,8,69,0,inf
45263,58,12,70,0,inf
45264,60,13,73,1,6.3040883043872356
45265,58,11,69,0,inf
45266,57,6,63,0,inf
45267,66,9,75,0,inf
45268,63,13,76,0,inf
45269,66,6,72,0,inf
45270,58,13,71,0,inf
45271,54,11,65,0,inf
45272,63,6,69,0,inf
45273,60,11,71,0,inf
45274,50,8,58,0,inf
45275,52,13,65,0,inf
45276,55,10,65,0,inf
45277,54,6,60,0,inf
45278,65,10,75,0,inf
45279,54,12,66,0,inf
45280,64,5,69,0,inf
45281,65,12,77,0,inf
45282,60,9,69,0,inf
45283,59,9,68,0,inf
45284,53,11,64,0,inf
45285,52,12,64,0,inf
45286,59,7,66,0,inf
45287,52,9,61,0,inf
45288,64,9,73,0,inf
45289,61,7,68,0,inf
45290,51,7,58,0,inf
45291,56,10,66,0,inf
45292,60,7,67,0,inf
45293,50,7,57,0,inf
45294,50,8,58,0,inf
45295,61,7,68,0,inf
45296,56,10,66,0,inf
45297,58,9,67,0,inf
45298,61,7,68,0,inf
45299,56,11,67,0,inf
45300,60,11,71,0,inf
45301,63,5,68,0,inf
45302,54,13,67,0,inf
45303,67,11,78,0,inf
45304,57,5,62,0,inf
45305,56,12,68,0,inf
45306,63,10,73,0,inf
45307,61,5,66,0,inf
45308,59,7,66,0,inf
45309,62,11,73,0,inf
45310,65,10,75,0,inf
45311,57,5,62,0,inf
45312,57,8,65,0,inf
45313,57,9,66,0,inf
45314,60,10,70,0,inf
45315,50,5,55,0,inf
45316,65,8,73,0,inf
45317,51,11,62,0,inf
45318,61,13,74,0,inf
45319,66,7,73,0,inf
45320,63,6,69,0,inf
45321,63,5,68,0,inf
45322,54,10,64,0,inf
45323,58,11,69,0,inf
45324,52,7,59,0,inf
45325,66,10,76,0,inf
45326,65,5,70,1,0.03025457038371826
45327,63,7,70,0,inf
45328,50,10,60,0,inf
45329,50,11,61,0,inf
45330,59,7,66,0,inf
45331,67,6,73,0,inf
45332,57,12,69,0,inf
45333,67,6,73,0,inf
45334,51,10,61,0,inf
45335,64,7,71,0,inf
45336,60,7,67,0,inf
45337,67,10,77,1,3.0036609649989288
45338,59,11,70,1,3.5782199319926775
45339,62,9,71,0,inf
45340,60,6,66,0,inf
45341,59,10,69,0,inf
45342,57,6,63,0,inf
45343,65,10,75,0,inf
45344,62,10,72,1,1.1488719291524134
45345,58,12,70,0,inf
45346,67,8,75,0,inf
45347,64,12,76,0,inf
45348,52,8,60,0,inf
45349,67,8,75,0,inf
45350,67,13,80,0,inf
45351,55,7,62,0,inf
45352,61,8,69,0,inf
45353,62,7,69,0,inf
45354,61,8,69,0,inf
45355,65,5,70,0,inf
45356,53,7,60,0,inf
45357,65,12,77,0,inf
45358,63,13,76,0,inf
45359,57,9,66,0,inf
45360,53,11,64,0,inf
45361,67,12,79,0,inf
45362,54,10,64,0,inf
45363,61,13,74,0,inf
45364,66,12,78,0,inf
45365,60,11,71,0,inf
45366,63,8,71,0,inf
45367,50,5,55,1,3.466445018066757
45368,56,6,62,1,2.4039325413569443
45369,58,7,65,0,inf
45370,50,5,55,0,inf
45371,55,6,61,0,inf
45372,51,8,59,0,inf
45373,53,13,66,0,inf
45374,65,6,71,0,inf
45375,51,8,59,0,inf
45376,55,7,62,0,inf
45377,51,8,59,0,inf
45378,50,13,63,0,inf
45379,67,10,77,0,inf
45380,65,6,71,0,inf
45381,58,9,67,0,inf
45382,52,11,63,0,inf
45383,54,12,66,0,inf
45384,66,13,79,1,6.201590369006951
45385,51,8,59,0,inf
45386,62,7,69,0,inf
45387,60,5,65,0,inf
45388,63,12,75,0,inf
45389,55,9,64,0,inf
45390,56,6,62,0,inf
45391,60,5,65,0,inf
45392,60,12,72,0,inf
45393,65,8,73,0,inf
45394,52,11,63,0,inf
45395,58,5,63,0,inf
45396,61,11,72,0,inf
45397,64,5,69,0,inf
45398,57,13,70,0,inf
45399,62,7,69,0,inf
45400,55,9,64,0,inf
45401,61,8,69,0,inf
45402,58,8,66,0,inf
45403,55,12,67,0,inf
45404,57,9,66,0,inf
45405,61,5,66,0,inf
45406,58,8,66,0,inf
45407,53,8,61,0,inf
45408,62,11,73,0,inf
45409,60,7,67,0,inf
45410,65,9,74,0,inf
45411,51,5,56,0,inf
45412,63,11,74,0,inf
45413,61,10,71,0,inf
45414,52,12,64,0,inf
45415,67,12,79,0,inf
45416,50,6,56,0,inf
45417,59,9,68,0,inf
45418,60,8,68,0,inf
45419,52,7,59,0,inf
45420,66,8,74,0,inf
45421,63,12,75,0,inf
45422,57,11,68,0,inf
45423,59,6,65,0,inf
45424,65,10,75,0,inf
45425,67,8,75,0,inf
45426,60,5,65,0,inf
45427,57,6,63,0,inf
45428,59,6,65,0,inf
45429,61,12,73,0,inf
45430,62,6,68,0,inf
45431,64,7,71,0,inf
45432,58,6,64,0,inf
45433,64,8,72,0,inf
45434,56,10,66,0,inf
45435,52,9,61,0,inf
45436,57,7,64,0,inf
45437,67,8,75,0,inf
45438,62,13,75,1,1.9045129346857834
45439,57,11,68,0,inf
45440,65,5,70,0,inf
45441,58,5,63,0,inf
45442,67,13,80,0,inf
45443,62,10,72,0,inf
45444,53,5,58,0,inf
45445,57,13,70,0,inf
45446,66,11,77,0,inf
45447,51,7,58,0,inf
45448,55,12,67,0,inf
45449,65,6,71,0,inf
45450,60,12,72,1,3.771807206822885
45451,64,7,71,0,inf
45452,57,13,70,0,inf
45453,51,10,61,0,inf
45454,53,9,62,0,inf
45455,64,5,69,0,inf
45456,62,5,67,0,inf
45457,63,7,70,0,inf
45458,62,8,70,0,inf
45459,62,7,69,1,5.186702835899254
45460,65,9,74,0,inf
45461,65,10,75,1,6.958186374216211
45462,50,11,61,0,inf
45463,56,8,64,0,inf
45464,53,5,58,0,inf
45465,50,7,57,0,inf
45466,57,10,67,0,inf
45467,65,10,75,1,3.03394038926659
45468,52,9,61,0,inf
45469,57,10,67,0,inf
45470,61,7,68,0,inf
45471,58,9,67,0,inf
45472,55,9,64,0,inf
45473,67,10,77,0,inf
45474,55,8,63,0,inf
45475,60,6,66,0,inf
45476,65,6,71,0,inf
45477,56,11,67,0,inf
45478,50,5,55,0,inf
45479,56,9,65,0,inf
45480,65,11,76,0,inf
45481,66,13,79,0,inf
45482,58,12,70,1,10.694616456994538
45483,54,12,66,0,inf
45484,50,11,61,0,inf
45485,57,10,67,0,inf
45486,51,9,60,0,inf
45487,53,12,65,0,inf
45488,56,7,63,0,inf
45489,55,8,63,0,inf
45490,50,5,55,0,inf
45491,57,5,62,0,inf
45492,54,7,61,0,inf
45493,63,11,74,0,inf
45494,56,8,64,0,inf
45495,62,8,70,0,inf
45496,64,11,75,0,inf
45497,65,7,72,1,3.071353981348949
45498,50,11,61,0,inf
45499,67,12,79,0,inf
45500,51,9,60,0,inf
45501,57,13,70,0,inf
45502,52,13,65,0,inf
45503,59,11,70,0,inf
45504,59,9,68,0,inf
45505,51,6,57,0,inf
45506,56,6,62,0,inf
45507,51,9,60,0,inf
45508,58,13,71,0,inf
45509,59,10,69,0,inf
45510,59,9,68,0,inf
45511,62,7,69,0,inf
45512,65,9,74,0,inf
45513,50,9,59,0,inf
45514,52,13,65,0,inf
45515,61,7,68,0,inf
45516,64,6,70,0,inf
45517,59,7,66,0,inf
45518,62,13,75,0,inf
45519,58,9,67,0,inf
45520,57,8,65,0,inf
45521,60,8,68,0,inf
45522,62,12,74,0,inf
45523,51,7,58,0,inf
45524,58,10,68,0,inf
45525,51,5,56,0,inf
45526,53,8,61,0,inf
45527,59,10,69,0,inf
45528,65,5,70,0,inf
45529,58,9,67,0,inf
45530,58,11,69,0,inf
45531,61,9,70,0,inf
45532,65,5,70,0,inf
45533,64,10,74,0,inf
45534,60,12,72,0,inf
45535,61,12,73,0,inf
45536,61,13,74,0,inf
45537,51,7,58,0,inf
45538,61,8,69,0,inf
45539,52,11,63,0,inf
45540,53,11,64,0,inf
45541,65,13,78,0,inf
45542,66,7,73,0,inf
45543,66,5,71,0,inf
45544,59,7,66,0,inf
45545,50,7,57,0,inf
45546,51,7,58,0,inf
45547,54,12,66,0,inf
45548,59,7,66,0,inf
45549,62,5,67,0,inf
45550,54,12,66,0,inf
45551,58,11,69,0,inf
45552,61,11,72,0,inf
45553,59,11,70,0,inf
45554,54,5,59,0,inf
45555,51,10,61,0,inf
45556,51,7,58,0,inf
45557,56,6,62,0,inf
45558,58,5,63,0,inf
45559,64,13,77,0,inf
45560,63,11,74,0,inf
45561,52,11,63,0,inf
45562,59,12,71,0,inf
45563,50,10,60,0,inf
45564,58,11,69,0,inf
45565,62,9,71,0,inf
45566,51,11,62,0,inf
45567,50,13,63,0,inf
45568,61,9,70,0,inf
45569,54,6,60,0,inf
45570,59,12,71,0,inf
45571,61,11,72,0,inf
45572,61,9,70,0,inf
45573,63,11,74,0,inf
45574,65,10,75,0,inf
45575,56,11,67,0,inf
45576,58,11,69,0,inf
45577,52,6,58,0,inf
45578,60,11,71,0,inf
45579,55,9,64,0,inf
45580,64,8,72,0,inf
45581,55,10,65,0,inf
45582,66,9,75,0,inf
45583,64,9,73,0,inf
45584,61,10,71,1,5.830043412142885
45585,55,13,68,0,inf
45586,56,8,64,0,inf
45587,51,12,63,0,inf
45588,63,12,75,0,inf
45589,66,5,71,0,inf
45590,64,7,71,0,inf
45591,50,8,58,0,inf
45592,52,6,58,0,inf
45593,51,7,58,0,inf
45594,54,12,66,0,inf
45595,57,9,66,0,inf
45596,57,12,69,0,inf
45597,54,6,60,0,inf
45598,57,6,63,0,inf
45599,67,8,75,0,inf
45600,63,12,75,0,inf
45601,60,5,65,0,inf
45602,66,9,75,0,inf
45603,52,9,61,0,inf
45604,61,13,74,0,inf
45605,62,10,72,0,inf
45606,62,6,68,0,inf
45607,60,7,67,0,inf
45608,58,8,66,0,inf
45609,51,10,61,0,inf
45610,59,12,71,0,inf
45611,63,6,69,0,inf
45612,55,5,60,0,inf
45613,59,11,70,0,inf
45614,60,6,66,0,inf
45615,60,12,72,0,inf
45616,62,12,74,0,inf
45617,53,13,66,0,inf
45618,67,9,76,0,inf
45619,55,10,65,0,inf
45620,52,5,57,0,inf
45621,66,7,73,0,inf
45622,59,10,69,0,inf
45623,54,6,60,0,inf
45624,61,10,71,1,7.842769030044266
45625,66,7,73,0,inf
45626,50,13,63,1,8.567434805753393
45627,64,11,75,0,inf
45628,55,11,66,0,inf
45629,56,6,62,0,inf
45630,57,6,63,0,inf
45631,52,8,60,0,inf
45632,61,8,69,0,inf
45633,52,8,60,1,0.7100688321418644
45634,54,8,62,0,inf
45635,53,11,64,0,inf
45636,63,13,76,0,inf
45637,67,9,76,0,inf
45638,53,9,62,0,inf
45639,67,11,78,0,inf
45640,58,10,68,0,inf
45641,56,7,63,0,inf
45642,56,5,61,0,inf
45643,54,11,65,0,inf
45644,64,9,73,0,inf
45645,57,9,66,0,inf
45646,62,13,75,0,inf
45647,52,8,60,0,inf
45648,64,8,72,0,inf
45649,54,13,67,0,inf
45650,51,5,56,0,inf
45651,64,11,75,0,inf
45652,60,6,66,0,inf
45653,51,10,61,0,inf
45654,57,6,63,0,inf
45655,63,8,71,0,inf
45656,52,12,64,0,inf
45657,66,13,79,0,inf
45658,56,10,66,0,inf
45659,57,12,69,1,10.06279048034719
45660,52,6,58,0,inf
45661,64,5,69,0,inf
45662,53,7,60,1,2.971921486415809
45663,58,12,70,0,inf
45664,64,10,74,0,inf
45665,63,11,74,0,inf
45666,59,7,66,0,inf
45667,58,12,70,0,inf
45668,67,13,80,0,inf
45669,63,8,71,0,inf
45670,65,7,72,0,inf
45671,53,13,66,0,inf
45672,67,13,80,0,inf
45673,57,8,65,0,inf
45674,65,12,77,0,inf
45675,61,11,72,0,inf
45676,61,8,69,0,inf
45677,66,5,71,0,inf
45678,65,13,78,0,inf
45679,50,11,61,0,inf
45680,59,8,67,0,inf
45681,62,13,75,0,inf
45682,61,7,68,0,inf
45683,56,7,63,0,inf
45684,61,11,72,1,8.933725451793151
45685,53,13,66,0,inf
45686,53,10,63,0,inf
45687,62,5,67,0,inf
45688,63,6,69,1,2.221498881889829
45689,60,8,68,0,inf
45690,52,9,61,0,inf
45691,56,8,64,0,inf
45692,61,9,70,0,inf
45693,58,6,64,0,inf
45694,65,12,77,0,inf
45695,63,10,73,0,inf
45696,65,9,74,0,inf
45697,52,6,58,0,inf
45698,60,6,66,0,inf
45699,64,9,73,0,inf
45700,51,8,59,0,inf
45701,65,7,72,0,inf
45702,51,7,58,0,inf
45703,51,5,56,0,inf
45704,54,5,59,0,inf
45705,63,8,71,0,inf
45706,62,5,67,0,inf
45707,57,10,67,0,inf
45708,51,12,63,0,inf
45709,63,7,70,0,inf
45710,66,5,71,0,inf
45711,60,11,71,0,inf
45712,57,9,66,0,inf
45713,51,8,59,0,inf
45714,59,5,64,0,inf
45715,57,11,68,0,inf
45716,67,5,72,0,inf
45717,55,10,65,0,inf
45718,66,12,78,0,inf
45719,60,8,68,0,inf
45720,64,7,71,0,inf
45721,55,11,66,0,inf
45722,63,5,68,0,inf
45723,66,11,77,0,inf
45724,65,12,77,0,inf
45725,50,11,61,0,inf
45726,56,7,63,0,inf
45727,65,9,74,0,inf
45728,61,8,69,0,inf
45729,55,12,67,0,inf
45730,52,13,65,0,inf
45731,62,9,71,0,inf
45732,58,7,65,0,inf
45733,65,11,76,0,inf
45734,66,5,71,0,inf
45735,56,11,67,1,0.9238212071362355
45736,67,12,79,0,inf
45737,53,11,64,0,inf
45738,61,8,69,0,inf
45739,58,7,65,0,inf
45740,67,11,78,0,inf
45741,53,10,63,0,inf
45742,66,7,73,0,inf
45743,67,9,76,0,inf
45744,64,11,75,0,inf
45745,56,9,65,0,inf
45746,66,13,79,0,inf
45747,56,6,62,0,inf
45748,58,8,66,0,inf
45749,58,8,66,0,inf
45750,56,10,66,0,inf
45751,51,7,58,0,inf
45752,57,12,69,0,inf
45753,56,8,64,0,inf
45754,59,6,65,0,inf
45755,67,10,77,0,inf
45756,65,12,77,0,inf
45757,61,10,71,0,inf
45758,56,13,69,0,inf
45759,53,9,62,0,inf
45760,51,9,60,0,inf
45761,67,9,76,0,inf
45762,55,5,60,0,inf
45763,58,8,66,0,inf
45764,57,11,68,0,inf
45765,60,10,70,0,inf
45766,56,9,65,0,inf
45767,62,13,75,1,1.5954801270813448
45768,56,7,63,0,inf
45769,57,12,69,0,inf
45770,56,11,67,0,inf
45771,61,11,72,0,inf
45772,55,13,68,0,inf
45773,67,12,79,0,inf
45774,60,6,66,0,inf
45775,64,12,76,0,inf
45776,63,6,69,0,inf
45777,62,6,68,0,inf
45778,56,10,66,0,inf
45779,50,9,59,0,inf
45780,60,11,71,0,inf
45781,59,12,71,0,inf
45782,61,12,73,0,inf
45783,51,13,64,0,inf
45784,65,12,77,0,inf
45785,60,12,72,0,inf
45786,65,8,73,0,inf
45787,53,5,58,0,inf
45788,54,5,59,0,inf
45789,56,13,69,0,inf
45790,55,6,61,0,inf
45791,58,6,64,0,inf
45792,55,13,68,1,7.94286691068816
45793,52,5,57,0,inf
45794,58,10,68,0,inf
45795,65,7,72,0,inf
45796,52,9,61,0,inf
45797,59,7,66,1,5.945728229499309
45798,58,5,63,0,inf
45799,52,10,62,0,inf
45800,58,5,63,0,inf
45801,58,7,65,0,inf
45802,50,5,55,0,inf
45803,52,9,61,0,inf
45804,53,9,62,0,inf
45805,52,7,59,0,inf
45806,61,6,67,0,inf
45807,58,11,69,0,inf
45808,52,10,62,0,inf
45809,50,13,63,0,inf
45810,50,5,55,0,inf
45811,63,13,76,0,inf
45812,59,10,69,0,inf
45813,57,8,65,0,inf
45814,62,12,74,0,inf
45815,51,5,56,0,inf
45816,52,12,64,0,inf
45817,58,10,68,0,inf
45818,67,5,72,0,inf
45819,55,5,60,0,inf
45820,63,13,76,0,inf
45821,55,8,63,0,inf
45822,55,6,61,0,inf
45823,64,5,69,0,inf
45824,56,7,63,0,inf
45825,59,7,66,0,inf
45826,51,8,59,0,inf
45827,61,5,66,0,inf
45828,63,9,72,0,inf
45829,65,5,70,0,inf
45830,55,8,63,1,1.8410484668837839
45831,59,11,70,0,inf
45832,65,13,78,0,inf
45833,65,9,74,0,inf
45834,55,11,66,0,inf
45835,58,11,69,0,inf
45836,64,6,70,0,inf
45837,54,10,64,0,inf
45838,59,8,67,0,inf
45839,53,12,65,0,inf
45840,61,8,69,0,inf
45841,53,9,62,0,inf
45842,50,7,57,0,inf
45843,50,10,60,0,inf
45844,64,9,73,0,inf
45845,64,12,76,0,inf
45846,66,13,79,0,inf
45847,56,8,64,0,inf
45848,61,5,66,0,inf
45849,66,6,72,0,inf
45850,60,11,71,0,inf
45851,56,12,68,0,inf
45852,66,7,73,0,inf
45853,65,8,73,0,inf
45854,57,13,70,0,inf
45855,67,13,80,0,inf
45856,56,8,64,0,inf
45857,56,5,61,0,inf
45858,58,12,70,0,inf
45859,63,13,76,0,inf
45860,58,6,64,0,inf
45861,62,13,75,0,inf
45862,57,12,69,0,inf
45863,64,13,77,0,inf
45864,66,10,76,0,inf
45865,51,10,61,0,inf
45866,56,9,65,0,inf
45867,55,12,67,1,6.875077573764166
45868,57,12,69,0,inf
45869,61,7,68,0,inf
45870,64,9,73,0,inf
45871,52,6,58,0,inf
45872,51,11,62,0,inf
45873,56,5,61,0,inf
45874,64,9,73,0,inf
45875,61,13,74,0,inf
45876,56,7,63,0,inf
45877,57,10,67,0,inf
45878,51,8,59,0,inf
45879,53,10,63,0,inf
45880,67,10,77,0,inf
45881,65,11,76,0,inf
45882,64,11,75,0,inf
45883,54,7,61,0,inf
45884,62,11,73,0,inf
45885,53,10,63,0,inf
45886,61,13,74,1,0.24654363700521031
45887,52,10,62,0,inf
45888,58,11,69,1,5.480992492483743
45889,54,9,63,0,inf
45890,59,11,70,0,inf
45891,66,7,73,0,inf
45892,51,10,61,0,inf
45893,64,6,70,0,inf
45894,67,10,77,0,inf
45895,67,12,79,0,inf
45896,59,7,66,0,inf
45897,63,9,72,0,inf
45898,65,7,72,0,inf
45899,62,12,74,0,inf
45900,50,7,57,0,inf
45901,66,11,77,0,inf
45902,66,8,74,0,inf
45903,57,8,65,0,inf
45904,66,12,78,0,inf
45905,63,12,75,0,inf
45906,53,11,64,0,inf
45907,66,10,76,0,inf
45908,60,12,72,0,inf
45909,53,11,64,0,inf
45910,60,6,66,1,3.456449730728032
45911,57,10,67,0,inf
45912,67,13,80,0,inf
45913,57,6,63,0,inf
45914,59,10,69,0,inf
45915,59,13,72,1,6.53554101518732
45916,63,8,71,0,inf
45917,52,7,59,0,inf
45918,62,8,70,0,inf
45919,57,10,67,0,inf
45920,58,8,66,1,6.203228448061509
45921,52,10,62,0,inf
45922,62,8,70,0,inf
45923,50,6,56,0,inf
45924,56,12,68,0,inf
45925,67,13,80,0,inf
45926,50,13,63,0,inf
45927,52,11,63,0,inf
45928,51,6,57,0,inf
45929,56,10,66,0,inf
45930,63,13,76,0,inf
45931,66,9,75,0,inf
45932,64,13,77,0,inf
45933,57,10,67,0,inf
45934,53,9,62,0,inf
45935,60,11,71,0,inf
45936,67,5,72,0,inf
45937,56,13,69,0,inf
45938,52,5,57,0,inf
45939,67,11,78,0,inf
45940,59,5,64,0,inf
45941,62,11,73,0,inf
45942,57,7,64,0,inf
45943,55,6,61,0,inf
45944,53,8,61,0,inf
45945,60,10,70,0,inf
45946,63,10,73,0,inf
45947,66,9,75,0,inf
45948,66,11,77,0,inf
45949,66,10,76,0,inf
45950,61,7,68,0,inf
45951,51,5,56,0,inf
45952,65,6,71,0,inf
45953,60,5,65,0,inf
45954,62,11,73,0,inf
45955,64,9,73,0,inf
45956,57,6,63,0,inf
45957,60,7,67,0,inf
45958,50,6,56,0,inf
45959,65,8,73,0,inf
45960,57,8,65,0,inf
45961,57,8,65,0,inf
45962,66,8,74,0,inf
45963,67,13,80,0,inf
45964,51,9,60,0,inf
45965,65,10,75,0,inf
45966,61,10,71,0,inf
45967,64,6,70,0,inf
45968,61,8,69,0,inf
45969,64,7,71,0,inf
45970,65,5,70,0,inf
45971,50,9,59,0,inf
45972,61,10,71,0,inf
45973,61,7,68,0,inf
45974,57,11,68,1,1.4257585530498247
45975,50,6,56,0,inf
45976,64,13,77,0,inf
45977,63,5,68,0,inf
45978,56,10,66,0,inf
45979,59,6,65,0,inf
45980,55,7,62,0,inf
45981,62,10,72,0,inf
45982,52,11,63,0,inf
45983,65,6,71,0,inf
45984,58,8,66,0,inf
45985,56,5,61,0,inf
45986,55,6,61,0,inf
45987,64,5,69,0,inf
45988,53,10,63,0,inf
45989,54,13,67,0,inf
45990,65,10,75,1,2.1564573688725943
45991,66,5,71,0,inf
45992,65,7,72,0,inf
45993,55,5,60,0,inf
45994,50,8,58,1,1.334953311064858
45995,52,10,62,0,inf
45996,62,7,69,0,inf
45997,67,13,80,0,inf
45998,51,5,56,0,inf
45999,54,10,64,0,inf
46000,63,13,76,0,inf
46001,57,11,68,0,inf
46002,55,5,60,0,inf
46003,56,13,69,0,inf
46004,60,9,69,0,inf
46005,59,13,72,0,inf
46006,54,10,64,0,inf
46007,50,13,63,0,inf
46008,57,5,62,0,inf
46009,57,13,70,0,inf
46010,58,8,66,0,inf
46011,52,7,59,0,inf
46012,57,12,69,0,inf
46013,50,10,60,0,inf
46014,62,13,75,0,inf
46015,66,13,79,0,inf
46016,63,12,75,0,inf
46017,57,5,62,0,inf
46018,52,12,64,0,inf
46019,50,5,55,0,inf
46020,58,7,65,0,inf
46021,53,10,63,0,inf
46022,58,7,65,0,inf
46023,66,9,75,0,inf
46024,59,8,67,0,inf
46025,65,9,74,0,inf
46026,64,9,73,0,inf
46027,66,7,73,0,inf
46028,61,5,66,0,inf
46029,57,7,64,0,inf
46030,63,12,75,0,inf
46031,64,10,74,0,inf
46032,65,11,76,0,inf
46033,65,9,74,0,inf
46034,65,9,74,0,inf
46035,55,11,66,0,inf
46036,65,11,76,0,inf
46037,62,8,70,1,4.330453415145186
46038,62,6,68,0,inf
46039,50,5,55,0,inf
46040,67,5,72,0,inf
46041,53,11,64,0,inf
46042,59,5,64,1,4.924548239089219
46043,55,6,61,0,inf
46044,67,9,76,0,inf
46045,60,6,66,0,inf
46046,52,12,64,0,inf
46047,55,5,60,0,inf
46048,63,10,73,0,inf
46049,56,9,65,0,inf
46050,65,12,77,0,inf
46051,53,11,64,0,inf
46052,53,11,64,0,inf
46053,58,12,70,0,inf
46054,58,12,70,0,inf
46055,52,9,61,0,inf
46056,56,11,67,0,inf
46057,53,11,64,0,inf
46058,63,10,73,0,inf
46059,60,13,73,0,inf
46060,54,6,60,0,inf
46061,51,5,56,0,inf
46062,56,11,67,0,inf
46063,63,7,70,0,inf
46064,52,9,61,0,inf
46065,50,9,59,0,inf
46066,66,7,73,0,inf
46067,64,6,70,0,inf
46068,53,10,63,0,inf
46069,58,12,70,1,1.4079044913296315
46070,63,12,75,0,inf
46071,58,6,64,0,inf
46072,51,6,57,0,inf
46073,61,8,69,0,inf
46074,65,11,76,0,inf
46075,64,11,75,0,inf
46076,67,7,74,0,inf
46077,57,8,65,0,inf
46078,57,7,64,0,inf
46079,56,5,61,0,inf
46080,60,8,68,0,inf
46081,61,5,66,0,inf
46082,60,11,71,0,inf
46083,52,9,61,0,inf
46084,64,5,69,0,inf
46085,62,8,70,0,inf
46086,50,6,56,0,inf
46087,65,13,78,0,inf
46088,59,11,70,0,inf
46089,50,8,58,0,inf
46090,65,13,78,0,inf
46091,57,8,65,0,inf
46092,67,8,75,0,inf
46093,59,13,72,0,inf
46094,66,13,79,0,inf
46095,56,7,63,0,inf
46096,52,6,58,0,inf
46097,65,9,74,0,inf
46098,54,12,66,0,inf
46099,57,9,66,0,inf
46100,58,10,68,1,8.52249880606665
46101,64,11,75,0,inf
46102,56,6,62,0,inf
46103,65,9,74,0,inf
46104,52,10,62,0,inf
46105,58,6,64,0,inf
46106,57,5,62,0,inf
46107,58,12,70,0,inf
46108,56,12,68,0,inf
46109,57,13,70,0,inf
46110,54,6,60,0,inf
46111,67,13,80,0,inf
46112,65,11,76,0,inf
46113,50,8,58,0,inf
46114,62,12,74,0,inf
46115,67,8,75,0,inf
46116,67,8,75,0,inf
46117,65,11,76,0,inf
46118,59,13,72,0,inf
46119,60,7,67,0,inf
46120,64,7,71,0,inf
46121,53,13,66,0,inf
46122,62,11,73,0,inf
46123,59,8,67,0,inf
46124,67,5,72,0,inf
46125,67,6,73,0,inf
46126,59,8,67,0,inf
46127,63,9,72,0,inf
46128,56,8,64,0,inf
46129,58,5,63,0,inf
46130,55,10,65,0,inf
46131,57,9,66,0,inf
46132,64,7,71,0,inf
46133,53,7,60,0,inf
46134,67,8,75,0,inf
46135,54,13,67,0,inf
46136,59,5,64,0,inf
46137,58,9,67,0,inf
46138,58,7,65,0,inf
46139,50,8,58,0,inf
46140,61,9,70,0,inf
46141,65,9,74,0,inf
46142,61,12,73,0,inf
46143,65,11,76,0,inf
46144,57,9,66,0,inf
46145,64,12,76,0,inf
46146,52,13,65,0,inf
46147,54,10,64,0,inf
46148,62,8,70,0,inf
46149,57,12,69,0,inf
46150,55,9,64,0,inf
46151,60,12,72,0,inf
46152,52,10,62,0,inf
46153,65,11,76,0,inf
46154,65,5,70,0,inf
46155,56,6,62,0,inf
46156,50,10,60,0,inf
46157,55,6,61,0,inf
46158,60,10,70,0,inf
46159,56,5,61,0,inf
46160,56,9,65,0,inf
46161,50,10,60,0,inf
46162,66,13,79,0,inf
46163,51,6,57,0,inf
46164,50,8,58,0,inf
46165,64,5,69,0,inf
46166,57,8,65,0,inf
46167,59,8,67,0,inf
46168,52,11,63,0,inf
46169,65,7,72,0,inf
46170,58,13,71,0,inf
46171,66,9,75,0,inf
46172,53,5,58,0,inf
46173,66,7,73,0,inf
46174,67,11,78,0,inf
46175,52,9,61,0,inf
46176,52,11,63,1,9.76811553802439
46177,63,9,72,0,inf
46178,51,10,61,0,inf
46179,63,12,75,0,inf
46180,51,12,63,0,inf
46181,64,9,73,0,inf
46182,63,5,68,0,inf
46183,52,10,62,0,inf
46184,52,5,57,0,inf
46185,53,5,58,0,inf
46186,55,8,63,0,inf
46187,64,5,69,0,inf
46188,52,12,64,0,inf
46189,52,13,65,0,inf
46190,54,7,61,0,inf
46191,62,11,73,0,inf
46192,52,12,64,0,inf
46193,52,7,59,0,inf
46194,51,13,64,0,inf
46195,62,11,73,0,inf
46196,54,12,66,0,inf
46197,62,6,68,0,inf
46198,56,8,64,0,inf
46199,67,7,74,0,inf
46200,53,9,62,0,inf
46201,50,11,61,0,inf
46202,58,10,68,0,inf
46203,54,9,63,0,inf
46204,52,10,62,0,inf
46205,65,6,71,0,inf
46206,58,9,67,0,inf
46207,62,6,68,0,inf
46208,64,13,77,0,inf
46209,55,8,63,0,inf
46210,53,5,58,0,inf
46211,50,6,56,0,inf
46212,60,11,71,0,inf
46213,55,12,67,0,inf
46214,66,5,71,0,inf
46215,50,7,57,0,inf
46216,65,8,73,0,inf
46217,52,9,61,0,inf
46218,67,12,79,0,inf
46219,65,7,72,0,inf
46220,53,12,65,0,inf
46221,58,8,66,0,inf
46222,62,13,75,0,inf
46223,54,10,64,0,inf
46224,52,5,57,0,inf
46225,53,5,58,0,inf
46226,67,7,74,0,inf
46227,61,6,67,0,inf
46228,64,11,75,0,inf
46229,58,9,67,0,inf
46230,60,6,66,1,3.6861670369010326
46231,51,12,63,0,inf
46232,65,6,71,0,inf
46233,52,13,65,1,7.005306360011637
46234,65,6,71,0,inf
46235,63,5,68,0,inf
46236,63,11,74,0,inf
46237,50,9,59,0,inf
46238,63,10,73,0,inf
46239,61,6,67,0,inf
46240,53,7,60,0,inf
46241,63,7,70,0,inf
46242,52,9,61,0,inf
46243,56,13,69,0,inf
46244,56,6,62,0,inf
46245,56,12,68,1,3.6639076628364293
46246,66,13,79,0,inf
46247,54,12,66,0,inf
46248,55,9,64,0,inf
46249,52,13,65,0,inf
46250,51,9,60,0,inf
46251,61,8,69,0,inf
46252,56,10,66,0,inf
46253,60,7,67,0,inf
46254,64,12,76,0,inf
46255,56,11,67,0,inf
46256,51,6,57,0,inf
46257,61,5,66,0,inf
46258,58,7,65,0,inf
46259,60,13,73,0,inf
46260,52,13,65,1,2.067266571522971
46261,64,5,69,0,inf
46262,65,8,73,0,inf
46263,65,11,76,0,inf
46264,63,7,70,0,inf
46265,65,8,73,0,inf
46266,61,5,66,0,inf
46267,52,12,64,0,inf
46268,59,10,69,0,inf
46269,55,11,66,0,inf
46270,56,8,64,0,inf
46271,50,13,63,0,inf
46272,52,7,59,0,inf
46273,60,9,69,0,inf
46274,55,6,61,0,inf
46275,67,9,76,0,inf
46276,63,5,68,0,inf
46277,58,9,67,0,inf
46278,54,6,60,0,inf
46279,55,6,61,0,inf
46280,64,5,69,0,inf
46281,59,10,69,0,inf
46282,51,13,64,0,inf
46283,52,5,57,0,inf
46284,67,7,74,0,inf
46285,60,7,67,0,inf
46286,61,9,70,0,inf
46287,50,6,56,0,inf
46288,55,7,62,0,inf
46289,67,13,80,0,inf
46290,66,11,77,1,1.536338878690799
46291,66,9,75,0,inf
46292,50,12,62,0,inf
46293,55,5,60,0,inf
46294,61,7,68,0,inf
46295,52,8,60,0,inf
46296,51,13,64,0,inf
46297,67,12,79,0,inf
46298,62,8,70,0,inf
46299,51,9,60,0,inf
46300,54,9,63,0,inf
46301,62,7,69,0,inf
46302,54,13,67,0,inf
46303,50,13,63,0,inf
46304,67,12,79,0,inf
46305,60,5,65,0,inf
46306,58,9,67,0,inf
46307,59,13,72,0,inf
46308,66,10,76,0,inf
46309,51,6,57,0,inf
46310,65,7,72,0,inf
46311,50,11,61,0,inf
46312,65,5,70,1,0.31400875043826204
46313,65,13,78,0,inf
46314,64,9,73,0,inf
46315,60,8,68,0,inf
46316,61,5,66,0,inf
46317,55,8,63,0,inf
46318,51,8,59,0,inf
46319,51,8,59,0,inf
46320,64,6,70,0,inf
46321,65,9,74,0,inf
46322,51,9,60,0,inf
46323,65,11,76,0,inf
46324,66,8,74,0,inf
46325,62,12,74,0,inf
46326,51,5,56,0,inf
46327,54,12,66,0,inf
46328,58,7,65,0,inf
46329,51,10,61,0,inf
46330,52,13,65,0,inf
46331,58,6,64,0,inf
46332,65,6,71,0,inf
46333,56,9,65,0,inf
46334,64,9,73,0,inf
46335,56,6,62,0,inf
46336,54,13,67,0,inf
46337,51,10,61,0,inf
46338,59,5,64,0,inf
46339,57,11,68,0,inf
46340,66,13,79,0,inf
46341,66,7,73,0,inf
46342,57,7,64,0,inf
46343,55,11,66,0,inf
46344,66,5,71,0,inf
46345,54,8,62,0,inf
46346,56,10,66,0,inf
46347,54,13,67,0,inf
46348,65,9,74,0,inf
46349,59,10,69,0,inf
46350,58,12,70,0,inf
46351,55,12,67,0,inf
46352,50,5,55,0,inf
46353,52,9,61,0,inf
46354,53,13,66,0,inf
46355,51,12,63,0,inf
46356,52,11,63,0,inf
46357,52,10,62,0,inf
46358,55,8,63,0,inf
46359,58,12,70,0,inf
46360,66,8,74,0,inf
46361,65,12,77,0,inf
46362,58,8,66,0,inf
46363,59,11,70,0,inf
46364,67,8,75,0,inf
46365,61,11,72,0,inf
46366,55,8,63,0,inf
46367,63,10,73,0,inf
46368,58,12,70,0,inf
46369,61,13,74,0,inf
46370,50,13,63,0,inf
46371,67,9,76,0,inf
46372,52,13,65,0,inf
46373,67,10,77,0,inf
46374,58,10,68,0,inf
46375,56,12,68,0,inf
46376,53,7,60,0,inf
46377,63,11,74,0,inf
46378,59,8,67,0,inf
46379,64,11,75,0,inf
46380,65,7,72,0,inf
46381,57,13,70,0,inf
46382,51,11,62,0,inf
46383,64,6,70,0,inf
46384,65,13,78,0,inf
46385,67,5,72,0,inf
46386,54,12,66,0,inf
46387,50,8,58,0,inf
46388,56,7,63,0,inf
46389,57,7,64,0,inf
46390,63,12,75,0,inf
46391,60,10,70,0,inf
46392,51,13,64,0,inf
46393,52,12,64,0,inf
46394,64,10,74,0,inf
46395,67,8,75,1,2.0797058391492556
46396,66,13,79,0,inf
46397,52,13,65,0,inf
46398,66,13,79,0,inf
46399,64,6,70,0,inf
46400,62,5,67,0,inf
46401,56,9,65,0,inf
46402,65,5,70,0,inf
46403,55,5,60,1,4.0889563562288345
46404,67,6,73,0,inf
46405,58,5,63,0,inf
46406,59,12,71,0,inf
46407,52,6,58,0,inf
46408,50,13,63,0,inf
46409,66,6,72,0,inf
46410,66,6,72,0,inf
46411,60,6,66,0,inf
46412,53,5,58,0,inf
46413,64,8,72,0,inf
46414,55,6,61,0,inf
46415,53,9,62,0,inf
46416,66,7,73,0,inf
46417,66,13,79,0,inf
46418,66,7,73,0,inf
46419,64,7,71,0,inf
46420,62,6,68,0,inf
46421,67,11,78,0,inf
46422,51,12,63,0,inf
46423,60,11,71,0,inf
46424,55,6,61,0,inf
46425,63,11,74,1,2.370256602080289
46426,66,5,71,0,inf
46427,54,12,66,0,inf
46428,50,7,57,0,inf
46429,56,12,68,0,inf
46430,58,10,68,0,inf
46431,59,6,65,0,inf
46432,53,9,62,0,inf
46433,50,9,59,0,inf
46434,61,11,72,0,inf
46435,67,9,76,0,inf
46436,53,7,60,0,inf
46437,54,6,60,0,inf
46438,59,12,71,0,inf
46439,51,13,64,0,inf
46440,59,11,70,0,inf
46441,65,8,73,0,inf
46442,53,12,65,1,10.249206839681108
46443,67,13,80,0,inf
46444,57,8,65,0,inf
46445,62,13,75,0,inf
46446,57,8,65,0,inf
46447,53,11,64,0,inf
46448,57,12,69,0,inf
46449,58,9,67,0,inf
46450,53,9,62,0,inf
46451,61,11,72,0,inf
46452,65,7,72,0,inf
46453,55,12,67,0,inf
46454,65,13,78,0,inf
46455,63,7,70,0,inf
46456,54,11,65,0,inf
46457,53,5,58,0,inf
46458,65,6,71,0,inf
46459,66,5,71,0,inf
46460,64,8,72,0,inf
46461,57,9,66,0,inf
46462,67,10,77,0,inf
46463,62,9,71,0,inf
46464,58,6,64,0,inf
46465,53,6,59,0,inf
46466,64,11,75,0,inf
46467,51,7,58,0,inf
46468,58,9,67,0,inf
46469,66,5,71,0,inf
46470,53,6,59,0,inf
46471,50,7,57,0,inf
46472,57,13,70,0,inf
46473,64,10,74,0,inf
46474,51,8,59,1,0.9268032444202774
46475,52,11,63,0,inf
46476,52,13,65,0,inf
46477,61,11,72,0,inf
46478,52,7,59,0,inf
46479,62,7,69,1,0.4783819582415063
46480,60,12,72,0,inf
46481,52,6,58,0,inf
46482,61,7,68,0,inf
46483,65,11,76,0,inf
46484,58,10,68,0,inf
46485,63,10,73,0,inf
46486,60,9,69,0,inf
46487,52,5,57,0,inf
46488,59,8,67,0,inf
46489,56,10,66,0,inf
46490,57,7,64,0,inf
46491,65,5,70,0,inf
46492,58,5,63,0,inf
46493,63,13,76,0,inf
46494,54,6,60,0,inf
46495,63,5,68,0,inf
46496,65,6,71,0,inf
46497,65,13,78,0,inf
46498,66,7,73,0,inf
46499,59,10,69,0,inf
46500,67,8,75,0,inf
46501,64,7,71,0,inf
46502,52,13,65,0,inf
46503,58,11,69,0,inf
46504,67,11,78,0,inf
46505,57,10,67,0,inf
46506,60,9,69,0,inf
46507,51,6,57,0,inf
46508,51,11,62,0,inf
46509,50,8,58,0,inf
46510,67,13,80,1,10.66180636522769
46511,67,7,74,0,inf
46512,53,7,60,0,inf
46513,51,10,61,0,inf
46514,62,5,67,0,inf
46515,54,12,66,0,inf
46516,53,7,60,0,inf
46517,62,12,74,0,inf
46518,50,6,56,0,inf
46519,58,13,71,0,inf
46520,56,10,66,0,inf
46521,58,5,63,0,inf
46522,56,9,65,0,inf
46523,66,5,71,0,inf
46524,67,13,80,0,inf
46525,67,8,75,0,inf
46526,56,7,63,0,inf
46527,60,13,73,0,inf
46528,66,5,71,0,inf
46529,67,13,80,0,inf
46530,60,6,66,0,inf
46531,61,12,73,0,inf
46532,66,9,75,0,inf
46533,63,13,76,0,inf
46534,56,10,66,0,inf
46535,51,7,58,0,inf
46536,65,10,75,0,inf
46537,67,9,76,0,inf
46538,54,7,61,0,inf
46539,61,8,69,0,inf
46540,53,6,59,0,inf
46541,62,12,74,0,inf
46542,63,9,72,0,inf
46543,67,13,80,0,inf
46544,58,12,70,0,inf
46545,65,13,78,0,inf
46546,63,7,70,0,inf
46547,67,8,75,0,inf
46548,58,11,69,0,inf
46549,56,9,65,0,inf
46550,53,11,64,0,inf
46551,53,5,58,0,inf
46552,60,5,65,0,inf
46553,50,7,57,0,inf
46554,60,11,71,0,inf
46555,59,9,68,0,inf
46556,56,10,66,1,5.953475713935511
46557,59,5,64,0,inf
46558,54,12,66,0,inf
46559,55,6,61,0,inf
46560,67,11,78,0,inf
46561,63,11,74,0,inf
46562,67,13,80,0,inf
46563,62,7,69,0,inf
46564,61,7,68,0,inf
46565,64,12,76,0,inf
46566,58,8,66,0,inf
46567,66,10,76,0,inf
46568,65,6,71,0,inf
46569,66,12,78,0,inf
46570,63,8,71,0,inf
46571,59,8,67,0,inf
46572,63,9,72,0,inf
46573,50,7,57,0,inf
46574,53,8,61,0,inf
46575,52,5,57,0,inf
46576,65,12,77,0,inf
46577,64,11,75,0,inf
46578,60,11,71,0,inf
46579,57,13,70,0,inf
46580,66,10,76,0,inf
46581,50,7,57,0,inf
46582,55,5,60,0,inf
46583,63,13,76,0,inf
46584,60,9,69,0,inf
46585,57,12,69,0,inf
46586,61,8,69,0,inf
46587,63,10,73,0,inf
46588,62,11,73,0,inf
46589,63,9,72,0,inf
46590,64,9,73,0,inf
46591,50,7,57,0,inf
46592,57,12,69,0,inf
46593,57,9,66,0,inf
46594,55,6,61,0,inf
46595,64,10,74,0,inf
46596,61,8,69,0,inf
46597,53,10,63,0,inf
46598,54,5,59,0,inf
46599,57,7,64,0,inf
46600,51,6,57,0,inf
46601,65,12,77,0,inf
46602,51,9,60,0,inf
46603,56,7,63,0,inf
46604,67,13,80,0,inf
46605,54,11,65,0,inf
46606,61,12,73,0,inf
46607,51,5,56,0,inf
46608,51,11,62,0,inf
46609,62,6,68,0,inf
46610,66,10,76,0,inf
46611,56,6,62,0,inf
46612,53,11,64,0,inf
46613,58,7,65,0,inf
46614,54,9,63,0,inf
46615,54,13,67,0,inf
46616,60,13,73,0,inf
46617,64,11,75,0,inf
46618,58,10,68,0,inf
46619,61,9,70,0,inf
46620,54,6,60,0,inf
46621,62,11,73,0,inf
46622,61,12,73,0,inf
46623,52,5,57,0,inf
46624,52,6,58,0,inf
46625,67,13,80,0,inf
46626,55,10,65,0,inf
46627,63,9,72,0,inf
46628,55,13,68,0,inf
46629,66,6,72,0,inf
46630,53,8,61,0,inf
46631,59,11,70,0,inf
46632,58,7,65,0,inf
46633,52,8,60,0,inf
46634,61,7,68,0,inf
46635,58,6,64,0,inf
46636,61,6,67,0,inf
46637,64,8,72,0,inf
46638,56,10,66,0,inf
46639,51,8,59,0,inf
46640,63,6,69,0,inf
46641,67,11,78,0,inf
46642,53,8,61,0,inf
46643,66,13,79,1,12.207479361058816
46644,65,6,71,0,inf
46645,57,5,62,0,inf
46646,58,5,63,0,inf
46647,50,10,60,0,inf
46648,55,9,64,0,inf
46649,52,9,61,0,inf
46650,55,11,66,0,inf
46651,50,5,55,0,inf
46652,51,13,64,0,inf
46653,66,10,76,0,inf
46654,56,11,67,0,inf
46655,58,12,70,1,5.378375184550933
46656,59,12,71,0,inf
46657,61,10,71,1,0.9675977035441861
46658,62,6,68,0,inf
46659,63,9,72,0,inf
46660,61,8,69,1,7.464696055196384
46661,56,7,63,0,inf
46662,50,12,62,0,inf
46663,51,12,63,0,inf
46664,64,7,71,0,inf
46665,55,7,62,0,inf
46666,65,6,71,0,inf
46667,64,9,73,0,inf
46668,65,8,73,0,inf
46669,54,10,64,0,inf
46670,65,7,72,0,inf
46671,57,9,66,0,inf
46672,67,13,80,0,inf
46673,65,6,71,0,inf
46674,51,6,57,0,inf
46675,65,8,73,0,inf
46676,50,10,60,0,inf
46677,65,10,75,1,7.715449906313182
46678,57,13,70,0,inf
46679,55,9,64,0,inf
46680,53,6,59,0,inf
46681,51,10,61,0,inf
46682,58,10,68,0,inf
46683,59,5,64,0,inf
46684,53,9,62,0,inf
46685,58,12,70,0,inf
46686,56,8,64,0,inf
46687,52,11,63,0,inf
46688,56,10,66,0,inf
46689,52,8,60,0,inf
46690,63,5,68,0,inf
46691,57,13,70,0,inf
46692,50,12,62,0,inf
46693,50,13,63,1,9.797705121201403
46694,60,6,66,0,inf
46695,59,7,66,0,inf
46696,66,10,76,0,inf
46697,50,6,56,0,inf
46698,51,10,61,0,inf
46699,57,12,69,0,inf
46700,53,13,66,0,inf
46701,58,13,71,0,inf
46702,59,6,65,0,inf
46703,55,6,61,0,inf
46704,64,5,69,0,inf
46705,66,10,76,0,inf
46706,65,6,71,0,inf
46707,50,6,56,0,inf
46708,67,12,79,0,inf
46709,62,10,72,0,inf
46710,59,6,65,0,inf
46711,65,12,77,0,inf
46712,58,8,66,0,inf
46713,62,6,68,0,inf
46714,63,6,69,0,inf
46715,54,11,65,0,inf
46716,66,9,75,0,inf
46717,56,6,62,0,inf
46718,64,13,77,0,inf
46719,50,7,57,0,inf
46720,56,9,65,0,inf
46721,52,9,61,0,inf
46722,52,12,64,0,inf
46723,65,12,77,0,inf
46724,64,8,72,0,inf
46725,61,11,72,0,inf
46726,64,8,72,0,inf
46727,54,7,61,0,inf
46728,57,12,69,0,inf
46729,60,8,68,0,inf
46730,57,10,67,0,inf
46731,55,9,64,1,7.904825337146882
46732,56,8,64,0,inf
46733,64,10,74,0,inf
46734,55,10,65,0,inf
46735,53,12,65,0,inf
46736,54,13,67,0,inf
46737,58,8,66,0,inf
46738,58,13,71,0,inf
46739,60,13,73,0,inf
46740,65,6,71,0,inf
46741,64,9,73,0,inf
46742,52,12,64,0,inf
46743,50,10,60,0,inf
46744,59,8,67,0,inf
46745,56,8,64,0,inf
46746,64,13,77,0,inf
46747,56,6,62,0,inf
46748,51,10,61,0,inf
46749,67,10,77,0,inf
46750,51,10,61,0,inf
46751,62,11,73,0,inf
46752,59,6,65,0,inf
46753,61,7,68,0,inf
46754,65,7,72,0,inf
46755,54,11,65,0,inf
46756,56,7,63,0,inf
46757,58,9,67,0,inf
46758,55,6,61,0,inf
46759,58,13,71,0,inf
46760,56,9,65,0,inf
46761,65,9,74,0,inf
46762,65,5,70,0,inf
46763,62,10,72,0,inf
46764,53,8,61,0,inf
46765,62,11,73,0,inf
46766,60,10,70,1,1.9529374035987104
46767,53,10,63,0,inf
46768,54,7,61,0,inf
46769,53,9,62,0,inf
46770,51,9,60,0,inf
46771,53,10,63,0,inf
46772,54,13,67,0,inf
46773,55,11,66,0,inf
46774,61,5,66,0,inf
46775,62,7,69,0,inf
46776,60,12,72,0,inf
46777,51,11,62,0,inf
46778,50,5,55,0,inf
46779,66,5,71,0,inf
46780,61,6,67,0,inf
46781,51,10,61,0,inf
46782,65,12,77,0,inf
46783,56,12,68,0,inf
46784,63,6,69,0,inf
46785,57,11,68,0,inf
46786,65,7,72,0,inf
46787,58,7,65,0,inf
46788,64,11,75,0,inf
46789,60,12,72,1,2.388072162344514
46790,54,10,64,0,inf
46791,56,10,66,0,inf
46792,54,11,65,0,inf
46793,63,11,74,0,inf
46794,61,11,72,0,inf
46795,63,11,74,0,inf
46796,51,6,57,0,inf
46797,63,11,74,0,inf
46798,54,7,61,0,inf
46799,65,8,73,0,inf
46800,58,12,70,0,inf
46801,53,5,58,0,inf
46802,62,13,75,0,inf
46803,62,6,68,0,inf
46804,52,9,61,0,inf
46805,58,7,65,1,3.7877634609871222
46806,51,11,62,0,inf
46807,51,13,64,0,inf
46808,67,11,78,0,inf
46809,59,11,70,0,inf
46810,61,13,74,0,inf
46811,67,6,73,0,inf
46812,62,11,73,0,inf
46813,63,8,71,0,inf
46814,51,13,64,0,inf
46815,52,5,57,0,inf
46816,59,5,64,0,inf
46817,51,9,60,0,inf
46818,66,9,75,0,inf
46819,62,10,72,0,inf
46820,67,5,72,0,inf
46821,61,12,73,0,inf
46822,51,6,57,0,inf
46823,57,5,62,0,inf
46824,65,6,71,0,inf
46825,67,11,78,0,inf
46826,59,10,69,0,inf
46827,65,11,76,0,inf
46828,64,5,69,0,inf
46829,67,12,79,0,inf
46830,60,11,71,0,inf
46831,61,11,72,0,inf
46832,62,8,70,0,inf
46833,65,12,77,0,inf
46834,57,12,69,0,inf
46835,52,6,58,0,inf
46836,55,5,60,0,inf
46837,62,13,75,0,inf
46838,53,10,63,0,inf
46839,58,9,67,0,inf
46840,50,8,58,0,inf
46841,63,11,74,0,inf
46842,50,12,62,0,inf
46843,66,7,73,0,inf
46844,56,5,61,0,inf
46845,54,7,61,0,inf
46846,56,10,66,0,inf
46847,64,8,72,0,inf
46848,67,6,73,0,inf
46849,57,6,63,0,inf
46850,61,8,69,0,inf
46851,53,6,59,0,inf
46852,52,6,58,0,inf
46853,65,11,76,0,inf
46854,57,11,68,0,inf
46855,57,7,64,0,inf
46856,51,11,62,1,0.8434664092953739
46857,65,10,75,0,inf
46858,65,7,72,0,inf
46859,63,7,70,0,inf
46860,59,5,64,0,inf
46861,54,6,60,0,inf
46862,50,9,59,0,inf
46863,58,8,66,0,inf
46864,51,10,61,0,inf
46865,55,9,64,0,inf
46866,60,11,71,0,inf
46867,62,11,73,0,inf
46868,50,11,61,0,inf
46869,53,5,58,0,inf
46870,53,10,63,0,inf
46871,62,9,71,0,inf
46872,54,13,67,0,inf
46873,65,10,75,1,7.351676401149888
46874,58,7,65,0,inf
46875,66,11,77,0,inf
46876,66,6,72,1,4.0480470990625435
46877,66,6,72,0,inf
46878,66,9,75,0,inf
46879,62,9,71,0,inf
46880,58,5,63,0,inf
46881,51,6,57,0,inf
46882,56,10,66,0,inf
46883,50,5,55,0,inf
46884,50,13,63,0,inf
46885,52,8,60,0,inf
46886,60,11,71,0,inf
46887,57,13,70,0,inf
46888,67,5,72,0,inf
46889,67,8,75,0,inf
46890,66,5,71,0,inf
46891,51,10,61,0,inf
46892,61,9,70,1,8.590384269784224
46893,58,5,63,0,inf
46894,55,9,64,0,inf
46895,57,10,67,0,inf
46896,65,6,71,0,inf
46897,65,12,77,0,inf
46898,62,5,67,0,inf
46899,55,5,60,0,inf
46900,54,9,63,0,inf
46901,66,7,73,0,inf
46902,57,12,69,0,inf
46903,54,11,65,0,inf
46904,64,13,77,0,inf
46905,61,7,68,0,inf
46906,59,11,70,0,inf
46907,58,12,70,0,inf
46908,54,6,60,0,inf
46909,65,7,72,0,inf
46910,61,5,66,0,inf
46911,60,12,72,0,inf
46912,66,5,71,0,inf
46913,66,5,71,0,inf
46914,59,8,67,0,inf
46915,52,13,65,0,inf
46916,67,8,75,0,inf
46917,63,5,68,0,inf
46918,56,5,61,0,inf
46919,53,8,61,0,inf
46920,52,6,58,0,inf
46921,57,9,66,1,6.392937426112475
46922,61,9,70,0,inf
46923,53,9,62,0,inf
46924,53,6,59,0,inf
46925,56,9,65,0,inf
46926,59,11,70,0,inf
46927,67,11,78,0,inf
46928,52,7,59,0,inf
46929,58,8,66,0,inf
46930,65,11,76,0,inf
46931,55,7,62,1,0.5807317777469194
46932,66,12,78,0,inf
46933,59,10,69,0,inf
46934,55,12,67,0,inf
46935,60,6,66,0,inf
46936,56,7,63,0,inf
46937,64,5,69,0,inf
46938,52,6,58,0,inf
46939,63,10,73,0,inf
46940,53,9,62,0,inf
46941,58,5,63,0,inf
46942,50,8,58,0,inf
46943,65,8,73,0,inf
46944,63,8,71,0,inf
46945,54,8,62,0,inf
46946,64,9,73,0,inf
46947,52,9,61,0,inf
46948,58,8,66,0,inf
46949,58,12,70,0,inf
46950,54,6,60,0,inf
46951,63,5,68,0,inf
46952,51,6,57,0,inf
46953,66,12,78,0,inf
46954,55,11,66,0,inf
46955,56,11,67,0,inf
46956,60,6,66,0,inf
46957,62,10,72,0,inf
46958,53,6,59,0,inf
46959,58,7,65,0,inf
46960,53,6,59,0,inf
46961,52,6,58,0,inf
46962,53,8,61,0,inf
46963,60,12,72,0,inf
46964,60,5,65,0,inf
46965,54,12,66,1,8.65225167231776
46966,63,6,69,0,inf
46967,54,5,59,0,inf
46968,59,5,64,0,inf
46969,50,10,60,0,inf
46970,51,9,60,0,inf
46971,53,12,65,0,inf
46972,51,6,57,0,inf
46973,54,12,66,0,inf
46974,54,13,67,0,inf
46975,59,13,72,0,inf
46976,67,5,72,0,inf
46977,52,5,57,0,inf
46978,59,11,70,0,inf
46979,66,12,78,0,inf
46980,60,12,72,0,inf
46981,53,8,61,0,inf
46982,61,7,68,0,inf
46983,54,10,64,0,inf
46984,65,10,75,0,inf
46985,67,10,77,0,inf
46986,58,6,64,0,inf
46987,60,10,70,0,inf
46988,50,6,56,0,inf
46989,57,11,68,0,inf
46990,50,5,55,0,inf
46991,62,5,67,0,inf
46992,58,8,66,0,inf
46993,50,10,60,0,inf
46994,57,6,63,0,inf
46995,55,8,63,0,inf
46996,61,11,72,0,inf
46997,56,9,65,0,inf
46998,57,6,63,0,inf
46999,54,8,62,0,inf
47000,59,10,69,0,inf
47001,52,6,58,0,inf
47002,59,9,68,0,inf
47003,52,9,61,0,inf
47004,65,8,73,0,inf
47005,61,10,71,0,inf
47006,63,5,68,0,inf
47007,67,7,74,0,inf
47008,60,5,65,0,inf
47009,56,5,61,0,inf
47010,58,9,67,0,inf
47011,58,9,67,0,inf
47012,56,8,64,0,inf
47013,60,9,69,1,0.5947737568985261
47014,61,6,67,0,inf
47015,52,7,59,0,inf
47016,60,12,72,0,inf
47017,65,6,71,0,inf
47018,65,7,72,0,inf
47019,62,12,74,0,inf
47020,55,10,65,0,inf
47021,62,7,69,0,inf
47022,62,9,71,0,inf
47023,55,11,66,0,inf
47024,64,6,70,0,inf
47025,67,10,77,0,inf
47026,51,5,56,0,inf
47027,58,12,70,0,inf
47028,67,10,77,0,inf
47029,55,8,63,1,3.567563792433809
47030,50,10,60,0,inf
47031,60,7,67,0,inf
47032,62,7,69,0,inf
47033,54,12,66,0,inf
47034,62,10,72,0,inf
47035,65,9,74,0,inf
47036,52,9,61,0,inf
47037,55,8,63,1,4.981229084423333
47038,63,5,68,0,inf
47039,65,9,74,0,inf
47040,55,13,68,0,inf
47041,66,10,76,0,inf
47042,51,9,60,0,inf
47043,67,7,74,0,inf
47044,60,9,69,0,inf
47045,66,11,77,0,inf
47046,57,6,63,0,inf
47047,61,13,74,0,inf
47048,62,11,73,0,inf
47049,55,9,64,0,inf
47050,55,7,62,0,inf
47051,56,11,67,0,inf
47052,64,10,74,0,inf
47053,51,8,59,0,inf
47054,64,8,72,0,inf
47055,54,7,61,0,inf
47056,50,13,63,0,inf
47057,60,8,68,0,inf
47058,66,7,73,0,inf
47059,55,13,68,0,inf
47060,55,8,63,0,inf
47061,52,7,59,0,inf
47062,58,9,67,0,inf
47063,57,12,69,0,inf
47064,62,10,72,0,inf
47065,50,6,56,0,inf
47066,67,7,74,0,inf
47067,52,5,57,0,inf
47068,58,12,70,0,inf
47069,62,12,74,1,11.189230206614127
47070,61,9,70,0,inf
47071,67,11,78,0,inf
47072,60,8,68,0,inf
47073,66,12,78,0,inf
47074,55,7,62,0,inf
47075,62,6,68,0,inf
47076,64,5,69,0,inf
47077,52,9,61,0,inf
47078,53,11,64,0,inf
47079,61,12,73,0,inf
47080,56,10,66,0,inf
47081,53,6,59,0,inf
47082,55,5,60,0,inf
47083,55,9,64,0,inf
47084,65,5,70,0,inf
47085,66,6,72,0,inf
47086,67,8,75,0,inf
47087,50,6,56,0,inf
47088,50,5,55,0,inf
47089,57,10,67,0,inf
47090,64,5,69,0,inf
47091,53,8,61,0,inf
47092,59,12,71,0,inf
47093,54,5,59,0,inf
47094,63,10,73,0,inf
47095,53,13,66,0,inf
47096,57,9,66,0,inf
47097,61,10,71,0,inf
47098,61,8,69,0,inf
47099,52,9,61,0,inf
47100,56,6,62,0,inf
47101,58,8,66,0,inf
47102,65,5,70,0,inf
47103,65,5,70,0,inf
47104,65,12,77,0,inf
47105,63,9,72,0,inf
47106,67,10,77,0,inf
47107,66,6,72,0,inf
47108,51,7,58,0,inf
47109,51,8,59,0,inf
47110,60,12,72,0,inf
47111,67,8,75,0,inf
47112,62,7,69,0,inf
47113,59,12,71,0,inf
47114,67,6,73,0,inf
47115,57,5,62,0,inf
47116,55,10,65,0,inf
47117,52,8,60,0,inf
47118,55,5,60,0,inf
47119,62,7,69,0,inf
47120,52,13,65,0,inf
47121,55,12,67,0,inf
47122,66,12,78,0,inf
47123,55,6,61,0,inf
47124,58,7,65,0,inf
47125,65,8,73,0,inf
47126,52,8,60,0,inf
47127,51,12,63,0,inf
47128,53,6,59,0,inf
47129,61,8,69,0,inf
47130,63,10,73,0,inf
47131,62,10,72,0,inf
47132,67,5,72,0,inf
47133,54,7,61,1,0.6840130014425014
47134,52,7,59,0,inf
47135,60,13,73,0,inf
47136,64,12,76,0,inf
47137,54,12,66,0,inf
47138,63,12,75,0,inf
47139,61,9,70,0,inf
47140,60,13,73,0,inf
47141,59,7,66,0,inf
47142,56,13,69,0,inf
47143,55,6,61,0,inf
47144,52,9,61,0,inf
47145,50,9,59,0,inf
47146,52,9,61,0,inf
47147,54,11,65,0,inf
47148,66,6,72,0,inf
47149,53,10,63,0,inf
47150,62,9,71,0,inf
47151,55,8,63,0,inf
47152,58,11,69,0,inf
47153,66,8,74,0,inf
47154,54,5,59,0,inf
47155,63,6,69,0,inf
47156,50,9,59,0,inf
47157,62,13,75,0,inf
47158,54,7,61,0,inf
47159,55,9,64,0,inf
47160,50,6,56,0,inf
47161,59,7,66,0,inf
47162,63,5,68,0,inf
47163,67,5,72,0,inf
47164,53,5,58,0,inf
47165,58,11,69,0,inf
47166,60,12,72,0,inf
47167,50,5,55,0,inf
47168,53,8,61,0,inf
47169,54,7,61,0,inf
47170,65,5,70,0,inf
47171,54,5,59,0,inf
47172,55,8,63,0,inf
47173,52,5,57,0,inf
47174,59,7,66,0,inf
47175,51,7,58,0,inf
47176,57,10,67,0,inf
47177,52,12,64,0,inf
47178,65,9,74,0,inf
47179,65,9,74,0,inf
47180,55,6,61,0,inf
47181,59,7,66,0,inf
47182,58,13,71,0,inf
47183,59,6,65,0,inf
47184,64,13,77,0,inf
47185,50,5,55,0,inf
47186,62,9,71,0,inf
47187,53,9,62,0,inf
47188,66,10,76,0,inf
47189,51,5,56,0,inf
47190,58,8,66,0,inf
47191,60,7,67,0,inf
47192,54,7,61,0,inf
47193,61,9,70,1,6.749935292678984
47194,65,10,75,0,inf
47195,51,5,56,0,inf
47196,63,6,69,0,inf
47197,55,11,66,0,inf
47198,56,10,66,0,inf
47199,66,5,71,0,inf
47200,53,6,59,0,inf
47201,52,12,64,0,inf
47202,52,13,65,0,inf
47203,60,5,65,0,inf
47204,63,7,70,0,inf
47205,50,10,60,0,inf
47206,56,9,65,0,inf
47207,62,6,68,0,inf
47208,58,5,63,0,inf
47209,51,7,58,0,inf
47210,53,13,66,0,inf
47211,66,10,76,0,inf
47212,59,5,64,0,inf
47213,55,10,65,0,inf
47214,51,9,60,0,inf
47215,57,10,67,0,inf
47216,65,6,71,0,inf
47217,66,10,76,0,inf
47218,54,12,66,0,inf
47219,65,8,73,0,inf
47220,57,13,70,0,inf
47221,52,8,60,0,inf
47222,53,9,62,0,inf
47223,53,7,60,0,inf
47224,60,10,70,0,inf
47225,52,7,59,0,inf
47226,56,9,65,0,inf
47227,59,5,64,0,inf
47228,67,10,77,0,inf
47229,55,10,65,0,inf
47230,63,13,76,0,inf
47231,60,5,65,0,inf
47232,53,6,59,0,inf
47233,53,13,66,0,inf
47234,53,13,66,0,inf
47235,50,9,59,0,inf
47236,64,13,77,0,inf
47237,66,9,75,0,inf
47238,58,10,68,0,inf
47239,65,6,71,1,4.381460457318724
47240,62,13,75,0,inf
47241,66,12,78,0,inf
47242,53,5,58,0,inf
47243,50,11,61,0,inf
47244,55,10,65,0,inf
47245,58,10,68,0,inf
47246,64,7,71,0,inf
47247,57,11,68,0,inf
47248,61,5,66,0,inf
47249,51,6,57,0,inf
47250,52,8,60,0,inf
47251,63,10,73,0,inf
47252,65,7,72,0,inf
47253,55,5,60,0,inf
47254,65,5,70,0,inf
47255,65,7,72,0,inf
47256,67,5,72,0,inf
47257,61,6,67,0,inf
47258,61,10,71,0,inf
47259,65,13,78,0,inf
47260,65,11,76,0,inf
47261,63,7,70,0,inf
47262,66,11,77,0,inf
47263,51,12,63,0,inf
47264,56,10,66,0,inf
47265,64,11,75,0,inf
47266,60,13,73,0,inf
47267,55,7,62,0,inf
47268,63,7,70,0,inf
47269,65,11,76,0,inf
47270,64,9,73,0,inf
47271,50,13,63,0,inf
47272,53,9,62,0,inf
47273,66,8,74,0,inf
47274,64,7,71,0,inf
47275,59,11,70,0,inf
47276,62,7,69,0,inf
47277,63,5,68,0,inf
47278,62,5,67,0,inf
47279,59,7,66,0,inf
47280,62,5,67,0,inf
47281,58,12,70,0,inf
47282,55,9,64,0,inf
47283,52,9,61,0,inf
47284,63,8,71,0,inf
47285,51,13,64,1,6.4747435530189605
47286,54,10,64,0,inf
47287,59,5,64,0,inf
47288,54,6,60,0,inf
47289,64,9,73,0,inf
47290,61,8,69,0,inf
47291,51,10,61,0,inf
47292,51,11,62,0,inf
47293,50,9,59,0,inf
47294,59,11,70,0,inf
47295,53,8,61,0,inf
47296,63,8,71,0,inf
47297,50,5,55,0,inf
47298,58,8,66,0,inf
47299,66,11,77,0,inf
47300,52,11,63,0,inf
47301,54,7,61,0,inf
47302,55,8,63,0,inf
47303,55,10,65,0,inf
47304,67,12,79,0,inf
47305,62,10,72,0,inf
47306,60,8,68,0,inf
47307,56,10,66,0,inf
47308,63,13,76,0,inf
47309,66,13,79,0,inf
47310,60,9,69,0,inf
47311,65,11,76,0,inf
47312,62,8,70,0,inf
47313,61,13,74,0,inf
47314,50,11,61,0,inf
47315,67,12,79,0,inf
47316,64,11,75,1,7.81803660352314
47317,55,10,65,0,inf
47318,65,6,71,0,inf
47319,55,8,63,0,inf
47320,50,8,58,0,inf
47321,64,8,72,0,inf
47322,55,5,60,0,inf
47323,58,5,63,0,inf
47324,54,13,67,0,inf
47325,66,11,77,0,inf
47326,64,8,72,0,inf
47327,51,6,57,0,inf
47328,60,13,73,0,inf
47329,56,7,63,0,inf
47330,66,13,79,0,inf
47331,58,9,67,0,inf
47332,51,9,60,0,inf
47333,53,12,65,0,inf
47334,55,12,67,0,inf
47335,53,5,58,0,inf
47336,63,10,73,0,inf
47337,64,6,70,0,inf
47338,58,11,69,0,inf
47339,53,5,58,0,inf
47340,64,12,76,0,inf
47341,66,7,73,0,inf
47342,52,10,62,0,inf
47343,63,12,75,0,inf
47344,53,11,64,0,inf
47345,67,9,76,0,inf
47346,63,6,69,0,inf
47347,66,13,79,0,inf
47348,51,5,56,0,inf
47349,62,8,70,0,inf
47350,55,7,62,0,inf
47351,66,11,77,0,inf
47352,54,6,60,0,inf
47353,63,9,72,0,inf
47354,53,9,62,0,inf
47355,55,11,66,0,inf
47356,63,13,76,0,inf
47357,56,9,65,0,inf
47358,60,13,73,0,inf
47359,62,9,71,0,inf
47360,63,6,69,0,inf
47361,67,10,77,0,inf
47362,67,13,80,0,inf
47363,52,8,60,0,inf
47364,59,8,67,0,inf
47365,56,13,69,0,inf
47366,50,8,58,0,inf
47367,51,5,56,0,inf
47368,67,9,76,0,inf
47369,56,7,63,0,inf
47370,62,10,72,0,inf
47371,65,7,72,0,inf
47372,59,13,72,0,inf
47373,58,10,68,0,inf
47374,57,11,68,0,inf
47375,62,11,73,0,inf
47376,58,13,71,0,inf
47377,55,8,63,0,inf
47378,52,8,60,0,inf
47379,54,11,65,0,inf
47380,54,11,65,0,inf
47381,56,7,63,0,inf
47382,55,13,68,0,inf
47383,58,13,71,0,inf
47384,58,11,69,0,inf
47385,58,9,67,0,inf
47386,67,11,78,0,inf
47387,63,5,68,0,inf
47388,54,8,62,0,inf
47389,66,9,75,0,inf
47390,60,6,66,0,inf
47391,58,13,71,0,inf
47392,60,9,69,0,inf
47393,53,11,64,0,inf
47394,66,12,78,0,inf
47395,67,12,79,0,inf
47396,55,9,64,0,inf
47397,67,6,73,0,inf
47398,61,6,67,0,inf
47399,56,7,63,0,inf
47400,61,10,71,0,inf
47401,64,13,77,0,inf
47402,50,8,58,0,inf
47403,56,10,66,0,inf
47404,59,12,71,0,inf
47405,65,8,73,1,0.254847895876523
47406,53,8,61,0,inf
47407,51,13,64,0,inf
47408,66,5,71,0,inf
47409,65,6,71,0,inf
47410,64,10,74,0,inf
47411,56,8,64,0,inf
47412,66,5,71,0,inf
47413,62,5,67,0,inf
47414,51,8,59,0,inf
47415,64,9,73,0,inf
47416,64,7,71,0,inf
47417,52,8,60,0,inf
47418,63,5,68,0,inf
47419,53,11,64,0,inf
47420,52,11,63,0,inf
47421,59,9,68,0,inf
47422,50,9,59,0,inf
47423,54,8,62,0,inf
47424,57,10,67,0,inf
47425,67,12,79,0,inf
47426,54,12,66,0,inf
47427,63,12,75,0,inf
47428,51,10,61,0,inf
47429,63,5,68,0,inf
47430,61,9,70,0,inf
47431,59,11,70,0,inf
47432,54,7,61,0,inf
47433,60,6,66,0,inf
47434,61,11,72,0,inf
47435,55,6,61,0,inf
47436,63,7,70,0,inf
47437,67,8,75,0,inf
47438,53,9,62,0,inf
47439,66,5,71,0,inf
47440,63,9,72,0,inf
47441,64,9,73,0,inf
47442,51,12,63,0,inf
47443,64,10,74,0,inf
47444,52,5,57,0,inf
47445,60,11,71,0,inf
47446,63,12,75,0,inf
47447,63,7,70,0,inf
47448,57,10,67,0,inf
47449,61,9,70,1,2.1735190920541214
47450,63,13,76,0,inf
47451,50,12,62,0,inf
47452,59,7,66,0,inf
47453,61,12,73,0,inf
47454,51,6,57,0,inf
47455,59,12,71,0,inf
47456,63,13,76,0,inf
47457,66,9,75,0,inf
47458,58,13,71,1,7.803903776192826
47459,55,12,67,0,inf
47460,62,12,74,0,inf
47461,66,12,78,0,inf
47462,59,9,68,0,inf
47463,50,11,61,0,inf
47464,56,8,64,0,inf
47465,58,11,69,0,inf
47466,63,7,70,0,inf
47467,58,5,63,0,inf
47468,57,10,67,0,inf
47469,50,10,60,0,inf
47470,50,10,60,0,inf
47471,64,11,75,0,inf
47472,54,5,59,0,inf
47473,62,8,70,0,inf
47474,64,7,71,0,inf
47475,61,12,73,0,inf
47476,63,7,70,0,inf
47477,61,6,67,0,inf
47478,62,11,73,0,inf
47479,51,13,64,0,inf
47480,59,12,71,0,inf
47481,60,6,66,0,inf
47482,54,8,62,0,inf
47483,53,11,64,0,inf
47484,63,12,75,0,inf
47485,56,7,63,0,inf
47486,50,9,59,0,inf
47487,54,12,66,0,inf
47488,63,11,74,0,inf
47489,55,5,60,0,inf
47490,50,13,63,0,inf
47491,64,11,75,0,inf
47492,59,5,64,0,inf
47493,64,12,76,0,inf
47494,58,5,63,0,inf
47495,53,9,62,0,inf
47496,59,11,70,0,inf
47497,58,11,69,0,inf
47498,58,9,67,0,inf
47499,66,6,72,0,inf
47500,54,10,64,0,inf
47501,54,7,61,0,inf
47502,55,12,67,0,inf
47503,56,9,65,0,inf
47504,62,6,68,0,inf
47505,50,13,63,0,inf
47506,63,7,70,0,inf
47507,57,6,63,0,inf
47508,67,6,73,0,inf
47509,60,11,71,0,inf
47510,66,8,74,0,inf
47511,67,11,78,0,inf
47512,53,11,64,0,inf
47513,56,6,62,0,inf
47514,52,9,61,0,inf
47515,56,10,66,0,inf
47516,66,8,74,0,inf
47517,64,11,75,0,inf
47518,53,12,65,0,inf
47519,54,9,63,0,inf
47520,60,12,72,0,inf
47521,54,7,61,0,inf
47522,51,10,61,0,inf
47523,52,9,61,0,inf
47524,62,9,71,0,inf
47525,50,5,55,0,inf
47526,54,12,66,0,inf
47527,56,7,63,0,inf
47528,60,10,70,0,inf
47529,60,7,67,0,inf
47530,63,6,69,0,inf
47531,54,5,59,0,inf
47532,64,11,75,0,inf
47533,59,8,67,0,inf
47534,53,7,60,0,inf
47535,53,10,63,0,inf
47536,53,7,60,0,inf
47537,56,8,64,0,inf
47538,65,11,76,0,inf
47539,62,12,74,0,inf
47540,61,7,68,0,inf
47541,53,13,66,0,inf
47542,57,5,62,0,inf
47543,51,12,63,0,inf
47544,50,9,59,0,inf
47545,61,10,71,0,inf
47546,50,11,61,0,inf
47547,67,6,73,0,inf
47548,53,8,61,0,inf
47549,58,8,66,0,inf
47550,53,11,64,0,inf
47551,59,7,66,0,inf
47552,50,12,62,0,inf
47553,64,11,75,0,inf
47554,52,6,58,0,inf
47555,58,7,65,0,inf
47556,58,5,63,0,inf
47557,67,12,79,0,inf
47558,53,13,66,0,inf
47559,59,11,70,0,inf
47560,64,7,71,0,inf
47561,60,9,69,0,inf
47562,51,12,63,0,inf
47563,58,7,65,0,inf
47564,53,5,58,0,inf
47565,66,8,74,0,inf
47566,61,13,74,1,3.30256300040989
47567,60,9,69,0,inf
47568,59,9,68,0,inf
47569,66,6,72,0,inf
47570,52,11,63,0,inf
47571,65,11,76,0,inf
47572,67,10,77,0,inf
47573,52,12,64,0,inf
47574,66,5,71,0,inf
47575,64,12,76,0,inf
47576,62,9,71,0,inf
47577,59,8,67,0,inf
47578,55,12,67,0,inf
47579,64,8,72,1,4.042844460402378
47580,52,13,65,0,inf
47581,60,10,70,0,inf
47582,61,12,73,0,inf
47583,63,8,71,0,inf
47584,52,12,64,0,inf
47585,57,13,70,0,inf
47586,51,12,63,0,inf
47587,52,13,65,0,inf
47588,63,8,71,0,inf
47589,65,13,78,0,inf
47590,58,10,68,0,inf
47591,56,13,69,0,inf
47592,60,7,67,0,inf
47593,61,13,74,0,inf
47594,52,10,62,1,7.106845210801772
47595,50,13,63,0,inf
47596,66,7,73,0,inf
47597,52,7,59,0,inf
47598,60,7,67,0,inf
47599,64,6,70,0,inf
47600,67,8,75,0,inf
47601,61,10,71,0,inf
47602,63,10,73,0,inf
47603,63,13,76,0,inf
47604,65,10,75,0,inf
47605,55,6,61,0,inf
47606,58,12,70,0,inf
47607,58,9,67,0,inf
47608,51,12,63,0,inf
47609,62,11,73,0,inf
47610,64,6,70,0,inf
47611,60,6,66,0,inf
47612,59,12,71,0,inf
47613,65,8,73,0,inf
47614,57,10,67,0,inf
47615,59,6,65,0,inf
47616,50,12,62,0,inf
47617,50,12,62,0,inf
47618,50,5,55,0,inf
47619,52,10,62,0,inf
47620,59,13,72,0,inf
47621,52,9,61,0,inf
47622,50,9,59,1,0.05478979423683228
47623,52,12,64,0,inf
47624,64,7,71,0,inf
47625,60,7,67,0,inf
47626,54,10,64,1,9.696987902160139
47627,52,12,64,0,inf
47628,56,11,67,0,inf
47629,64,11,75,0,inf
47630,55,12,67,0,inf
47631,67,7,74,0,inf
47632,65,11,76,0,inf
47633,67,12,79,0,inf
47634,53,13,66,0,inf
47635,63,11,74,0,inf
47636,63,12,75,0,inf
47637,53,11,64,0,inf
47638,61,11,72,0,inf
47639,58,9,67,0,inf
47640,53,11,64,0,inf
47641,66,10,76,0,inf
47642,58,5,63,0,inf
47643,56,7,63,0,inf
47644,51,10,61,0,inf
47645,66,6,72,0,inf
47646,61,10,71,0,inf
47647,59,5,64,0,inf
47648,59,11,70,0,inf
47649,54,12,66,0,inf
47650,51,7,58,0,inf
47651,56,8,64,0,inf
47652,51,12,63,0,inf
47653,55,13,68,0,inf
47654,55,11,66,0,inf
47655,58,9,67,0,inf
47656,67,7,74,0,inf
47657,65,10,75,0,inf
47658,56,5,61,0,inf
47659,56,11,67,0,inf
47660,67,7,74,0,inf
47661,58,9,67,0,inf
47662,60,11,71,0,inf
47663,65,10,75,0,inf
47664,54,7,61,0,inf
47665,63,11,74,0,inf
47666,63,9,72,0,inf
47667,61,8,69,0,inf
47668,65,6,71,0,inf
47669,57,8,65,0,inf
47670,67,8,75,1,6.80848777107218
47671,59,12,71,0,inf
47672,60,5,65,0,inf
47673,51,10,61,0,inf
47674,67,6,73,0,inf
47675,61,7,68,0,inf
47676,58,12,70,0,inf
47677,61,10,71,0,inf
47678,59,7,66,0,inf
47679,54,12,66,0,inf
47680,53,13,66,0,inf
47681,67,8,75,0,inf
47682,57,10,67,0,inf
47683,62,7,69,0,inf
47684,61,8,69,0,inf
47685,61,8,69,0,inf
47686,62,5,67,0,inf
47687,53,13,66,0,inf
47688,66,10,76,0,inf
47689,51,5,56,0,inf
47690,56,8,64,0,inf
47691,52,6,58,0,inf
47692,52,9,61,0,inf
47693,52,9,61,0,inf
47694,65,13,78,0,inf
47695,64,9,73,0,inf
47696,54,13,67,0,inf
47697,50,13,63,0,inf
47698,51,7,58,0,inf
47699,65,11,76,0,inf
47700,64,8,72,0,inf
47701,67,7,74,0,inf
47702,62,9,71,0,inf
47703,50,9,59,0,inf
47704,66,10,76,0,inf
47705,60,6,66,0,inf
47706,55,6,61,0,inf
47707,56,11,67,0,inf
47708,64,9,73,0,inf
47709,60,7,67,0,inf
47710,64,9,73,0,inf
47711,56,13,69,0,inf
47712,56,5,61,0,inf
47713,52,6,58,0,inf
47714,51,7,58,0,inf
47715,61,6,67,0,inf
47716,63,11,74,0,inf
47717,53,6,59,0,inf
47718,58,12,70,1,8.927166510124536
47719,59,10,69,0,inf
47720,61,11,72,0,inf
47721,61,6,67,0,inf
47722,62,8,70,0,inf
47723,59,8,67,0,inf
47724,52,13,65,0,inf
47725,58,12,70,0,inf
47726,64,5,69,0,inf
47727,52,12,64,0,inf
47728,56,10,66,0,inf
47729,55,7,62,0,inf
47730,65,9,74,0,inf
47731,54,5,59,0,inf
47732,61,8,69,0,inf
47733,52,12,64,0,inf
47734,66,10,76,0,inf
47735,54,13,67,0,inf
47736,58,8,66,0,inf
47737,67,5,72,0,inf
47738,61,12,73,0,inf
47739,51,5,56,0,inf
47740,50,8,58,0,inf
47741,59,11,70,0,inf
47742,67,5,72,0,inf
47743,55,10,65,0,inf
47744,57,8,65,0,inf
47745,57,9,66,0,inf
47746,56,8,64,0,inf
47747,64,9,73,0,inf
47748,61,9,70,0,inf
47749,57,5,62,0,inf
47750,67,6,73,0,inf
47751,64,8,72,0,inf
47752,63,7,70,0,inf
47753,62,12,74,0,inf
47754,58,10,68,0,inf
47755,59,13,72,0,inf
47756,55,12,67,0,inf
47757,58,9,67,0,inf
47758,62,5,67,0,inf
47759,64,13,77,0,inf
47760,62,10,72,0,inf
47761,66,8,74,0,inf
47762,65,6,71,0,inf
47763,62,11,73,0,inf
47764,50,10,60,0,inf
47765,62,12,74,0,inf
47766,60,10,70,0,inf
47767,57,13,70,0,inf
47768,67,7,74,0,inf
47769,59,5,64,0,inf
47770,54,13,67,1,7.681412547259434
47771,65,7,72,0,inf
47772,66,9,75,0,inf
47773,57,10,67,0,inf
47774,57,13,70,0,inf
47775,55,7,62,0,inf
47776,53,5,58,0,inf
47777,67,12,79,0,inf
47778,53,13,66,0,inf
47779,57,10,67,0,inf
47780,55,12,67,0,inf
47781,61,11,72,0,inf
47782,62,13,75,0,inf
47783,62,13,75,0,inf
47784,51,8,59,0,inf
47785,62,5,67,0,inf
47786,61,7,68,0,inf
47787,64,7,71,0,inf
47788,67,10,77,0,inf
47789,59,10,69,0,inf
47790,55,7,62,1,6.957048818179089
47791,57,5,62,0,inf
47792,53,11,64,0,inf
47793,54,12,66,0,inf
47794,63,6,69,0,inf
47795,58,6,64,0,inf
47796,50,12,62,0,inf
47797,61,12,73,0,inf
47798,67,6,73,0,inf
47799,58,7,65,0,inf
47800,60,12,72,0,inf
47801,66,7,73,0,inf
47802,56,11,67,0,inf
47803,50,5,55,0,inf
47804,57,12,69,0,inf
47805,58,13,71,0,inf
47806,66,9,75,0,inf
47807,56,13,69,0,inf
47808,61,10,71,0,inf
47809,67,6,73,0,inf
47810,55,10,65,0,inf
47811,56,9,65,0,inf
47812,60,8,68,0,inf
47813,52,8,60,0,inf
47814,65,9,74,0,inf
47815,58,13,71,0,inf
47816,53,10,63,0,inf
47817,62,13,75,0,inf
47818,62,13,75,0,inf
47819,51,9,60,0,inf
47820,66,11,77,0,inf
47821,61,10,71,0,inf
47822,62,7,69,0,inf
47823,62,13,75,0,inf
47824,66,9,75,0,inf
47825,64,5,69,0,inf
47826,53,10,63,0,inf
47827,51,13,64,0,inf
47828,53,9,62,0,inf
47829,50,11,61,0,inf
47830,56,8,64,0,inf
47831,55,9,64,0,inf
47832,52,11,63,0,inf
47833,64,12,76,1,5.798752228206652
47834,52,11,63,0,inf
47835,58,12,70,0,inf
47836,65,11,76,0,inf
47837,50,5,55,0,inf
47838,54,9,63,0,inf
47839,62,7,69,0,inf
47840,67,5,72,0,inf
47841,51,10,61,0,inf
47842,53,9,62,0,inf
47843,65,11,76,0,inf
47844,63,8,71,0,inf
47845,54,6,60,0,inf
47846,67,10,77,0,inf
47847,66,6,72,0,inf
47848,58,13,71,0,inf
47849,58,13,71,0,inf
47850,50,10,60,0,inf
47851,51,8,59,0,inf
47852,63,11,74,0,inf
47853,60,13,73,0,inf
47854,66,5,71,0,inf
47855,66,10,76,0,inf
47856,61,11,72,0,inf
47857,50,8,58,0,inf
47858,60,9,69,0,inf
47859,64,6,70,1,1.8731219317060805
47860,56,7,63,0,inf
47861,67,9,76,0,inf
47862,50,9,59,0,inf
47863,52,10,62,0,inf
47864,65,12,77,0,inf
47865,64,5,69,0,inf
47866,50,6,56,0,inf
47867,56,9,65,0,inf
47868,59,13,72,0,inf
47869,57,5,62,0,inf
47870,67,5,72,0,inf
47871,62,7,69,0,inf
47872,57,9,66,0,inf
47873,55,6,61,0,inf
47874,58,8,66,0,inf
47875,66,6,72,0,inf
47876,52,11,63,0,inf
47877,52,13,65,0,inf
47878,56,10,66,0,inf
47879,61,7,68,0,inf
47880,51,7,58,0,inf
47881,54,5,59,0,inf
47882,54,11,65,0,inf
47883,54,9,63,0,inf
47884,65,12,77,0,inf
47885,67,12,79,0,inf
47886,65,12,77,0,inf
47887,56,11,67,0,inf
47888,59,8,67,0,inf
47889,57,11,68,0,inf
47890,55,12,67,0,inf
47891,55,9,64,0,inf
47892,52,5,57,0,inf
47893,63,12,75,0,inf
47894,52,9,61,0,inf
47895,59,10,69,0,inf
47896,50,8,58,0,inf
47897,56,5,61,0,inf
47898,64,10,74,0,inf
47899,51,7,58,0,inf
47900,63,13,76,0,inf
47901,63,13,76,0,inf
47902,65,11,76,0,inf
47903,63,7,70,0,inf
47904,64,11,75,0,inf
47905,66,11,77,0,inf
47906,65,8,73,0,inf
47907,58,13,71,1,4.891524684751502
47908,54,5,59,0,inf
47909,66,13,79,0,inf
47910,62,6,68,0,inf
47911,51,7,58,0,inf
47912,59,8,67,0,inf
47913,67,5,72,0,inf
47914,65,5,70,0,inf
47915,51,11,62,0,inf
47916,51,12,63,0,inf
47917,67,9,76,0,inf
47918,55,12,67,0,inf
47919,63,6,69,0,inf
47920,57,5,62,0,inf
47921,59,9,68,0,inf
47922,51,9,60,0,inf
47923,59,13,72,0,inf
47924,66,9,75,0,inf
47925,58,8,66,0,inf
47926,64,7,71,0,inf
47927,65,8,73,0,inf
47928,56,5,61,0,inf
47929,65,10,75,0,inf
47930,50,11,61,0,inf
47931,61,12,73,1,0.6541159289539351
47932,59,9,68,0,inf
47933,67,11,78,0,inf
47934,59,5,64,0,inf
47935,54,7,61,0,inf
47936,62,7,69,0,inf
47937,51,8,59,0,inf
47938,62,13,75,0,inf
47939,61,7,68,0,inf
47940,51,9,60,0,inf
47941,53,12,65,0,inf
47942,65,13,78,0,inf
47943,51,11,62,0,inf
47944,57,6,63,0,inf
47945,62,8,70,0,inf
47946,60,6,66,0,inf
47947,61,8,69,0,inf
47948,51,9,60,0,inf
47949,64,12,76,0,inf
47950,66,12,78,0,inf
47951,52,7,59,1,1.8684156268891456
47952,50,10,60,1,0.4249751599878593
47953,64,11,75,0,inf
47954,55,5,60,0,inf
47955,58,6,64,0,inf
47956,58,6,64,0,inf
47957,64,10,74,0,inf
47958,55,10,65,0,inf
47959,53,8,61,0,inf
47960,52,8,60,0,inf
47961,63,6,69,0,inf
47962,55,12,67,0,inf
47963,63,10,73,0,inf
47964,60,8,68,0,inf
47965,60,8,68,0,inf
47966,55,8,63,0,inf
47967,61,5,66,0,inf
47968,59,6,65,0,inf
47969,58,7,65,0,inf
47970,53,11,64,0,inf
47971,52,10,62,0,inf
47972,65,11,76,0,inf
47973,56,10,66,0,inf
47974,53,7,60,0,inf
47975,50,7,57,0,inf
47976,62,12,74,0,inf
47977,53,7,60,0,inf
47978,55,12,67,0,inf
47979,59,5,64,0,inf
47980,58,9,67,0,inf
47981,57,5,62,0,inf
47982,65,8,73,0,inf
47983,56,13,69,1,2.2233276252548535
47984,51,10,61,0,inf
47985,66,6,72,0,inf
47986,66,13,79,0,inf
47987,64,10,74,0,inf
47988,50,9,59,0,inf
47989,61,10,71,0,inf
47990,65,11,76,0,inf
47991,52,6,58,0,inf
47992,56,9,65,0,inf
47993,64,5,69,0,inf
47994,63,6,69,0,inf
47995,54,9,63,0,inf
47996,64,11,75,0,inf
47997,52,5,57,0,inf
47998,50,7,57,0,inf
47999,67,12,79,0,inf
48000,58,7,65,0,inf
48001,58,9,67,0,inf
48002,53,12,65,0,inf
48003,65,8,73,0,inf
48004,55,7,62,0,inf
48005,55,13,68,0,inf
48006,60,7,67,0,inf
48007,50,13,63,0,inf
48008,52,9,61,0,inf
48009,61,8,69,0,inf
48010,50,5,55,0,inf
48011,65,9,74,0,inf
48012,58,9,67,1,1.9943982417648982
48013,57,8,65,0,inf
48014,55,7,62,0,inf
48015,62,10,72,0,inf
48016,67,9,76,0,inf
48017,53,12,65,0,inf
48018,51,5,56,0,inf
48019,59,11,70,0,inf
48020,52,13,65,0,inf
48021,55,5,60,0,inf
48022,64,11,75,0,inf
48023,66,8,74,0,inf
48024,57,5,62,0,inf
48025,51,9,60,0,inf
48026,67,12,79,0,inf
48027,64,13,77,0,inf
48028,50,10,60,0,inf
48029,57,10,67,0,inf
48030,53,6,59,0,inf
48031,58,12,70,0,inf
48032,55,5,60,1,1.9776494895265415
48033,50,5,55,0,inf
48034,63,6,69,0,inf
48035,62,9,71,0,inf
48036,54,11,65,0,inf
48037,63,11,74,1,3.932734467972111
48038,67,8,75,0,inf
48039,62,13,75,0,inf
48040,51,12,63,0,inf
48041,62,11,73,0,inf
48042,63,5,68,0,inf
48043,54,5,59,0,inf
48044,64,9,73,0,inf
48045,56,10,66,0,inf
48046,57,12,69,1,9.131745246039856
48047,51,12,63,0,inf
48048,55,10,65,0,inf
48049,67,6,73,0,inf
48050,63,5,68,0,inf
48051,60,6,66,0,inf
48052,52,10,62,0,inf
48053,60,8,68,0,inf
48054,66,8,74,0,inf
48055,54,10,64,0,inf
48056,63,7,70,0,inf
48057,53,7,60,0,inf
48058,63,11,74,0,inf
48059,58,9,67,0,inf
48060,50,5,55,0,inf
48061,52,12,64,0,inf
48062,53,10,63,0,inf
48063,54,10,64,0,inf
48064,56,9,65,0,inf
48065,67,6,73,0,inf
48066,62,9,71,0,inf
48067,63,7,70,0,inf
48068,67,12,79,0,inf
48069,66,12,78,0,inf
48070,56,10,66,0,inf
48071,55,7,62,0,inf
48072,52,8,60,0,inf
48073,58,11,69,0,inf
48074,64,13,77,0,inf
48075,63,8,71,0,inf
48076,58,11,69,0,inf
48077,55,9,64,0,inf
48078,58,11,69,0,inf
48079,64,12,76,0,inf
48080,58,7,65,0,inf
48081,52,5,57,0,inf
48082,53,9,62,0,inf
48083,60,10,70,0,inf
48084,58,6,64,0,inf
48085,59,13,72,0,inf
48086,53,13,66,0,inf
48087,65,5,70,0,inf
48088,64,5,69,0,inf
48089,60,11,71,0,inf
48090,64,5,69,0,inf
48091,57,5,62,0,inf
48092,63,5,68,0,inf
48093,65,10,75,0,inf
48094,59,6,65,0,inf
48095,66,10,76,0,inf
48096,52,11,63,0,inf
48097,50,10,60,0,inf
48098,65,12,77,0,inf
48099,51,6,57,0,inf
48100,59,12,71,0,inf
48101,55,5,60,0,inf
48102,53,11,64,0,inf
48103,53,12,65,0,inf
48104,57,11,68,0,inf
48105,64,8,72,0,inf
48106,63,11,74,0,inf
48107,51,9,60,0,inf
48108,56,10,66,0,inf
48109,62,7,69,0,inf
48110,56,10,66,1,3.1496681704504326
48111,61,12,73,0,inf
48112,64,7,71,0,inf
48113,63,13,76,0,inf
48114,59,13,72,0,inf
48115,60,10,70,0,inf
48116,51,6,57,0,inf
48117,59,13,72,0,inf
48118,50,6,56,0,inf
48119,57,8,65,0,inf
48120,67,6,73,0,inf
48121,67,9,76,0,inf
48122,51,10,61,0,inf
48123,50,11,61,0,inf
48124,55,9,64,0,inf
48125,58,7,65,0,inf
48126,62,10,72,0,inf
48127,58,11,69,0,inf
48128,57,8,65,0,inf
48129,56,5,61,0,inf
48130,63,11,74,0,inf
48131,66,10,76,0,inf
48132,52,10,62,0,inf
48133,58,10,68,0,inf
48134,59,5,64,0,inf
48135,67,5,72,0,inf
48136,58,9,67,0,inf
48137,65,10,75,0,inf
48138,52,6,58,0,inf
48139,67,6,73,0,inf
48140,55,5,60,0,inf
48141,61,11,72,0,inf
48142,55,8,63,0,inf
48143,55,13,68,0,inf
48144,67,9,76,1,4.678611336960188
48145,65,5,70,0,inf
48146,59,11,70,0,inf
48147,53,10,63,1,7.56144954176429
48148,56,10,66,0,inf
48149,65,11,76,0,inf
48150,63,11,74,0,inf
48151,64,11,75,0,inf
48152,65,5,70,0,inf
48153,62,6,68,0,inf
48154,53,7,60,0,inf
48155,65,11,76,0,inf
48156,58,8,66,0,inf
48157,56,10,66,0,inf
48158,57,7,64,0,inf
48159,65,13,78,0,inf
48160,63,8,71,0,inf
48161,51,7,58,0,inf
48162,63,7,70,0,inf
48163,56,9,65,0,inf
48164,59,9,68,0,inf
48165,50,9,59,0,inf
48166,56,11,67,0,inf
48167,58,10,68,0,inf
48168,51,6,57,0,inf
48169,52,11,63,0,inf
48170,52,6,58,0,inf
48171,57,11,68,0,inf
48172,60,9,69,0,inf
48173,67,13,80,0,inf
48174,54,12,66,0,inf
48175,67,13,80,0,inf
48176,59,7,66,0,inf
48177,60,12,72,0,inf
48178,50,12,62,0,inf
48179,52,11,63,0,inf
48180,62,11,73,0,inf
48181,67,13,80,0,inf
48182,50,6,56,0,inf
48183,67,13,80,0,inf
48184,64,10,74,0,inf
48185,62,6,68,0,inf
48186,65,10,75,0,inf
48187,52,7,59,0,inf
48188,51,8,59,0,inf
48189,60,8,68,0,inf
48190,51,8,59,0,inf
48191,67,8,75,0,inf
48192,54,6,60,0,inf
48193,50,7,57,0,inf
48194,65,9,74,0,inf
48195,62,13,75,0,inf
48196,55,12,67,0,inf
48197,63,6,69,0,inf
48198,57,12,69,0,inf
48199,64,6,70,0,inf
48200,65,5,70,0,inf
48201,51,13,64,0,inf
48202,67,6,73,0,inf
48203,58,10,68,0,inf
48204,64,13,77,0,inf
48205,54,9,63,0,inf
48206,66,8,74,0,inf
48207,52,13,65,0,inf
48208,65,9,74,0,inf
48209,62,6,68,0,inf
48210,56,6,62,0,inf
48211,53,11,64,0,inf
48212,54,6,60,0,inf
48213,58,7,65,0,inf
48214,53,11,64,0,inf
48215,53,7,60,0,inf
48216,62,13,75,0,inf
48217,59,5,64,0,inf
48218,60,8,68,1,1.7038635600243595
48219,65,9,74,0,inf
48220,62,6,68,0,inf
48221,63,13,76,0,inf
48222,56,6,62,0,inf
48223,63,9,72,1,1.5426932670614804
48224,60,13,73,0,inf
48225,56,6,62,0,inf
48226,52,8,60,0,inf
48227,63,8,71,0,inf
48228,54,5,59,0,inf
48229,52,12,64,0,inf
48230,59,12,71,0,inf
48231,66,7,73,0,inf
48232,60,8,68,0,inf
48233,58,6,64,0,inf
48234,65,6,71,0,inf
48235,63,11,74,0,inf
48236,64,12,76,0,inf
48237,57,8,65,0,inf
48238,50,10,60,0,inf
48239,66,6,72,0,inf
48240,63,11,74,0,inf
48241,50,8,58,0,inf
48242,56,9,65,0,inf
48243,50,9,59,0,inf
48244,67,7,74,0,inf
48245,50,6,56,0,inf
48246,66,7,73,0,inf
48247,54,8,62,0,inf
48248,67,5,72,0,inf
48249,65,13,78,0,inf
48250,66,11,77,0,inf
48251,65,9,74,0,inf
48252,64,5,69,0,inf
48253,57,8,65,0,inf
48254,64,7,71,0,inf
48255,52,11,63,0,inf
48256,63,13,76,0,inf
48257,65,11,76,0,inf
48258,52,7,59,0,inf
48259,61,7,68,0,inf
48260,66,7,73,0,inf
48261,61,13,74,0,inf
48262,53,7,60,0,inf
48263,61,6,67,0,inf
48264,67,8,75,1,1.6323932230585
48265,67,7,74,0,inf
48266,53,9,62,0,inf
48267,50,8,58,0,inf
48268,55,12,67,1,4.1092390426205085
48269,58,13,71,0,inf
48270,54,8,62,0,inf
48271,61,8,69,0,inf
48272,60,7,67,0,inf
48273,50,13,63,0,inf
48274,51,6,57,0,inf
48275,51,8,59,0,inf
48276,51,6,57,0,inf
48277,62,6,68,0,inf
48278,58,12,70,0,inf
48279,63,7,70,0,inf
48280,58,6,64,0,inf
48281,55,6,61,0,inf
48282,62,13,75,0,inf
48283,59,13,72,0,inf
48284,62,11,73,0,inf
48285,67,6,73,0,inf
48286,60,10,70,0,inf
48287,56,8,64,0,inf
48288,66,5,71,0,inf
48289,51,5,56,0,inf
48290,66,7,73,0,inf
48291,65,11,76,0,inf
48292,59,8,67,0,inf
48293,63,7,70,1,1.6360849393547312
48294,61,7,68,0,inf
48295,63,12,75,0,inf
48296,60,11,71,0,inf
48297,66,12,78,1,1.7346886369700485
48298,67,11,78,0,inf
48299,66,10,76,0,inf
48300,65,5,70,0,inf
48301,61,9,70,0,inf
48302,65,5,70,0,inf
48303,63,12,75,0,inf
48304,61,7,68,0,inf
48305,54,9,63,0,inf
48306,54,9,63,0,inf
48307,60,12,72,0,inf
48308,52,9,61,0,inf
48309,55,9,64,0,inf
48310,64,13,77,0,inf
48311,60,11,71,0,inf
48312,54,11,65,0,inf
48313,60,10,70,0,inf
48314,60,6,66,0,inf
48315,58,13,71,0,inf
48316,64,9,73,0,inf
48317,50,8,58,0,inf
48318,63,12,75,0,inf
48319,61,8,69,0,inf
48320,58,11,69,0,inf
48321,65,12,77,0,inf
48322,58,6,64,0,inf
48323,54,10,64,0,inf
48324,54,7,61,0,inf
48325,57,13,70,0,inf
48326,63,13,76,1,3.612868714533789
48327,67,7,74,0,inf
48328,51,6,57,0,inf
48329,61,9,70,0,inf
48330,58,11,69,0,inf
48331,52,8,60,0,inf
48332,58,8,66,0,inf
48333,66,5,71,0,inf
48334,64,13,77,0,inf
48335,62,7,69,0,inf
48336,65,13,78,0,inf
48337,54,5,59,0,inf
48338,64,8,72,0,inf
48339,66,5,71,0,inf
48340,58,12,70,0,inf
48341,50,7,57,0,inf
48342,51,9,60,0,inf
48343,51,6,57,0,inf
48344,53,5,58,0,inf
48345,64,8,72,0,inf
48346,67,13,80,0,inf
48347,61,8,69,0,inf
48348,59,7,66,0,inf
48349,51,10,61,0,inf
48350,64,12,76,0,inf
48351,64,11,75,0,inf
48352,56,9,65,0,inf
48353,56,5,61,0,inf
48354,53,5,58,0,inf
48355,57,11,68,0,inf
48356,60,9,69,0,inf
48357,53,5,58,0,inf
48358,61,5,66,0,inf
48359,64,8,72,0,inf
48360,61,10,71,0,inf
48361,65,11,76,0,inf
48362,61,6,67,0,inf
48363,65,5,70,0,inf
48364,54,7,61,0,inf
48365,52,8,60,0,inf
48366,55,5,60,0,inf
48367,62,10,72,0,inf
48368,66,11,77,0,inf
48369,64,12,76,0,inf
48370,58,9,67,0,inf
48371,51,5,56,0,inf
48372,54,5,59,0,inf
48373,66,9,75,0,inf
48374,51,6,57,0,inf
48375,59,5,64,0,inf
48376,52,13,65,0,inf
48377,62,9,71,0,inf
48378,55,13,68,0,inf
48379,53,7,60,0,inf
48380,50,8,58,0,inf
48381,61,11,72,0,inf
48382,61,13,74,0,inf
48383,52,10,62,0,inf
48384,52,7,59,0,inf
48385,54,8,62,0,inf
48386,53,8,61,0,inf
48387,59,13,72,0,inf
48388,56,9,65,0,inf
48389,55,11,66,0,inf
48390,65,12,77,0,inf
48391,53,5,58,0,inf
48392,50,9,59,0,inf
48393,52,8,60,0,inf
48394,62,13,75,0,inf
48395,62,8,70,0,inf
48396,59,8,67,0,inf
48397,61,12,73,0,inf
48398,59,12,71,0,inf
48399,53,5,58,0,inf
48400,67,7,74,0,inf
48401,63,7,70,0,inf
48402,66,6,72,0,inf
48403,55,9,64,0,inf
48404,53,6,59,0,inf
48405,54,8,62,0,inf
48406,52,11,63,1,4.217164379358934
48407,59,12,71,0,inf
48408,57,11,68,0,inf
48409,63,9,72,0,inf
48410,54,10,64,0,inf
48411,59,10,69,0,inf
48412,66,13,79,0,inf
48413,52,12,64,0,inf
48414,59,9,68,0,inf
48415,63,6,69,0,inf
48416,56,6,62,0,inf
48417,52,12,64,0,inf
48418,50,11,61,0,inf
48419,54,10,64,0,inf
48420,52,7,59,0,inf
48421,51,13,64,0,inf
48422,67,13,80,0,inf
48423,54,10,64,0,inf
48424,67,12,79,0,inf
48425,62,11,73,0,inf
48426,55,6,61,0,inf
48427,65,11,76,0,inf
48428,65,10,75,0,inf
48429,55,6,61,0,inf
48430,50,11,61,0,inf
48431,59,5,64,0,inf
48432,61,5,66,0,inf
48433,55,8,63,0,inf
48434,57,12,69,1,3.479056811697518
48435,54,8,62,0,inf
48436,65,6,71,0,inf
48437,66,10,76,0,inf
48438,66,9,75,0,inf
48439,66,10,76,0,inf
48440,52,8,60,0,inf
48441,63,10,73,0,inf
48442,56,12,68,0,inf
48443,64,11,75,0,inf
48444,57,8,65,0,inf
48445,59,9,68,0,inf
48446,60,8,68,0,inf
48447,54,9,63,0,inf
48448,50,13,63,0,inf
48449,65,10,75,0,inf
48450,66,7,73,0,inf
48451,51,9,60,0,inf
48452,63,11,74,0,inf
48453,59,10,69,0,inf
48454,54,13,67,0,inf
48455,55,7,62,0,inf
48456,56,12,68,0,inf
48457,50,13,63,1,9.623814323677138
48458,56,6,62,0,inf
48459,67,9,76,0,inf
48460,64,10,74,0,inf
48461,53,10,63,0,inf
48462,61,13,74,1,10.153023482174234
48463,50,5,55,0,inf
48464,58,13,71,0,inf
48465,58,5,63,0,inf
48466,53,10,63,0,inf
48467,54,6,60,0,inf
48468,52,10,62,0,inf
48469,61,11,72,1,0.9281544788427496
48470,50,8,58,0,inf
48471,64,6,70,0,inf
48472,65,10,75,0,inf
48473,57,10,67,0,inf
48474,59,11,70,0,inf
48475,54,13,67,0,inf
48476,56,7,63,0,inf
48477,53,7,60,0,inf
48478,59,13,72,0,inf
48479,63,13,76,0,inf
48480,66,11,77,0,inf
48481,65,8,73,0,inf
48482,63,12,75,0,inf
48483,60,8,68,0,inf
48484,65,10,75,0,inf
48485,56,13,69,0,inf
48486,67,13,80,0,inf
48487,60,7,67,0,inf
48488,58,11,69,0,inf
48489,66,9,75,0,inf
48490,58,13,71,0,inf
48491,67,11,78,0,inf
48492,67,6,73,0,inf
48493,50,9,59,0,inf
48494,62,12,74,0,inf
48495,55,9,64,0,inf
48496,60,8,68,0,inf
48497,51,12,63,0,inf
48498,58,7,65,0,inf
48499,51,9,60,1,8.20604474821846
48500,56,7,63,0,inf
48501,63,13,76,0,inf
48502,56,10,66,0,inf
48503,64,5,69,0,inf
48504,57,11,68,0,inf
48505,50,8,58,0,inf
48506,67,11,78,0,inf
48507,55,7,62,0,inf
48508,61,7,68,0,inf
48509,58,10,68,0,inf
48510,60,12,72,0,inf
48511,51,5,56,0,inf
48512,66,11,77,0,inf
48513,66,5,71,0,inf
48514,58,12,70,0,inf
48515,58,7,65,0,inf
48516,57,7,64,0,inf
48517,57,9,66,1,5.494430056558549
48518,53,11,64,0,inf
48519,58,5,63,0,inf
48520,55,7,62,0,inf
48521,67,6,73,0,inf
48522,63,13,76,0,inf
48523,52,9,61,0,inf
48524,50,11,61,0,inf
48525,63,10,73,0,inf
48526,54,9,63,0,inf
48527,54,7,61,0,inf
48528,58,8,66,0,inf
48529,64,8,72,0,inf
48530,60,9,69,0,inf
48531,66,6,72,0,inf
48532,65,13,78,0,inf
48533,50,5,55,0,inf
48534,66,8,74,0,inf
48535,52,5,57,0,inf
48536,66,7,73,0,inf
48537,56,9,65,0,inf
48538,59,7,66,0,inf
48539,62,8,70,0,inf
48540,57,7,64,0,inf
48541,51,9,60,0,inf
48542,53,10,63,0,inf
48543,61,10,71,0,inf
48544,66,8,74,0,inf
48545,51,12,63,0,inf
48546,55,8,63,0,inf
48547,58,13,71,0,inf
48548,51,13,64,0,inf
48549,60,9,69,0,inf
48550,66,8,74,0,inf
48551,52,8,60,0,inf
48552,64,9,73,0,inf
48553,51,11,62,0,inf
48554,57,8,65,0,inf
48555,52,11,63,0,inf
48556,65,12,77,1,4.968374193267422
48557,61,11,72,0,inf
48558,63,7,70,0,inf
48559,51,13,64,1,3.8932973735385943
48560,53,9,62,0,inf
48561,66,11,77,0,inf
48562,58,7,65,0,inf
48563,54,12,66,0,inf
48564,50,6,56,0,inf
48565,66,12,78,0,inf
48566,61,13,74,0,inf
48567,57,10,67,0,inf
48568,59,11,70,0,inf
48569,59,10,69,0,inf
48570,65,9,74,0,inf
48571,60,5,65,0,inf
48572,67,12,79,0,inf
48573,53,6,59,0,inf
48574,61,12,73,0,inf
48575,63,12,75,0,inf
48576,62,9,71,0,inf
48577,58,13,71,0,inf
48578,56,9,65,0,inf
48579,52,6,58,0,inf
48580,56,8,64,0,inf
48581,59,13,72,0,inf
48582,62,6,68,0,inf
48583,59,10,69,0,inf
48584,62,13,75,0,inf
48585,63,6,69,0,inf
48586,50,5,55,0,inf
48587,53,7,60,0,inf
48588,50,8,58,0,inf
48589,61,5,66,0,inf
48590,57,11,68,0,inf
48591,54,7,61,0,inf
48592,66,11,77,0,inf
48593,55,5,60,0,inf
48594,50,11,61,0,inf
48595,61,9,70,0,inf
48596,62,8,70,0,inf
48597,64,5,69,0,inf
48598,54,5,59,0,inf
48599,54,8,62,0,inf
48600,63,10,73,0,inf
48601,56,5,61,0,inf
48602,62,5,67,0,inf
48603,55,8,63,0,inf
48604,59,11,70,0,inf
48605,65,6,71,0,inf
48606,57,12,69,0,inf
48607,65,12,77,0,inf
48608,53,11,64,0,inf
48609,62,10,72,1,7.726324791354784
48610,65,10,75,0,inf
48611,57,12,69,0,inf
48612,63,10,73,0,inf
48613,55,10,65,0,inf
48614,66,6,72,0,inf
48615,54,11,65,0,inf
48616,66,10,76,0,inf
48617,64,11,75,0,inf
48618,54,13,67,0,inf
48619,59,8,67,0,inf
48620,56,9,65,0,inf
48621,52,8,60,0,inf
48622,59,8,67,0,inf
48623,63,10,73,0,inf
48624,58,12,70,0,inf
48625,55,9,64,0,inf
48626,62,7,69,0,inf
48627,60,13,73,0,inf
48628,63,9,72,0,inf
48629,56,9,65,0,inf
48630,62,11,73,0,inf
48631,59,10,69,0,inf
48632,52,8,60,0,inf
48633,57,11,68,0,inf
48634,65,5,70,0,inf
48635,55,12,67,0,inf
48636,50,8,58,0,inf
48637,58,7,65,0,inf
48638,53,8,61,0,inf
48639,67,10,77,0,inf
48640,64,6,70,0,inf
48641,51,10,61,0,inf
48642,54,10,64,0,inf
48643,52,12,64,0,inf
48644,59,5,64,1,4.298761635502238
48645,67,5,72,0,inf
48646,65,7,72,0,inf
48647,62,8,70,0,inf
48648,65,5,70,0,inf
48649,62,6,68,0,inf
48650,51,13,64,0,inf
48651,65,9,74,0,inf
48652,59,11,70,0,inf
48653,63,10,73,0,inf
48654,55,10,65,0,inf
48655,61,13,74,0,inf
48656,50,11,61,0,inf
48657,60,9,69,0,inf
48658,52,8,60,0,inf
48659,58,6,64,0,inf
48660,61,7,68,0,inf
48661,64,6,70,0,inf
48662,50,11,61,0,inf
48663,55,10,65,0,inf
48664,62,5,67,0,inf
48665,63,11,74,0,inf
48666,62,8,70,0,inf
48667,50,10,60,0,inf
48668,66,7,73,0,inf
48669,66,13,79,0,inf
48670,63,8,71,0,inf
48671,62,5,67,0,inf
48672,55,7,62,0,inf
48673,67,13,80,0,inf
48674,62,7,69,0,inf
48675,63,10,73,0,inf
48676,58,10,68,0,inf
48677,64,6,70,0,inf
48678,61,11,72,0,inf
48679,60,7,67,0,inf
48680,58,12,70,0,inf
48681,50,8,58,0,inf
48682,53,11,64,0,inf
48683,61,10,71,0,inf
48684,62,9,71,0,inf
48685,50,12,62,0,inf
48686,62,9,71,0,inf
48687,61,13,74,0,inf
48688,55,7,62,0,inf
48689,54,8,62,0,inf
48690,60,12,72,0,inf
48691,65,9,74,0,inf
48692,62,7,69,0,inf
48693,53,9,62,0,inf
48694,53,13,66,0,inf
48695,64,12,76,0,inf
48696,66,7,73,0,inf
48697,61,13,74,0,inf
48698,58,6,64,0,inf
48699,50,13,63,0,inf
48700,55,5,60,0,inf
48701,56,5,61,0,inf
48702,60,9,69,0,inf
48703,59,13,72,0,inf
48704,65,10,75,0,inf
48705,58,5,63,0,inf
48706,56,10,66,0,inf
48707,67,12,79,0,inf
48708,57,8,65,0,inf
48709,57,6,63,0,inf
48710,52,7,59,0,inf
48711,58,9,67,0,inf
48712,50,11,61,1,8.219873340390528
48713,58,6,64,0,inf
48714,65,8,73,0,inf
48715,60,8,68,0,inf
48716,61,12,73,0,inf
48717,63,5,68,0,inf
48718,55,10,65,0,inf
48719,50,12,62,0,inf
48720,61,5,66,0,inf
48721,56,8,64,0,inf
48722,51,7,58,0,inf
48723,53,6,59,0,inf
48724,56,13,69,0,inf
48725,61,8,69,0,inf
48726,58,9,67,0,inf
48727,52,12,64,0,inf
48728,65,9,74,0,inf
48729,61,12,73,0,inf
48730,52,10,62,0,inf
48731,64,7,71,0,inf
48732,58,7,65,0,inf
48733,62,10,72,0,inf
48734,56,8,64,0,inf
48735,62,9,71,0,inf
48736,60,9,69,0,inf
48737,58,13,71,0,inf
48738,52,6,58,0,inf
48739,52,7,59,0,inf
48740,50,10,60,0,inf
48741,58,9,67,0,inf
48742,67,8,75,0,inf
48743,51,9,60,0,inf
48744,61,5,66,0,inf
48745,64,6,70,0,inf
48746,52,10,62,0,inf
48747,62,12,74,0,inf
48748,50,6,56,0,inf
48749,60,13,73,0,inf
48750,52,12,64,1,2.1102983911740054
48751,56,11,67,0,inf
48752,67,5,72,0,inf
48753,56,9,65,0,inf
48754,65,8,73,0,inf
48755,64,13,77,0,inf
48756,50,11,61,0,inf
48757,53,9,62,0,inf
48758,58,11,69,0,inf
48759,56,8,64,0,inf
48760,58,10,68,0,inf
48761,67,12,79,0,inf
48762,57,12,69,0,inf
48763,56,5,61,0,inf
48764,51,6,57,0,inf
48765,63,12,75,0,inf
48766,53,9,62,0,inf
48767,62,12,74,0,inf
48768,53,13,66,0,inf
48769,50,12,62,0,inf
48770,58,8,66,0,inf
48771,53,6,59,0,inf
48772,60,7,67,0,inf
48773,50,5,55,0,inf
48774,55,7,62,0,inf
48775,53,7,60,0,inf
48776,61,6,67,0,inf
48777,64,10,74,0,inf
48778,50,5,55,0,inf
48779,51,6,57,0,inf
48780,59,9,68,0,inf
48781,66,10,76,0,inf
48782,59,12,71,0,inf
48783,65,13,78,0,inf
48784,58,13,71,0,inf
48785,66,12,78,0,inf
48786,53,8,61,0,inf
48787,62,12,74,1,4.885706377523206
48788,60,7,67,0,inf
48789,55,10,65,0,inf
48790,64,9,73,0,inf
48791,60,11,71,0,inf
48792,58,9,67,0,inf
48793,59,6,65,0,inf
48794,53,6,59,0,inf
48795,59,10,69,0,inf
48796,51,10,61,1,7.022374951193548
48797,62,6,68,0,inf
48798,62,12,74,0,inf
48799,67,11,78,0,inf
48800,60,12,72,0,inf
48801,51,12,63,0,inf
48802,53,10,63,0,inf
48803,62,6,68,0,inf
48804,65,7,72,0,inf
48805,63,11,74,0,inf
48806,58,13,71,0,inf
48807,50,11,61,0,inf
48808,57,8,65,0,inf
48809,63,6,69,0,inf
48810,66,10,76,0,inf
48811,66,11,77,0,inf
48812,62,13,75,0,inf
48813,63,8,71,0,inf
48814,50,5,55,0,inf
48815,66,11,77,0,inf
48816,57,5,62,0,inf
48817,56,9,65,0,inf
48818,57,7,64,0,inf
48819,57,6,63,0,inf
48820,57,10,67,1,9.76679555291777
48821,53,6,59,0,inf
48822,57,7,64,0,inf
48823,59,13,72,0,inf
48824,57,13,70,0,inf
48825,53,6,59,0,inf
48826,53,11,64,0,inf
48827,63,13,76,0,inf
48828,59,10,69,0,inf
48829,56,8,64,0,inf
48830,52,6,58,0,inf
48831,52,5,57,0,inf
48832,58,13,71,0,inf
48833,66,10,76,0,inf
48834,53,9,62,0,inf
48835,65,11,76,0,inf
48836,60,10,70,0,inf
48837,53,10,63,1,4.569667916697391
48838,66,8,74,0,inf
48839,59,9,68,0,inf
48840,55,13,68,0,inf
48841,61,11,72,0,inf
48842,51,13,64,0,inf
48843,56,7,63,0,inf
48844,54,11,65,0,inf
48845,62,7,69,0,inf
48846,63,7,70,0,inf
48847,53,8,61,0,inf
48848,61,10,71,0,inf
48849,55,12,67,0,inf
48850,50,10,60,0,inf
48851,51,6,57,0,inf
48852,55,13,68,0,inf
48853,50,12,62,0,inf
48854,51,8,59,0,inf
48855,65,13,78,0,inf
48856,58,5,63,0,inf
48857,66,6,72,0,inf
48858,60,9,69,0,inf
48859,54,9,63,0,inf
48860,65,7,72,0,inf
48861,64,7,71,0,inf
48862,57,12,69,0,inf
48863,61,7,68,0,inf
48864,57,5,62,0,inf
48865,51,11,62,0,inf
48866,56,7,63,0,inf
48867,62,13,75,0,inf
48868,58,10,68,0,inf
48869,55,11,66,0,inf
48870,55,11,66,0,inf
48871,61,7,68,0,inf
48872,51,8,59,0,inf
48873,61,7,68,0,inf
48874,50,10,60,0,inf
48875,57,10,67,0,inf
48876,65,5,70,0,inf
48877,64,12,76,0,inf
48878,63,6,69,0,inf
48879,53,13,66,0,inf
48880,61,9,70,0,inf
48881,52,6,58,0,inf
48882,50,10,60,0,inf
48883,63,7,70,0,inf
48884,67,12,79,0,inf
48885,53,13,66,1,6.482587588002254
48886,64,5,69,0,inf
48887,53,8,61,0,inf
48888,58,11,69,0,inf
48889,60,13,73,0,inf
48890,61,9,70,0,inf
48891,60,13,73,0,inf
48892,67,13,80,0,inf
48893,61,12,73,0,inf
48894,57,7,64,0,inf
48895,54,6,60,0,inf
48896,52,7,59,0,inf
48897,59,8,67,0,inf
48898,60,8,68,0,inf
48899,64,10,74,0,inf
48900,58,13,71,0,inf
48901,56,8,64,0,inf
48902,65,8,73,0,inf
48903,56,5,61,0,inf
48904,67,5,72,0,inf
48905,51,7,58,0,inf
48906,59,7,66,0,inf
48907,54,11,65,0,inf
48908,53,11,64,0,inf
48909,51,12,63,0,inf
48910,56,11,67,0,inf
48911,66,13,79,0,inf
48912,59,8,67,0,inf
48913,53,10,63,0,inf
48914,53,11,64,0,inf
48915,63,13,76,0,inf
48916,53,7,60,0,inf
48917,60,12,72,0,inf
48918,60,11,71,0,inf
48919,58,7,65,0,inf
48920,55,9,64,1,5.479293484647783
48921,53,12,65,0,inf
48922,67,11,78,0,inf
48923,59,6,65,0,inf
48924,55,9,64,0,inf
48925,52,9,61,0,inf
48926,59,12,71,0,inf
48927,57,12,69,0,inf
48928,61,13,74,0,inf
48929,51,13,64,0,inf
48930,65,12,77,1,11.304379593547381
48931,50,9,59,0,inf
48932,66,13,79,0,inf
48933,54,7,61,0,inf
48934,57,6,63,0,inf
48935,65,11,76,0,inf
48936,66,10,76,0,inf
48937,64,5,69,0,inf
48938,60,10,70,0,inf
48939,62,10,72,0,inf
48940,56,10,66,0,inf
48941,65,10,75,1,3.5512119442895766
48942,58,6,64,1,0.2610367352570151
48943,65,8,73,0,inf
48944,56,12,68,0,inf
48945,52,9,61,0,inf
48946,58,7,65,0,inf
48947,58,5,63,0,inf
48948,64,12,76,0,inf
48949,60,9,69,0,inf
48950,61,5,66,0,inf
48951,50,8,58,0,inf
48952,51,8,59,0,inf
48953,65,8,73,0,inf
48954,61,8,69,0,inf
48955,50,9,59,0,inf
48956,61,7,68,0,inf
48957,59,9,68,0,inf
48958,62,10,72,0,inf
48959,52,9,61,0,inf
48960,57,8,65,0,inf
48961,67,8,75,0,inf
48962,53,10,63,1,8.638616713331487
48963,62,8,70,0,inf
48964,65,8,73,0,inf
48965,52,10,62,0,inf
48966,52,9,61,0,inf
48967,65,12,77,0,inf
48968,65,11,76,1,0.22169417674376746
48969,67,6,73,0,inf
48970,63,12,75,0,inf
48971,54,8,62,0,inf
48972,60,11,71,0,inf
48973,52,13,65,0,inf
48974,52,9,61,0,inf
48975,56,13,69,0,inf
48976,64,6,70,0,inf
48977,61,6,67,0,inf
48978,53,5,58,0,inf
48979,50,9,59,0,inf
48980,58,6,64,0,inf
48981,50,13,63,0,inf
48982,66,9,75,0,inf
48983,65,13,78,0,inf
48984,65,8,73,0,inf
48985,64,6,70,0,inf
48986,67,11,78,0,inf
48987,56,9,65,0,inf
48988,51,13,64,0,inf
48989,67,12,79,0,inf
48990,67,7,74,0,inf
48991,57,8,65,0,inf
48992,54,5,59,0,inf
48993,63,6,69,0,inf
48994,55,11,66,0,inf
48995,52,6,58,0,inf
48996,55,9,64,0,inf
48997,59,13,72,0,inf
48998,64,6,70,0,inf
48999,53,7,60,0,inf
49000,66,6,72,0,inf
49001,50,12,62,0,inf
49002,67,6,73,0,inf
49003,59,13,72,0,inf
49004,58,7,65,0,inf
49005,62,7,69,0,inf
49006,57,7,64,0,inf
49007,57,10,67,0,inf
49008,64,8,72,0,inf
49009,53,10,63,0,inf
49010,61,8,69,0,inf
49011,57,8,65,0,inf
49012,65,10,75,0,inf
49013,67,12,79,0,inf
49014,50,10,60,0,inf
49015,60,8,68,0,inf
49016,66,11,77,0,inf
49017,58,7,65,0,inf
49018,62,13,75,0,inf
49019,65,5,70,0,inf
49020,60,10,70,1,7.502329363883746
49021,52,13,65,0,inf
49022,58,5,63,0,inf
49023,58,11,69,0,inf
49024,66,7,73,0,inf
49025,67,13,80,0,inf
49026,64,6,70,0,inf
49027,51,11,62,0,inf
49028,63,12,75,0,inf
49029,52,9,61,0,inf
49030,60,7,67,0,inf
49031,67,10,77,0,inf
49032,58,6,64,0,inf
49033,53,5,58,0,inf
49034,55,9,64,1,0.4537640960580802
49035,55,5,60,0,inf
49036,66,5,71,0,inf
49037,52,7,59,0,inf
49038,51,13,64,0,inf
49039,52,13,65,0,inf
49040,56,7,63,0,inf
49041,64,10,74,0,inf
49042,51,7,58,0,inf
49043,50,9,59,0,inf
49044,64,6,70,0,inf
49045,61,5,66,0,inf
49046,66,5,71,0,inf
49047,58,8,66,0,inf
49048,58,8,66,0,inf
49049,65,9,74,1,2.048740239600292
49050,66,7,73,0,inf
49051,64,10,74,0,inf
49052,65,10,75,0,inf
49053,50,8,58,0,inf
49054,58,11,69,0,inf
49055,59,9,68,0,inf
49056,51,9,60,0,inf
49057,66,7,73,0,inf
49058,54,6,60,0,inf
49059,53,7,60,0,inf
49060,53,8,61,0,inf
49061,55,10,65,0,inf
49062,53,13,66,0,inf
49063,56,11,67,0,inf
49064,61,9,70,0,inf
49065,52,7,59,0,inf
49066,61,7,68,0,inf
49067,53,9,62,0,inf
49068,60,13,73,0,inf
49069,51,8,59,0,inf
49070,56,12,68,0,inf
49071,50,6,56,0,inf
49072,63,7,70,0,inf
49073,56,11,67,0,inf
49074,61,13,74,0,inf
49075,65,6,71,1,1.9105692535857344
49076,51,5,56,0,inf
49077,53,7,60,0,inf
49078,67,12,79,0,inf
49079,50,5,55,0,inf
49080,66,9,75,0,inf
49081,56,11,67,0,inf
49082,63,9,72,0,inf
49083,59,10,69,0,inf
49084,51,12,63,0,inf
49085,59,12,71,0,inf
49086,60,6,66,0,inf
49087,51,5,56,0,inf
49088,62,11,73,0,inf
49089,58,9,67,0,inf
49090,50,8,58,0,inf
49091,56,12,68,0,inf
49092,53,7,60,0,inf
49093,57,7,64,0,inf
49094,51,7,58,0,inf
49095,54,7,61,0,inf
49096,51,8,59,0,inf
49097,51,5,56,0,inf
49098,62,5,67,0,inf
49099,58,5,63,0,inf
49100,64,12,76,1,2.8122445646721275
49101,62,13,75,0,inf
49102,55,11,66,0,inf
49103,67,5,72,0,inf
49104,59,8,67,0,inf
49105,62,13,75,0,inf
49106,60,5,65,0,inf
49107,50,8,58,0,inf
49108,59,8,67,0,inf
49109,60,12,72,0,inf
49110,61,10,71,0,inf
49111,58,13,71,0,inf
49112,60,7,67,0,inf
49113,58,13,71,0,inf
49114,57,6,63,0,inf
49115,53,6,59,0,inf
49116,55,5,60,0,inf
49117,67,10,77,0,inf
49118,55,5,60,0,inf
49119,53,10,63,0,inf
49120,62,9,71,0,inf
49121,62,11,73,0,inf
49122,65,9,74,0,inf
49123,65,10,75,0,inf
49124,56,5,61,0,inf
49125,50,5,55,0,inf
49126,58,9,67,0,inf
49127,66,10,76,0,inf
49128,61,9,70,0,inf
49129,56,8,64,0,inf
49130,59,13,72,0,inf
49131,63,10,73,0,inf
49132,65,7,72,0,inf
49133,59,7,66,0,inf
49134,54,6,60,0,inf
49135,64,13,77,0,inf
49136,61,10,71,0,inf
49137,51,5,56,0,inf
49138,66,7,73,0,inf
49139,67,13,80,0,inf
49140,53,12,65,0,inf
49141,56,7,63,0,inf
49142,63,9,72,0,inf
49143,67,8,75,0,inf
49144,64,7,71,0,inf
49145,59,5,64,0,inf
49146,51,6,57,0,inf
49147,64,6,70,0,inf
49148,50,8,58,0,inf
49149,65,13,78,0,inf
49150,51,12,63,0,inf
49151,63,10,73,0,inf
49152,51,12,63,0,inf
49153,50,8,58,1,7.895777652400184
49154,59,5,64,0,inf
49155,58,6,64,0,inf
49156,63,8,71,0,inf
49157,65,8,73,0,inf
49158,66,5,71,0,inf
49159,52,12,64,0,inf
49160,58,10,68,0,inf
49161,65,11,76,1,9.296321783347778
49162,54,6,60,0,inf
49163,53,8,61,0,inf
49164,56,13,69,1,4.168158193894868
49165,67,7,74,0,inf
49166,55,6,61,0,inf
49167,51,13,64,0,inf
49168,65,5,70,0,inf
49169,66,12,78,0,inf
49170,65,13,78,0,inf
49171,52,12,64,0,inf
49172,52,12,64,0,inf
49173,64,9,73,0,inf
49174,54,11,65,0,inf
49175,54,8,62,0,inf
49176,57,11,68,0,inf
49177,62,6,68,0,inf
49178,52,7,59,0,inf
49179,63,11,74,0,inf
49180,54,7,61,0,inf
49181,66,6,72,0,inf
49182,51,6,57,0,inf
49183,64,12,76,0,inf
49184,66,11,77,0,inf
49185,62,7,69,0,inf
49186,56,11,67,0,inf
49187,55,7,62,0,inf
49188,53,7,60,0,inf
49189,63,12,75,0,inf
49190,67,13,80,0,inf
49191,58,12,70,0,inf
49192,59,10,69,0,inf
49193,56,6,62,0,inf
49194,62,5,67,0,inf
49195,63,9,72,0,inf
49196,51,12,63,0,inf
49197,66,10,76,0,inf
49198,58,9,67,0,inf
49199,53,5,58,0,inf
49200,55,6,61,0,inf
49201,57,13,70,0,inf
49202,67,9,76,0,inf
49203,57,11,68,0,inf
49204,62,10,72,0,inf
49205,66,6,72,0,inf
49206,64,6,70,0,inf
49207,66,11,77,0,inf
49208,58,8,66,0,inf
49209,57,5,62,0,inf
49210,62,10,72,0,inf
49211,59,9,68,0,inf
49212,50,11,61,0,inf
49213,55,13,68,0,inf
49214,62,11,73,0,inf
49215,56,13,69,0,inf
49216,66,6,72,0,inf
49217,53,7,60,0,inf
49218,52,6,58,0,inf
49219,56,6,62,0,inf
49220,58,6,64,0,inf
49221,65,11,76,0,inf
49222,59,10,69,0,inf
49223,50,11,61,0,inf
49224,56,8,64,0,inf
49225,58,12,70,0,inf
49226,55,7,62,0,inf
49227,64,6,70,0,inf
49228,55,7,62,0,inf
49229,58,13,71,0,inf
49230,65,9,74,0,inf
49231,56,13,69,0,inf
49232,50,12,62,0,inf
49233,66,7,73,0,inf
49234,53,8,61,0,inf
49235,56,5,61,0,inf
49236,64,11,75,0,inf
49237,59,5,64,0,inf
49238,66,12,78,0,inf
49239,53,11,64,0,inf
49240,64,12,76,0,inf
49241,50,12,62,0,inf
49242,50,8,58,0,inf
49243,53,7,60,0,inf
49244,54,10,64,0,inf
49245,55,8,63,0,inf
49246,50,5,55,0,inf
49247,66,6,72,0,inf
49248,55,9,64,0,inf
49249,61,5,66,0,inf
49250,61,13,74,0,inf
49251,53,6,59,0,inf
49252,67,6,73,0,inf
49253,65,5,70,0,inf
49254,64,8,72,0,inf
49255,65,13,78,0,inf
49256,57,10,67,0,inf
49257,54,5,59,0,inf
49258,51,12,63,0,inf
49259,60,5,65,0,inf
49260,51,5,56,0,inf
49261,52,13,65,0,inf
49262,54,12,66,0,inf
49263,64,7,71,0,inf
49264,65,7,72,0,inf
49265,63,12,75,0,inf
49266,57,9,66,0,inf
49267,57,9,66,0,inf
49268,55,5,60,0,inf
49269,67,12,79,0,inf
49270,64,9,73,0,inf
49271,61,6,67,0,inf
49272,62,13,75,0,inf
49273,56,5,61,0,inf
49274,58,8,66,0,inf
49275,58,13,71,0,inf
49276,51,6,57,0,inf
49277,55,9,64,0,inf
49278,63,12,75,0,inf
49279,53,10,63,0,inf
49280,53,13,66,0,inf
49281,63,12,75,0,inf
49282,61,7,68,0,inf
49283,51,6,57,0,inf
49284,60,11,71,0,inf
49285,59,10,69,0,inf
49286,64,11,75,0,inf
49287,55,9,64,0,inf
49288,56,13,69,0,inf
49289,62,5,67,0,inf
49290,58,9,67,0,inf
49291,52,12,64,0,inf
49292,62,5,67,0,inf
49293,60,9,69,0,inf
49294,62,9,71,0,inf
49295,60,13,73,0,inf
49296,66,12,78,0,inf
49297,63,5,68,0,inf
49298,52,5,57,0,inf
49299,59,7,66,0,inf
49300,55,5,60,0,inf
49301,59,11,70,0,inf
49302,52,11,63,0,inf
49303,52,9,61,1,8.653050491180082
49304,54,6,60,0,inf
49305,67,11,78,0,inf
49306,58,7,65,0,inf
49307,67,10,77,0,inf
49308,61,11,72,0,inf
49309,64,12,76,0,inf
49310,65,9,74,0,inf
49311,53,12,65,0,inf
49312,62,9,71,0,inf
49313,67,10,77,0,inf
49314,66,5,71,0,inf
49315,59,12,71,0,inf
49316,50,13,63,0,inf
49317,56,8,64,0,inf
49318,55,11,66,0,inf
49319,61,10,71,0,inf
49320,63,7,70,0,inf
49321,56,5,61,0,inf
49322,64,5,69,0,inf
49323,58,6,64,0,inf
49324,55,7,62,0,inf
49325,64,13,77,0,inf
49326,59,7,66,0,inf
49327,54,5,59,0,inf
49328,56,5,61,0,inf
49329,59,13,72,0,inf
49330,55,7,62,0,inf
49331,57,12,69,0,inf
49332,59,10,69,0,inf
49333,63,12,75,0,inf
49334,54,7,61,0,inf
49335,64,11,75,0,inf
49336,52,6,58,0,inf
49337,58,9,67,0,inf
49338,59,7,66,0,inf
49339,59,8,67,1,3.588972382380568
49340,60,8,68,0,inf
49341,60,12,72,0,inf
49342,56,10,66,0,inf
49343,54,7,61,0,inf
49344,51,12,63,0,inf
49345,60,10,70,0,inf
49346,62,7,69,0,inf
49347,51,5,56,0,inf
49348,57,7,64,0,inf
49349,56,7,63,0,inf
49350,55,13,68,0,inf
49351,50,6,56,0,inf
49352,67,6,73,0,inf
49353,55,10,65,0,inf
49354,67,7,74,0,inf
49355,55,7,62,0,inf
49356,54,7,61,0,inf
49357,61,5,66,0,inf
49358,59,12,71,0,inf
49359,55,11,66,0,inf
49360,56,5,61,0,inf
49361,53,8,61,0,inf
49362,66,11,77,0,inf
49363,57,13,70,0,inf
49364,67,11,78,0,inf
49365,51,7,58,0,inf
49366,51,6,57,0,inf
49367,63,7,70,0,inf
49368,59,13,72,0,inf
49369,67,5,72,0,inf
49370,50,5,55,0,inf
49371,54,6,60,0,inf
49372,57,9,66,0,inf
49373,64,6,70,0,inf
49374,62,10,72,0,inf
49375,52,12,64,0,inf
49376,65,13,78,0,inf
49377,51,11,62,0,inf
49378,53,7,60,0,inf
49379,57,10,67,0,inf
49380,54,5,59,0,inf
49381,53,9,62,0,inf
49382,50,11,61,0,inf
49383,57,13,70,0,inf
49384,61,8,69,0,inf
49385,61,13,74,0,inf
49386,53,7,60,0,inf
49387,52,11,63,0,inf
49388,51,5,56,0,inf
49389,65,6,71,0,inf
49390,50,9,59,0,inf
49391,63,8,71,0,inf
49392,55,8,63,0,inf
49393,65,9,74,0,inf
49394,67,13,80,0,inf
49395,50,11,61,0,inf
49396,54,8,62,0,inf
49397,52,6,58,0,inf
49398,62,9,71,0,inf
49399,61,11,72,0,inf
49400,64,9,73,0,inf
49401,51,5,56,0,inf
49402,52,7,59,0,inf
49403,52,13,65,0,inf
49404,51,7,58,0,inf
49405,57,10,67,0,inf
49406,55,13,68,0,inf
49407,58,8,66,0,inf
49408,59,5,64,0,inf
49409,66,13,79,0,inf
49410,65,6,71,0,inf
49411,56,12,68,0,inf
49412,53,11,64,0,inf
49413,65,9,74,0,inf
49414,60,8,68,0,inf
49415,62,10,72,0,inf
49416,55,12,67,0,inf
49417,63,12,75,0,inf
49418,64,10,74,0,inf
49419,64,9,73,0,inf
49420,51,10,61,0,inf
49421,54,10,64,0,inf
49422,65,11,76,0,inf
49423,65,8,73,0,inf
49424,50,9,59,0,inf
49425,52,8,60,0,inf
49426,55,12,67,0,inf
49427,52,7,59,0,inf
49428,52,10,62,0,inf
49429,55,5,60,0,inf
49430,53,10,63,0,inf
49431,51,11,62,0,inf
49432,61,5,66,0,inf
49433,52,9,61,0,inf
49434,60,8,68,0,inf
49435,56,9,65,0,inf
49436,54,12,66,0,inf
49437,60,12,72,0,inf
49438,60,8,68,0,inf
49439,62,13,75,1,6.871774675741818
49440,54,13,67,0,inf
49441,61,7,68,0,inf
49442,53,8,61,0,inf
49443,66,8,74,0,inf
49444,67,8,75,0,inf
49445,66,5,71,0,inf
49446,67,5,72,0,inf
49447,55,7,62,0,inf
49448,55,11,66,0,inf
49449,66,7,73,0,inf
49450,51,12,63,0,inf
49451,58,8,66,0,inf
49452,52,8,60,0,inf
49453,50,7,57,0,inf
49454,56,8,64,0,inf
49455,63,10,73,0,inf
49456,54,7,61,0,inf
49457,60,8,68,0,inf
49458,52,11,63,0,inf
49459,56,13,69,0,inf
49460,61,8,69,0,inf
49461,67,11,78,0,inf
49462,63,6,69,0,inf
49463,65,5,70,0,inf
49464,56,7,63,0,inf
49465,66,6,72,0,inf
49466,54,13,67,0,inf
49467,55,8,63,0,inf
49468,56,11,67,0,inf
49469,65,10,75,0,inf
49470,67,8,75,0,inf
49471,56,10,66,0,inf
49472,54,11,65,0,inf
49473,61,11,72,0,inf
49474,63,9,72,0,inf
49475,56,12,68,0,inf
49476,67,5,72,0,inf
49477,55,13,68,0,inf
49478,50,7,57,0,inf
49479,50,7,57,0,inf
49480,59,12,71,0,inf
49481,64,5,69,0,inf
49482,53,7,60,0,inf
49483,67,7,74,0,inf
49484,53,9,62,0,inf
49485,57,7,64,0,inf
49486,57,5,62,0,inf
49487,60,8,68,0,inf
49488,62,5,67,0,inf
49489,62,8,70,0,inf
49490,66,8,74,0,inf
49491,50,8,58,0,inf
49492,58,13,71,0,inf
49493,59,6,65,0,inf
49494,57,6,63,0,inf
49495,51,9,60,0,inf
49496,67,6,73,0,inf
49497,66,11,77,0,inf
49498,53,5,58,0,inf
49499,54,5,59,0,inf
49500,54,13,67,0,inf
49501,54,10,64,0,inf
49502,59,13,72,0,inf
49503,59,10,69,0,inf
49504,54,11,65,0,inf
49505,54,13,67,0,inf
49506,65,7,72,0,inf
49507,55,12,67,0,inf
49508,62,5,67,0,inf
49509,63,11,74,0,inf
49510,64,8,72,0,inf
49511,54,8,62,1,6.437709150355232
49512,53,12,65,0,inf
49513,56,8,64,0,inf
49514,65,7,72,0,inf
49515,51,11,62,0,inf
49516,58,8,66,0,inf
49517,61,6,67,0,inf
49518,64,11,75,0,inf
49519,55,5,60,0,inf
49520,63,9,72,0,inf
49521,53,8,61,0,inf
49522,66,7,73,0,inf
49523,64,8,72,0,inf
49524,62,7,69,0,inf
49525,50,10,60,0,inf
49526,52,9,61,0,inf
49527,64,8,72,0,inf
49528,62,6,68,0,inf
49529,51,12,63,0,inf
49530,55,6,61,0,inf
49531,65,10,75,0,inf
49532,62,10,72,0,inf
49533,55,8,63,0,inf
49534,58,10,68,0,inf
49535,55,7,62,0,inf
49536,66,11,77,0,inf
49537,59,10,69,0,inf
49538,57,11,68,1,10.962420059794013
49539,51,7,58,0,inf
49540,66,6,72,0,inf
49541,52,6,58,0,inf
49542,55,10,65,0,inf
49543,63,5,68,0,inf
49544,54,6,60,0,inf
49545,59,7,66,1,5.714553846285355
49546,52,10,62,0,inf
49547,56,10,66,0,inf
49548,53,8,61,0,inf
49549,53,12,65,0,inf
49550,63,13,76,0,inf
49551,55,11,66,0,inf
49552,63,10,73,0,inf
49553,61,5,66,0,inf
49554,66,9,75,1,3.7864234712281046
49555,59,6,65,0,inf
49556,56,6,62,0,inf
49557,56,9,65,1,8.97826345087114
49558,62,10,72,0,inf
49559,60,11,71,0,inf
49560,66,13,79,0,inf
49561,52,7,59,0,inf
49562,50,6,56,0,inf
49563,59,7,66,0,inf
49564,57,10,67,0,inf
49565,53,12,65,0,inf
49566,67,5,72,0,inf
49567,62,8,70,0,inf
49568,57,10,67,0,inf
49569,54,11,65,0,inf
49570,51,5,56,0,inf
49571,54,13,67,0,inf
49572,58,9,67,0,inf
49573,58,12,70,0,inf
49574,54,8,62,0,inf
49575,52,12,64,0,inf
49576,53,11,64,0,inf
49577,51,13,64,0,inf
49578,54,6,60,0,inf
49579,62,6,68,0,inf
49580,56,6,62,0,inf
49581,65,8,73,0,inf
49582,63,6,69,0,inf
49583,65,10,75,0,inf
49584,61,8,69,0,inf
49585,67,6,73,0,inf
49586,63,9,72,0,inf
49587,58,7,65,0,inf
49588,64,12,76,0,inf
49589,55,10,65,0,inf
49590,52,6,58,0,inf
49591,67,9,76,0,inf
49592,51,13,64,0,inf
49593,50,8,58,0,inf
49594,50,5,55,0,inf
49595,61,9,70,0,inf
49596,62,6,68,0,inf
49597,54,10,64,0,inf
49598,52,9,61,0,inf
49599,62,12,74,0,inf
49600,58,8,66,0,inf
49601,64,10,74,1,8.798063081032069
49602,57,5,62,0,inf
49603,57,6,63,1,4.544401388308941
49604,58,9,67,0,inf
49605,54,12,66,0,inf
49606,51,8,59,0,inf
49607,60,5,65,0,inf
49608,64,10,74,0,inf
49609,52,11,63,0,inf
49610,66,12,78,0,inf
49611,64,11,75,0,inf
49612,66,11,77,0,inf
49613,52,9,61,0,inf
49614,58,9,67,0,inf
49615,63,13,76,0,inf
49616,51,12,63,0,inf
49617,67,13,80,0,inf
49618,58,6,64,0,inf
49619,50,8,58,0,inf
49620,65,8,73,0,inf
49621,58,12,70,0,inf
49622,51,7,58,0,inf
49623,53,5,58,0,inf
49624,66,13,79,0,inf
49625,54,10,64,0,inf
49626,55,9,64,0,inf
49627,58,5,63,0,inf
49628,65,5,70,0,inf
49629,62,5,67,0,inf
49630,66,12,78,0,inf
49631,64,10,74,0,inf
49632,58,8,66,1,1.3209385381729746
49633,52,13,65,1,12.826401484688134
49634,60,6,66,0,inf
49635,62,7,69,0,inf
49636,59,9,68,0,inf
49637,55,9,64,0,inf
49638,64,6,70,0,inf
49639,54,12,66,0,inf
49640,51,11,62,0,inf
49641,59,6,65,0,inf
49642,53,13,66,0,inf
49643,60,5,65,0,inf
49644,51,10,61,0,inf
49645,52,9,61,0,inf
49646,61,13,74,0,inf
49647,62,11,73,0,inf
49648,55,9,64,0,inf
49649,65,12,77,0,inf
49650,59,12,71,0,inf
49651,67,6,73,0,inf
49652,63,10,73,0,inf
49653,57,12,69,0,inf
49654,54,7,61,0,inf
49655,56,5,61,0,inf
49656,63,6,69,0,inf
49657,62,12,74,0,inf
49658,53,10,63,0,inf
49659,52,12,64,0,inf
49660,54,11,65,0,inf
49661,50,13,63,0,inf
49662,66,8,74,0,inf
49663,58,11,69,0,inf
49664,58,13,71,0,inf
49665,58,8,66,0,inf
49666,50,6,56,0,inf
49667,52,11,63,0,inf
49668,58,7,65,0,inf
49669,63,12,75,0,inf
49670,59,10,69,0,inf
49671,64,11,75,0,inf
49672,66,11,77,1,3.765897070760488
49673,51,12,63,0,inf
49674,60,10,70,0,inf
49675,61,11,72,0,inf
49676,66,7,73,0,inf
49677,51,10,61,0,inf
49678,58,12,70,0,inf
49679,62,7,69,0,inf
49680,63,11,74,0,inf
49681,61,9,70,0,inf
49682,67,6,73,0,inf
49683,60,11,71,0,inf
49684,50,5,55,0,inf
49685,57,7,64,0,inf
49686,57,12,69,0,inf
49687,55,8,63,0,inf
49688,63,8,71,0,inf
49689,62,6,68,0,inf
49690,59,13,72,0,inf
49691,58,7,65,0,inf
49692,64,10,74,0,inf
49693,57,13,70,0,inf
49694,53,9,62,0,inf
49695,56,6,62,0,inf
49696,52,9,61,0,inf
49697,58,7,65,0,inf
49698,61,12,73,0,inf
49699,53,11,64,0,inf
49700,50,10,60,0,inf
49701,52,11,63,0,inf
49702,62,9,71,0,inf
49703,57,5,62,0,inf
49704,52,9,61,0,inf
49705,66,12,78,0,inf
49706,58,11,69,0,inf
49707,55,13,68,0,inf
49708,57,11,68,0,inf
49709,61,12,73,0,inf
49710,64,6,70,0,inf
49711,60,7,67,0,inf
49712,64,9,73,0,inf
49713,64,5,69,0,inf
49714,57,12,69,0,inf
49715,63,11,74,1,6.251310344896751
49716,60,12,72,0,inf
49717,55,8,63,0,inf
49718,65,10,75,0,inf
49719,64,5,69,0,inf
49720,59,12,71,0,inf
49721,65,12,77,0,inf
49722,50,8,58,0,inf
49723,65,11,76,0,inf
49724,60,11,71,0,inf
49725,63,9,72,0,inf
49726,64,6,70,0,inf
49727,64,5,69,0,inf
49728,50,6,56,0,inf
49729,62,7,69,0,inf
49730,60,8,68,0,inf
49731,55,9,64,1,2.401551608879423
49732,52,8,60,0,inf
49733,51,6,57,0,inf
49734,67,12,79,0,inf
49735,50,12,62,0,inf
49736,62,10,72,0,inf
49737,51,7,58,0,inf
49738,65,13,78,0,inf
49739,50,9,59,0,inf
49740,65,13,78,0,inf
49741,61,13,74,0,inf
49742,61,13,74,0,inf
49743,55,5,60,0,inf
49744,57,10,67,0,inf
49745,62,13,75,0,inf
49746,59,12,71,0,inf
49747,52,13,65,0,inf
49748,66,5,71,0,inf
49749,55,13,68,0,inf
49750,54,13,67,0,inf
49751,52,11,63,0,inf
49752,55,12,67,0,inf
49753,53,7,60,0,inf
49754,64,8,72,0,inf
49755,57,5,62,0,inf
49756,52,6,58,0,inf
49757,50,9,59,0,inf
49758,57,8,65,0,inf
49759,52,9,61,0,inf
49760,60,13,73,0,inf
49761,54,11,65,0,inf
49762,61,7,68,0,inf
49763,67,6,73,0,inf
49764,53,10,63,0,inf
49765,63,12,75,0,inf
49766,55,6,61,0,inf
49767,62,9,71,0,inf
49768,57,11,68,0,inf
49769,60,13,73,0,inf
49770,61,7,68,0,inf
49771,63,5,68,0,inf
49772,61,13,74,0,inf
49773,52,9,61,0,inf
49774,61,12,73,0,inf
49775,67,8,75,0,inf
49776,59,11,70,0,inf
49777,55,6,61,0,inf
49778,54,8,62,0,inf
49779,55,7,62,0,inf
49780,50,5,55,0,inf
49781,61,12,73,0,inf
49782,62,8,70,0,inf
49783,61,8,69,0,inf
49784,66,11,77,0,inf
49785,66,6,72,0,inf
49786,50,11,61,0,inf
49787,50,9,59,0,inf
49788,66,8,74,0,inf
49789,54,11,65,0,inf
49790,63,6,69,0,inf
49791,66,6,72,0,inf
49792,64,6,70,0,inf
49793,64,13,77,0,inf
49794,55,8,63,0,inf
49795,55,13,68,0,inf
49796,58,10,68,0,inf
49797,62,10,72,0,inf
49798,55,5,60,0,inf
49799,54,7,61,0,inf
49800,56,12,68,0,inf
49801,64,13,77,1,10.151749143152514
49802,61,6,67,0,inf
49803,62,6,68,0,inf
49804,66,7,73,0,inf
49805,57,9,66,0,inf
49806,50,6,56,0,inf
49807,53,13,66,0,inf
49808,61,13,74,1,5.19578665599029
49809,50,12,62,0,inf
49810,52,13,65,0,inf
49811,65,8,73,0,inf
49812,59,7,66,0,inf
49813,58,7,65,0,inf
49814,55,12,67,0,inf
49815,60,11,71,0,inf
49816,65,10,75,0,inf
49817,51,6,57,0,inf
49818,61,10,71,0,inf
49819,57,6,63,0,inf
49820,53,10,63,0,inf
49821,67,8,75,0,inf
49822,64,9,73,0,inf
49823,60,11,71,0,inf
49824,53,10,63,0,inf
49825,56,7,63,0,inf
49826,62,11,73,0,inf
49827,57,5,62,0,inf
49828,66,9,75,0,inf
49829,54,12,66,0,inf
49830,57,13,70,0,inf
49831,64,7,71,0,inf
49832,67,5,72,0,inf
49833,66,12,78,0,inf
49834,61,11,72,0,inf
49835,61,9,70,0,inf
49836,57,9,66,0,inf
49837,62,12,74,0,inf
49838,63,8,71,0,inf
49839,64,8,72,0,inf
49840,61,5,66,0,inf
49841,63,12,75,0,inf
49842,65,12,77,0,inf
49843,53,11,64,0,inf
49844,65,12,77,0,inf
49845,59,6,65,0,inf
49846,50,13,63,0,inf
49847,66,13,79,0,inf
49848,63,10,73,0,inf
49849,64,10,74,0,inf
49850,67,7,74,0,inf
49851,50,5,55,0,inf
49852,62,11,73,0,inf
49853,60,8,68,0,inf
49854,62,11,73,0,inf
49855,53,13,66,1,10.505656451937867
49856,63,6,69,0,inf
49857,58,11,69,0,inf
49858,53,8,61,0,inf
49859,60,9,69,0,inf
49860,58,12,70,0,inf
49861,64,11,75,0,inf
49862,59,9,68,0,inf
49863,67,6,73,0,inf
49864,52,6,58,0,inf
49865,51,12,63,0,inf
49866,54,7,61,0,inf
49867,53,11,64,0,inf
49868,50,6,56,0,inf
49869,60,5,65,0,inf
49870,67,11,78,0,inf
49871,61,9,70,0,inf
49872,56,6,62,0,inf
49873,64,13,77,0,inf
49874,64,11,75,0,inf
49875,61,11,72,0,inf
49876,65,9,74,0,inf
49877,63,12,75,0,inf
49878,53,8,61,0,inf
49879,58,11,69,0,inf
49880,65,7,72,0,inf
49881,50,12,62,0,inf
49882,66,8,74,0,inf
49883,60,7,67,0,inf
49884,58,7,65,0,inf
49885,59,5,64,1,0.8036664218171055
49886,56,11,67,0,inf
49887,55,10,65,0,inf
49888,65,13,78,0,inf
49889,50,8,58,0,inf
49890,55,6,61,0,inf
49891,50,5,55,0,inf
49892,50,6,56,0,inf
49893,50,5,55,0,inf
49894,55,6,61,0,inf
49895,62,7,69,0,inf
49896,62,9,71,0,inf
49897,54,10,64,0,inf
49898,54,10,64,0,inf
49899,51,8,59,0,inf
49900,60,8,68,0,inf
49901,55,7,62,0,inf
49902,52,10,62,1,8.557458248394354
49903,55,8,63,0,inf
49904,62,8,70,0,inf
49905,57,5,62,0,inf
49906,55,9,64,0,inf
49907,54,5,59,0,inf
49908,55,13,68,0,inf
49909,63,7,70,0,inf
49910,57,8,65,0,inf
49911,66,12,78,1,3.682944782867807
49912,51,6,57,0,inf
49913,66,12,78,0,inf
49914,66,10,76,0,inf
49915,53,8,61,0,inf
49916,62,6,68,0,inf
49917,56,10,66,0,inf
49918,59,10,69,0,inf
49919,54,13,67,0,inf
49920,61,5,66,0,inf
49921,60,11,71,0,inf
49922,64,6,70,0,inf
49923,59,7,66,0,inf
49924,66,10,76,0,inf
49925,55,11,66,0,inf
49926,51,12,63,0,inf
49927,57,12,69,0,inf
49928,60,13,73,0,inf
49929,66,10,76,0,inf
49930,55,5,60,0,inf
49931,61,11,72,0,inf
49932,56,9,65,0,inf
49933,54,8,62,0,inf
49934,50,9,59,0,inf
49935,67,6,73,0,inf
49936,51,9,60,0,inf
49937,66,12,78,0,inf
49938,67,9,76,0,inf
49939,55,8,63,0,inf
49940,61,8,69,0,inf
49941,61,10,71,0,inf
49942,58,8,66,0,inf
49943,61,11,72,0,inf
49944,53,6,59,0,inf
49945,53,8,61,0,inf
49946,53,11,64,0,inf
49947,61,10,71,0,inf
49948,66,11,77,0,inf
49949,50,12,62,0,inf
49950,59,10,69,0,inf
49951,66,5,71,0,inf
49952,65,10,75,0,inf
49953,56,11,67,0,inf
49954,56,10,66,0,inf
49955,53,10,63,0,inf
49956,61,8,69,0,inf
49957,55,6,61,0,inf
49958,53,10,63,0,inf
49959,67,9,76,0,inf
49960,62,7,69,0,inf
49961,56,5,61,0,inf
49962,55,12,67,0,inf
49963,66,13,79,0,inf
49964,65,6,71,0,inf
49965,59,5,64,0,inf
49966,61,5,66,0,inf
49967,66,8,74,0,inf
49968,56,9,65,0,inf
49969,51,10,61,0,inf
49970,59,6,65,0,inf
49971,67,5,72,0,inf
49972,52,12,64,0,inf
49973,57,8,65,0,inf
49974,53,13,66,0,inf
49975,65,13,78,0,inf
49976,50,7,57,0,inf
49977,61,11,72,0,inf
49978,59,9,68,0,inf
49979,50,5,55,0,inf
49980,65,10,75,0,inf
49981,62,13,75,0,inf
49982,66,5,71,0,inf
49983,61,7,68,0,inf
49984,56,6,62,0,inf
49985,55,13,68,0,inf
49986,56,7,63,0,inf
49987,52,9,61,0,inf
49988,52,11,63,0,inf
49989,67,5,72,0,inf
49990,60,7,67,0,inf
49991,54,12,66,0,inf
49992,64,8,72,0,inf
49993,57,7,64,0,inf
49994,56,12,68,0,inf
49995,62,7,69,0,inf
49996,52,13,65,0,inf
49997,57,10,67,0,inf
49998,57,5,62,0,inf
49999,61,8,69,0,inf
50000,66,7,73,0,inf
